Income,Savings,Expenses,Saving Percentage,Expense Percentage,Expense Category
171095,25868,145227,15.119085887956981,84.88091411204302,Healthcare
85679,19851,65828,23.169037920610652,76.83096207938935,Transportation
16618,4182,12436,25.16548321097605,74.83451678902395,Housing
82603,25216,57387,30.526736317082914,69.47326368291709,Transportation
91940,32571,59369,35.42636502066565,64.57363497933434,Transportation
144858,16878,127980,11.651410346684338,88.34858965331566,Healthcare
19697,8994,10703,45.661775904960145,54.338224095039855,Housing
68888,16775,52113,24.351120659621415,75.64887934037858,Transportation
153847,15527,138320,10.092494491280297,89.9075055087197,Healthcare
13444,1214,12230,9.030050580184469,90.96994941981553,Housing
48578,12258,36320,25.233644859813083,74.76635514018692,Food
163121,41628,121493,25.519706230344347,74.48029376965566,Healthcare
74534,10165,64369,13.638071215820968,86.36192878417903,Transportation
67031,27516,39515,41.04966358848891,58.950336411511095,Transportation
33557,16467,17090,49.07172870042018,50.92827129957982,Food
135283,14462,120821,10.690182801978075,89.30981719802192,Healthcare
24857,9373,15484,37.70768797521825,62.29231202478175,Housing
227673,65944,161729,28.96434799031945,71.03565200968055,Entertainment
131641,21390,110251,16.24873709558572,83.75126290441428,Healthcare
231493,53132,178361,22.951881914355944,77.04811808564406,Entertainment
199154,43046,156108,21.614429034817277,78.38557096518272,Entertainment
54887,17131,37756,31.2113979630878,68.78860203691221,Food
101544,53328,48216,52.5171354289766,47.4828645710234,Transportation
184565,7289,177276,3.949286159347655,96.05071384065235,Entertainment
80544,1774,78770,2.202522844656337,97.79747715534366,Transportation
184037,52819,131218,28.700207023587648,71.29979297641236,Entertainment
19545,6180,13365,31.619339984650807,68.38066001534919,Housing
223919,50076,173843,22.363443923918915,77.63655607608109,Entertainment
179817,27616,152201,15.357836022178104,84.6421639778219,Healthcare
225012,548,224464,0.24354256661866924,99.75645743338133,Entertainment
13119,4534,8585,34.5605610183703,65.43943898162969,Housing
38063,21321,16742,56.01502771720569,43.98497228279432,Food
110429,5568,104861,5.042153782068117,94.95784621793189,Transportation
118639,25651,92988,21.621052099225384,78.37894790077462,Transportation
239213,64903,174310,27.131886644956587,72.86811335504342,Entertainment
53062,25461,27601,47.983491010516,52.016508989484,Food
107137,58858,48279,54.93713656346547,45.06286343653453,Transportation
29740,3796,25944,12.763954270342973,87.23604572965704,Housing
56424,27693,28731,49.080178647384095,50.91982135261591,Food
130277,6593,123684,5.060755160158738,94.93924483984127,Healthcare
119518,45894,73624,38.399236935022344,61.600763064977656,Transportation
12521,3687,8834,29.446529829885794,70.55347017011421,Housing
206678,58232,148446,28.17522910033966,71.82477089966034,Entertainment
29013,3919,25094,13.507737910591805,86.4922620894082,Housing
242438,68650,173788,28.31651803760137,71.68348196239863,Entertainment
27495,9230,18265,33.56973995271868,66.43026004728132,Housing
90147,12438,77709,13.79746414190156,86.20253585809844,Transportation
46937,23516,23421,50.10119948015424,49.89880051984575,Food
25631,2195,23436,8.563848464749716,91.43615153525029,Housing
59265,26806,32459,45.23074327174555,54.76925672825445,Food
39240,19564,19676,49.857288481141694,50.142711518858306,Food
243905,24281,219624,9.95510547139255,90.04489452860744,Entertainment
87796,10653,77143,12.1338101963643,87.86618980363569,Transportation
192255,30845,161410,16.04379600010403,83.95620399989598,Entertainment
47882,19385,28497,40.48494214945073,59.51505785054927,Food
170206,49931,120275,29.3356285912365,70.66437140876349,Healthcare
47107,15788,31319,33.51518882543996,66.48481117456004,Food
231069,59898,171171,25.922127156823286,74.07787284317672,Entertainment
32612,8605,24007,26.385992886054215,73.61400711394579,Food
59130,20448,38682,34.58143074581431,65.41856925418568,Food
25985,14573,11412,56.08235520492592,43.91764479507408,Housing
138728,39177,99551,28.24015339369125,71.75984660630876,Healthcare
159375,17104,142271,10.73192156862745,89.26807843137254,Healthcare
29466,17141,12325,58.17213059118984,41.82786940881015,Housing
15510,8462,7048,54.55834945196647,45.44165054803352,Housing
191545,59541,132004,31.084601529666656,68.91539847033334,Entertainment
45674,11541,34133,25.26820510574944,74.73179489425056,Food
226010,51895,174115,22.96137339055794,77.03862660944206,Entertainment
132378,53090,79288,40.10485125927269,59.89514874072731,Healthcare
48350,26831,21519,55.49327817993795,44.50672182006205,Food
62916,19524,43392,31.031851993133703,68.9681480068663,Transportation
28693,15907,12786,55.43860871989684,44.561391280103166,Housing
55598,10717,44881,19.275873232850103,80.7241267671499,Food
38817,18875,19942,48.62560218460983,51.37439781539016,Food
38657,20264,18393,52.42000155211216,47.57999844788783,Food
240314,35931,204383,14.95168820792796,85.04831179207204,Entertainment
22498,12091,10407,53.742554893768336,46.257445106231664,Housing
120298,38842,81456,32.28815109145622,67.71184890854379,Healthcare
187462,10662,176800,5.687552677342608,94.31244732265739,Entertainment
38293,18120,20173,47.31935340662785,52.68064659337216,Food
217555,24335,193220,11.185677185079633,88.81432281492036,Entertainment
11570,623,10947,5.384615384615385,94.61538461538461,Housing
93601,40351,53250,43.109582162583735,56.890417837416265,Transportation
32512,9044,23468,27.81742125984252,72.18257874015748,Food
70008,19181,50827,27.398297337447147,72.60170266255285,Transportation
57462,30232,27230,52.61216108036616,47.38783891963384,Food
42939,17454,25485,40.64836162928806,59.351638370711946,Food
34860,11845,23015,33.97877223178428,66.02122776821572,Food
182339,13818,168521,7.578192268247605,92.4218077317524,Entertainment
137343,22352,114991,16.274582614330544,83.72541738566946,Healthcare
122284,61377,60907,50.1921755912466,49.80782440875339,Healthcare
168322,28741,139581,17.075010990838987,82.92498900916101,Healthcare
227869,61336,166533,26.917219981656125,73.08278001834387,Entertainment
13595,7196,6399,52.931224714968735,47.068775285031265,Housing
54182,14958,39224,27.606954339079397,72.39304566092059,Food
58430,28153,30277,48.182440527126474,51.81755947287352,Food
188525,46185,142340,24.49807717809309,75.5019228219069,Entertainment
145334,7062,138272,4.85915202223843,95.14084797776157,Healthcare
124316,9791,114525,7.875896907879919,92.12410309212008,Healthcare
131762,42482,89280,32.24146567295578,67.75853432704422,Healthcare
29824,6406,23418,21.47934549356223,78.52065450643777,Housing
91640,42724,48916,46.62156263640332,53.37843736359669,Transportation
64458,38525,25933,59.767600608147944,40.232399391852056,Transportation
245072,36462,208610,14.878076646862961,85.12192335313703,Entertainment
160859,38991,121868,24.23924057715142,75.76075942284858,Healthcare
59165,9944,49221,16.807234006591734,83.19276599340827,Food
23666,1169,22497,4.939575762697541,95.06042423730246,Housing
158585,16135,142450,10.174354447141912,89.82564555285809,Healthcare
183757,44898,138859,24.43335491981258,75.56664508018743,Entertainment
56303,8023,48280,14.24968474148802,85.75031525851198,Food
114647,15377,99270,13.41247481399426,86.58752518600575,Transportation
125473,51864,73609,41.33478915782678,58.665210842173224,Healthcare
70648,36590,34058,51.79198278790624,48.208017212093765,Transportation
16131,7811,8320,48.4222924803174,51.577707519682605,Housing
227579,39844,187735,17.507766533819023,82.49223346618098,Entertainment
69051,29743,39308,43.07395982679469,56.926040173205315,Transportation
167621,46262,121359,27.5991671687915,72.40083283120849,Healthcare
26542,8680,17862,32.70288599201266,67.29711400798733,Housing
47958,4136,43822,8.624212852912965,91.37578714708704,Food
117255,54947,62308,46.86111466461985,53.13888533538016,Transportation
162301,42757,119544,26.344261588037043,73.65573841196296,Healthcare
102156,41565,60591,40.68777164336896,59.31222835663104,Transportation
174878,69942,104936,39.99473918960647,60.00526081039354,Healthcare
101213,32767,68446,32.37429974410402,67.62570025589598,Transportation
42768,1274,41494,2.9788627010849233,97.02113729891508,Food
115263,38662,76601,33.54242037774481,66.4575796222552,Transportation
56998,32498,24500,57.016035650373695,42.983964349626305,Food
72524,26747,45777,36.88020517345982,63.11979482654018,Transportation
210196,15659,194537,7.449713600639403,92.55028639936059,Entertainment
16764,4177,12587,24.916487711763303,75.0835122882367,Housing
150895,22210,128685,14.71884422943106,85.28115577056894,Healthcare
46523,8818,37705,18.954065730928786,81.04593426907121,Food
29926,13104,16822,43.78801042571677,56.21198957428323,Housing
118382,40214,78168,33.969691338210204,66.03030866178979,Transportation
216610,11186,205424,5.164119846729145,94.83588015327086,Entertainment
196076,36029,160047,18.375017850221344,81.62498214977866,Entertainment
20913,5189,15724,24.81231769712619,75.18768230287381,Housing
140039,4423,135616,3.158405872649762,96.84159412735023,Healthcare
15784,9152,6632,57.98276735935124,42.01723264064876,Housing
214025,357,213668,0.1668029435813573,99.83319705641864,Entertainment
22023,11278,10745,51.2100985333515,48.78990146664851,Housing
128385,44683,83702,34.803910114109904,65.1960898858901,Healthcare
130123,61744,68379,47.45048915257103,52.54951084742897,Healthcare
19729,5036,14693,25.525875614577526,74.47412438542248,Housing
128303,69993,58310,54.55289432047575,45.44710567952425,Healthcare
175748,2540,173208,1.445251155062931,98.55474884493707,Healthcare
85952,4629,81323,5.385564035740878,94.61443596425913,Transportation
16747,2529,14218,15.101212157401326,84.89878784259868,Housing
22980,6444,16536,28.041775456919062,71.95822454308095,Housing
96270,34696,61574,36.04030331359718,63.95969668640282,Transportation
121372,56359,65013,46.434927330850606,53.565072669149394,Healthcare
132075,44767,87308,33.89513533976907,66.10486466023093,Healthcare
59679,19394,40285,32.4971933175824,67.5028066824176,Food
203849,61616,142233,30.22629495361763,69.77370504638237,Entertainment
100439,4860,95579,4.838757853025219,95.16124214697477,Transportation
120120,9326,110794,7.763902763902763,92.23609723609724,Healthcare
117163,48577,68586,41.46104145506687,58.53895854493313,Transportation
20196,7992,12204,39.57219251336899,60.42780748663101,Housing
111613,7752,103861,6.945427503964592,93.0545724960354,Transportation
65794,9837,55957,14.95121135665866,85.04878864334134,Transportation
13258,1381,11877,10.416352391009202,89.5836476089908,Housing
84142,1467,82675,1.7434812578735945,98.2565187421264,Transportation
120816,42556,78260,35.22381141570653,64.77618858429346,Healthcare
13620,811,12809,5.954478707782672,94.04552129221733,Housing
49115,20249,28866,41.227730835793544,58.772269164206456,Food
10194,5421,4773,53.17834020011772,46.82165979988228,Housing
233292,37748,195544,16.18058055998491,83.81941944001508,Entertainment
211725,52425,159300,24.760892667375135,75.23910733262487,Entertainment
218034,58071,159963,26.633919480448004,73.366080519552,Entertainment
46414,4667,41747,10.055155771965357,89.94484422803465,Food
20011,3270,16741,16.341012443156263,83.65898755684373,Housing
196213,66465,129748,33.87390234082349,66.12609765917651,Entertainment
156971,67086,89885,42.73783055468844,57.26216944531155,Healthcare
134194,9860,124334,7.347571426442315,92.65242857355769,Healthcare
27777,4434,23343,15.962846959714872,84.03715304028513,Housing
26814,1539,25275,5.739539046766614,94.26046095323338,Housing
32403,3088,29315,9.5299817918094,90.4700182081906,Food
188797,11938,176859,6.323193694815066,93.67680630518494,Entertainment
106411,57262,49149,53.81210589130823,46.187894108691765,Transportation
97837,39554,58283,40.42846775759682,59.57153224240318,Transportation
221185,8900,212285,4.023780997807266,95.97621900219274,Entertainment
37207,2025,35182,5.442524256188352,94.55747574381165,Food
119528,32781,86747,27.425373134328357,72.57462686567165,Transportation
36795,21030,15765,57.154504688136974,42.845495311863026,Food
76498,27706,48792,36.217940338309496,63.782059661690504,Transportation
163467,57351,106116,35.08414542384701,64.91585457615298,Healthcare
11345,5468,5877,48.19744380784486,51.80255619215514,Housing
155324,61635,93689,39.68156884963045,60.31843115036955,Healthcare
43396,12861,30535,29.636372015853997,70.363627984146,Food
27892,15846,12046,56.81198910081744,43.18801089918256,Housing
180167,64915,115252,36.03046062819495,63.96953937180505,Entertainment
44171,14678,29493,33.229947250458444,66.77005274954155,Food
77683,25722,51961,33.11149157473321,66.88850842526679,Transportation
31759,12346,19413,38.87401996284518,61.125980037154825,Food
206649,3826,202823,1.8514485915731504,98.14855140842685,Entertainment
111996,25051,86945,22.367763134397656,77.63223686560235,Transportation
19993,11552,8441,57.78022307807733,42.21977692192267,Housing
53120,12835,40285,24.16227409638554,75.83772590361446,Food
19132,8199,10933,42.854902780681584,57.145097219318416,Housing
49489,2877,46612,5.8134130816949225,94.18658691830508,Food
92529,13630,78899,14.730516919019983,85.26948308098001,Transportation
207925,60367,147558,29.033064807021763,70.96693519297824,Entertainment
15000,1104,13896,7.359999999999999,92.64,Housing
38681,15549,23132,40.1980300405884,59.80196995941159,Food
213555,4666,208889,2.184917234436094,97.81508276556391,Entertainment
17355,9720,7635,56.00691443388073,43.99308556611927,Housing
166700,62958,103742,37.76724655068986,62.23275344931014,Healthcare
28018,13800,14218,49.254050967235344,50.74594903276465,Housing
182040,28083,153957,15.426829268292682,84.57317073170731,Entertainment
29697,16583,13114,55.84065730545172,44.15934269454827,Housing
39352,5962,33390,15.15043708070746,84.84956291929254,Food
141627,49433,92194,34.90365537644658,65.09634462355342,Healthcare
136546,67140,69406,49.17024299503464,50.82975700496536,Healthcare
205486,42924,162562,20.889014336743138,79.11098566325686,Entertainment
98751,43108,55643,43.6532288280625,56.346771171937505,Transportation
194232,59952,134280,30.866180649944397,69.1338193500556,Entertainment
125020,58915,66105,47.12446008638618,52.87553991361382,Healthcare
125966,9330,116636,7.406760554435324,92.59323944556468,Healthcare
154956,11070,143886,7.1439634476883755,92.85603655231162,Healthcare
31107,2775,28332,8.920821680007714,91.07917831999228,Food
151623,69876,81747,46.08535644328367,53.91464355671632,Healthcare
138231,34947,103284,25.28159385376652,74.71840614623348,Healthcare
247140,33578,213562,13.586631059318604,86.4133689406814,Entertainment
22133,12140,9993,54.85022364794651,45.14977635205349,Housing
195180,18221,176959,9.335485193155037,90.66451480684496,Entertainment
94778,15347,79431,16.19257633628057,83.80742366371943,Transportation
243327,28081,215246,11.540437353848935,88.45956264615107,Entertainment
151730,4157,147573,2.73973505569103,97.26026494430897,Healthcare
52629,30980,21649,58.86488437933459,41.13511562066542,Food
70940,14416,56524,20.321398364815337,79.67860163518466,Transportation
13447,456,12991,3.3910909496541977,96.6089090503458,Housing
28303,5762,22541,20.35826590820761,79.64173409179239,Housing
67634,29598,38036,43.762013188632935,56.237986811367065,Transportation
163072,62611,100461,38.394696821036106,61.60530317896389,Healthcare
80065,13954,66111,17.428339474177232,82.57166052582276,Transportation
83579,34777,48802,41.60973450268608,58.39026549731392,Transportation
19291,10464,8827,54.242911202114975,45.757088797885025,Housing
32767,8173,24594,24.942777794732503,75.0572222052675,Food
154630,36521,118109,23.61831468667141,76.38168531332859,Healthcare
241971,8551,233420,3.5338945576122756,96.46610544238773,Entertainment
148162,50292,97870,33.94392624289629,66.0560737571037,Healthcare
55624,15221,40403,27.36408744426866,72.63591255573134,Food
15650,8878,6772,56.72843450479233,43.27156549520767,Housing
106163,49419,56744,46.550116330548306,53.449883669451694,Transportation
15406,2451,12955,15.909385953524602,84.0906140464754,Housing
21828,1008,20820,4.617921935129192,95.38207806487081,Housing
131202,38965,92237,29.69848020609442,70.30151979390557,Healthcare
35499,9572,25927,26.96413983492493,73.03586016507508,Food
37443,10803,26640,28.851854819325375,71.14814518067463,Food
95335,55195,40140,57.895840981801015,42.104159018198985,Transportation
149287,64223,85064,43.01982088192542,56.98017911807458,Healthcare
26996,7044,19952,26.0927544821455,73.90724551785449,Housing
221448,68818,152630,31.076370073335504,68.9236299266645,Entertainment
176091,37396,138695,21.236746909268504,78.7632530907315,Healthcare
73357,18103,55254,24.677944845072727,75.32205515492727,Transportation
171334,58153,113181,33.941307621371124,66.05869237862888,Healthcare
38112,8506,29606,22.318429890848027,77.68157010915198,Food
247343,26668,220675,10.781788851918186,89.21821114808182,Entertainment
91511,52313,39198,57.165805203746004,42.834194796254,Transportation
31004,14699,16305,47.410011611404975,52.589988388595025,Food
86186,39135,47051,45.40760680388926,54.592393196110734,Transportation
131946,67559,64387,51.20200688160308,48.79799311839692,Healthcare
191679,38594,153085,20.13470437554453,79.86529562445547,Entertainment
36889,15982,20907,43.32456829949307,56.67543170050693,Food
18882,4246,14636,22.487024679589027,77.51297532041097,Housing
70815,21392,49423,30.20828920426463,69.79171079573536,Transportation
246411,60410,186001,24.51595099244758,75.48404900755243,Entertainment
111704,64407,47297,57.65863353147604,42.34136646852396,Transportation
41796,19164,22632,45.85127763422337,54.14872236577663,Food
13742,2997,10745,21.809052539659437,78.19094746034057,Housing
102058,26973,75085,26.429089341354917,73.57091065864509,Transportation
182050,66909,115141,36.75308981049162,63.24691018950838,Entertainment
226229,63434,162795,28.039729654465166,71.96027034553484,Entertainment
184440,46582,137858,25.25590978095858,74.74409021904142,Entertainment
27092,4416,22676,16.300014764506127,83.69998523549387,Housing
69276,22900,46376,33.05618107281021,66.9438189271898,Transportation
174712,46345,128367,26.526512202939696,73.4734877970603,Healthcare
10153,570,9583,5.6141042056535015,94.3858957943465,Housing
156983,39226,117757,24.987419019893874,75.01258098010612,Healthcare
103940,45493,58447,43.76852030017317,56.23147969982683,Transportation
173694,26274,147420,15.126601955162528,84.87339804483747,Healthcare
14718,4355,10363,29.589618154640572,70.41038184535942,Housing
220856,50467,170389,22.850635708334842,77.14936429166515,Entertainment
229730,20721,209009,9.019718800330823,90.98028119966918,Entertainment
192465,7292,185173,3.7887408100174063,96.21125918998258,Entertainment
122292,16913,105379,13.830013410525627,86.16998658947436,Healthcare
36018,7908,28110,21.95568882225554,78.04431117774446,Food
45638,15736,29902,34.48003856435427,65.51996143564574,Food
30501,12204,18297,40.01180289170847,59.98819710829153,Food
88839,39385,49454,44.3330069001227,55.6669930998773,Transportation
74218,29766,44452,40.10617370449217,59.89382629550782,Transportation
179155,32650,146505,18.224442521838633,81.77555747816136,Healthcare
218675,7626,211049,3.4873670972904995,96.5126329027095,Entertainment
38109,16498,21611,43.29161090556037,56.70838909443964,Food
153970,44406,109564,28.840683249983762,71.15931675001623,Healthcare
138965,27125,111840,19.519303421724896,80.4806965782751,Healthcare
172882,15796,157086,9.136867921472449,90.86313207852756,Healthcare
157741,39033,118708,24.744993375216335,75.25500662478366,Healthcare
24346,5263,19083,21.61751417070566,78.38248582929434,Housing
179836,6187,173649,3.440356769501101,96.5596432304989,Healthcare
137501,65805,71696,47.857833761209015,52.142166238790985,Healthcare
28075,13102,14973,46.66785396260018,53.332146037399816,Housing
177870,14084,163786,7.918142463597009,92.08185753640299,Healthcare
49827,2826,47001,5.671623818411704,94.3283761815883,Food
27689,11843,15846,42.771497706670516,57.228502293329484,Housing
106197,39936,66261,37.60558207858979,62.39441792141021,Transportation
211639,27453,184186,12.971616762505967,87.02838323749404,Entertainment
121286,23663,97623,19.510083604043334,80.48991639595667,Healthcare
28305,10989,17316,38.82352941176471,61.1764705882353,Housing
62557,9339,53218,14.928784948127308,85.0712150518727,Transportation
217524,4292,213232,1.9731156102315146,98.02688438976848,Entertainment
247223,55128,192095,22.298896138304283,77.70110386169571,Entertainment
203333,66040,137293,32.47874176842913,67.52125823157087,Entertainment
140896,21907,118989,15.548347717465363,84.45165228253464,Healthcare
16017,4220,11797,26.347006305800086,73.6529936941999,Housing
157665,65667,91998,41.64970031395681,58.35029968604319,Healthcare
86844,47976,38868,55.2438855879508,44.75611441204919,Transportation
132519,50097,82422,37.80363570506871,62.19636429493129,Healthcare
147934,10839,137095,7.326916057160626,92.67308394283937,Healthcare
92322,44595,47727,48.30376291674791,51.69623708325209,Transportation
157956,24943,133013,15.79110638405632,84.20889361594368,Healthcare
78851,3677,75174,4.6632255773547575,95.33677442264525,Transportation
74643,26167,48476,35.05620084937636,64.94379915062363,Transportation
231571,63158,168413,27.27370871136714,72.72629128863286,Entertainment
160766,4718,156048,2.9347001231603698,97.06529987683963,Healthcare
121841,53211,68630,43.67249119754434,56.32750880245566,Healthcare
92266,54127,38139,58.66407994277415,41.33592005722584,Transportation
131357,49027,82330,37.323477241410814,62.67652275858919,Healthcare
179084,45391,133693,25.346206249581204,74.6537937504188,Healthcare
70116,5963,64153,8.504478293114268,91.49552170688573,Transportation
29624,6593,23031,22.25560356467729,77.74439643532271,Housing
90551,17516,73035,19.34379520932955,80.65620479067044,Transportation
27876,15500,12376,55.603386425599076,44.39661357440092,Housing
35378,7507,27871,21.219401888179092,78.78059811182091,Food
236692,13782,222910,5.8227570006590845,94.17724299934092,Entertainment
114132,27200,86932,23.83205411278169,76.16794588721831,Transportation
42594,1526,41068,3.582664225008217,96.41733577499178,Food
144240,6947,137293,4.816278424847476,95.18372157515252,Healthcare
128699,10120,118579,7.863308961219589,92.1366910387804,Healthcare
104012,19977,84035,19.20643771872476,80.79356228127523,Transportation
116678,16133,100545,13.826942525583231,86.17305747441677,Transportation
232193,31797,200396,13.694211281132507,86.30578871886749,Entertainment
85181,15320,69861,17.985231448327678,82.01476855167232,Transportation
149016,5678,143338,3.810329092178021,96.18967090782198,Healthcare
237196,54134,183062,22.822475927081403,77.1775240729186,Entertainment
26569,12086,14483,45.48910384282435,54.51089615717566,Housing
118651,18258,100393,15.387986616210567,84.61201338378943,Transportation
197265,22608,174657,11.460725420120143,88.53927457987986,Entertainment
123675,69541,54134,56.22882555083889,43.77117444916111,Healthcare
161255,2582,158673,1.6011906607547053,98.3988093392453,Healthcare
135503,9447,126056,6.971801362331462,93.02819863766854,Healthcare
56318,27751,28567,49.27554245534287,50.72445754465713,Food
21219,10976,10243,51.72722559969838,48.272774400301614,Housing
17034,8727,8307,51.232828460725614,48.767171539274386,Housing
181878,19349,162529,10.63844994996646,89.36155005003353,Entertainment
65210,33056,32154,50.691611715994476,49.308388284005524,Transportation
81896,27142,54754,33.14203379896454,66.85796620103545,Transportation
54177,23530,30647,43.431714565221405,56.568285434778595,Food
182677,1752,180925,0.9590698336407976,99.0409301663592,Entertainment
47085,15488,31597,32.89370287777424,67.10629712222577,Food
36583,19591,16992,53.552196375365604,46.447803624634396,Food
99441,44764,54677,45.015637413139444,54.98436258686055,Transportation
61244,19699,41545,32.16478348899484,67.83521651100516,Transportation
177464,24527,152937,13.820831267186584,86.17916873281342,Healthcare
106853,1961,104892,1.8352315798339773,98.16476842016603,Transportation
171840,69737,102103,40.58251862197393,59.41748137802607,Healthcare
152346,36343,116003,23.85556562036417,76.14443437963583,Healthcare
205838,26264,179574,12.759548771363887,87.2404512286361,Entertainment
109182,19292,89890,17.66957923467238,82.33042076532762,Transportation
30165,1781,28384,5.9041936018564565,94.09580639814354,Food
42122,7033,35089,16.696738046626468,83.30326195337354,Food
159341,9548,149793,5.9921802925800645,94.00781970741994,Healthcare
51035,115,50920,0.22533555403154698,99.77466444596845,Food
17901,1901,16000,10.619518462655718,89.38048153734428,Housing
57254,31406,25848,54.853809340832086,45.146190659167914,Food
235361,58947,176414,25.045355857597478,74.95464414240253,Entertainment
123460,44667,78793,36.179329337437224,63.820670662562776,Healthcare
44465,14289,30176,32.13538738333521,67.86461261666479,Food
16312,8091,8221,49.60152035311427,50.39847964688573,Housing
18704,1940,16764,10.372112917023097,89.6278870829769,Housing
136763,6959,129804,5.088364543041612,94.9116354569584,Healthcare
145889,31508,114381,21.597241738582074,78.40275826141793,Healthcare
32411,6109,26302,18.848539076239547,81.15146092376045,Food
35375,21139,14236,59.75689045936395,40.24310954063604,Food
25933,2016,23917,7.773878841630355,92.22612115836965,Housing
173733,53089,120644,30.557809972774315,69.44219002722568,Healthcare
190378,22918,167460,12.038155669247496,87.9618443307525,Entertainment
33971,14917,19054,43.910982897177,56.08901710282299,Food
97483,57579,39904,59.06568324733543,40.93431675266457,Transportation
30808,15316,15492,49.714359906517785,50.28564009348221,Food
136265,6183,130082,4.537482112061057,95.46251788793894,Healthcare
238594,37052,201542,15.529309203081384,84.47069079691862,Entertainment
34793,18296,16497,52.585290144569306,47.414709855430694,Food
39940,19757,20183,49.46670005007511,50.533299949924896,Food
80646,33958,46688,42.107482082186344,57.892517917813656,Transportation
96240,36463,59777,37.8875727348296,62.11242726517041,Transportation
75771,20310,55461,26.804450251415453,73.19554974858455,Transportation
30018,17934,12084,59.74415350789526,40.25584649210474,Food
20105,10577,9528,52.60880378015419,47.39119621984581,Housing
12428,3252,9176,26.166720308979723,73.83327969102028,Housing
57524,21575,35949,37.50608441693902,62.49391558306099,Food
162427,65584,96843,40.377523441299786,59.62247655870022,Healthcare
244932,9810,235122,4.005193278134339,95.99480672186566,Entertainment
245634,898,244736,0.3655845689114699,99.63441543108853,Entertainment
100174,7543,92631,7.529897977519116,92.47010202248089,Transportation
15905,1706,14199,10.72618673373153,89.27381326626846,Housing
81469,24958,56511,30.634965446979834,69.36503455302017,Transportation
160195,9156,151039,5.715534192702643,94.28446580729735,Healthcare
39718,7020,32698,17.674605972103326,82.32539402789666,Food
22027,6155,15872,27.942979071139966,72.05702092886004,Housing
129786,18363,111423,14.148675511996672,85.85132448800333,Healthcare
81420,23501,57919,28.86391549987718,71.13608450012282,Transportation
34352,8927,25425,25.986842105263158,74.01315789473685,Food
163692,68186,95506,41.655059501991545,58.344940498008455,Healthcare
200012,53505,146507,26.750894946303223,73.24910505369678,Entertainment
232863,26371,206492,11.324684471126801,88.6753155288732,Entertainment
16884,6084,10800,36.034115138592746,63.965884861407254,Housing
96953,38667,58286,39.882210968201086,60.11778903179892,Transportation
195390,63454,131936,32.47556169711858,67.52443830288142,Entertainment
249778,61539,188239,24.637478080535516,75.36252191946448,Entertainment
118927,20556,98371,17.28455270880456,82.71544729119545,Transportation
24986,10503,14483,42.03553990234531,57.964460097654694,Housing
63997,13902,50095,21.722893260621593,78.27710673937841,Transportation
130060,41268,88792,31.72997078271567,68.27002921728433,Healthcare
234172,50403,183769,21.52392258681653,78.47607741318348,Entertainment
233130,55267,177863,23.706515677947927,76.29348432205208,Entertainment
128706,69841,58865,54.26398147716501,45.73601852283499,Healthcare
12172,5399,6773,44.35589878409464,55.64410121590536,Housing
248479,21048,227431,8.47073595756583,91.52926404243416,Entertainment
237903,67874,170029,28.53011521502461,71.46988478497539,Entertainment
55524,33294,22230,59.96325913118652,40.03674086881349,Food
104210,44423,59787,42.62834660781115,57.37165339218885,Transportation
25520,3295,22225,12.911442006269592,87.0885579937304,Housing
113891,24338,89553,21.369555100929833,78.63044489907016,Transportation
186796,11708,175088,6.267800167027131,93.73219983297287,Entertainment
62253,7289,54964,11.708672674409264,88.29132732559073,Transportation
175256,727,174529,0.4148217464737298,99.58517825352628,Healthcare
47021,24223,22798,51.51528040662683,48.48471959337317,Food
27729,3832,23897,13.819466984023945,86.18053301597605,Housing
112294,4247,108047,3.7820364400591306,96.21796355994087,Transportation
63472,13931,49541,21.948260650365516,78.05173934963449,Transportation
146911,43310,103601,29.480433731987393,70.5195662680126,Healthcare
210084,68504,141580,32.60790921726547,67.39209078273453,Entertainment
24818,8543,16275,34.42259650253848,65.57740349746152,Housing
24505,9178,15327,37.45358090185677,62.54641909814323,Housing
96347,54355,41992,56.41587179673472,43.58412820326528,Transportation
112124,52269,59855,46.61713816845635,53.38286183154365,Transportation
90745,8695,82050,9.581795140228113,90.41820485977189,Transportation
20024,11966,8058,59.75829005193768,40.24170994806233,Housing
33031,238,32793,0.7205352547606794,99.27946474523932,Food
24030,175,23855,0.7282563462338744,99.27174365376612,Housing
235410,29698,205712,12.615436897328067,87.38456310267193,Entertainment
46622,26465,20157,56.76504654454978,43.23495345545022,Food
179486,26522,152964,14.776639960776885,85.22336003922312,Healthcare
14862,2313,12549,15.563181267662497,84.4368187323375,Housing
26131,15127,11004,57.88909724082507,42.11090275917493,Housing
46450,15764,30686,33.93756727664155,66.06243272335846,Food
165646,51151,114495,30.879707327674677,69.12029267232532,Healthcare
16043,3017,13026,18.805709655301378,81.19429034469863,Housing
29671,12485,17186,42.07812342017458,57.921876579825415,Housing
140159,44090,96069,31.457130829985946,68.54286917001406,Healthcare
223807,68218,155589,30.480726697556378,69.51927330244362,Entertainment
24557,6326,18231,25.760475628130468,74.23952437186952,Housing
160291,36170,124121,22.565209525176087,77.43479047482391,Healthcare
238960,9513,229447,3.981001004352193,96.0189989956478,Entertainment
201443,24839,176604,12.33053518861415,87.66946481138585,Entertainment
195884,40281,155603,20.563700965877764,79.43629903412224,Entertainment
13152,4689,8463,35.652372262773724,64.34762773722628,Housing
53699,27667,26032,51.522374718337396,48.477625281662604,Food
25930,11365,14565,43.82954107211724,56.17045892788276,Housing
33894,19452,14442,57.39068861745442,42.609311382545584,Food
22129,1705,20424,7.704821727145375,92.29517827285463,Housing
63600,24888,38712,39.132075471698116,60.867924528301884,Transportation
245775,33355,212420,13.571355914962874,86.42864408503713,Entertainment
23306,2817,20489,12.0870162189994,87.91298378100059,Housing
105875,53650,52225,50.67296340023613,49.32703659976387,Transportation
156277,13789,142488,8.823435310378366,91.17656468962163,Healthcare
218225,3901,214324,1.7876045366021307,98.21239546339787,Entertainment
118533,19746,98787,16.65865202095619,83.34134797904382,Transportation
149745,18577,131168,12.405756452636147,87.59424354736385,Healthcare
41619,18954,22665,45.541699704461905,54.458300295538095,Food
10096,4143,5953,41.03605388272583,58.96394611727417,Housing
40254,6921,33333,17.193322402742584,82.80667759725742,Food
93265,11229,82036,12.039886345359996,87.96011365464,Transportation
15482,9218,6264,59.54011109675752,40.45988890324247,Housing
133685,23445,110240,17.537494857313835,82.46250514268615,Healthcare
93576,30296,63280,32.375822860562536,67.62417713943746,Transportation
28878,15667,13211,54.25237204792575,45.74762795207425,Housing
26725,8737,17988,32.69223573433115,67.30776426566885,Housing
51017,9404,41613,18.43307132916479,81.56692867083521,Food
25445,1622,23823,6.3745333071330315,93.62546669286696,Housing
181086,49335,131751,27.24396143268944,72.75603856731055,Entertainment
225520,40551,184969,17.981110322809506,82.0188896771905,Entertainment
244852,16938,227914,6.917648211981114,93.08235178801888,Entertainment
16959,4807,12152,28.344831652809717,71.65516834719028,Housing
98218,17063,81155,17.372579364271314,82.62742063572868,Transportation
134055,2038,132017,1.5202715303420238,98.47972846965799,Healthcare
58193,27242,30951,46.8131905899335,53.1868094100665,Food
41726,20979,20747,50.278004122130085,49.721995877869915,Food
132994,10283,122711,7.731927756139374,92.26807224386062,Healthcare
120527,32878,87649,27.27853510001908,72.72146489998092,Healthcare
142275,6592,135683,4.633280618520471,95.36671938147953,Healthcare
124147,22042,102105,17.754758471811645,82.24524152818836,Healthcare
160252,37809,122443,23.59346529216484,76.40653470783516,Healthcare
24356,3921,20435,16.098702578420102,83.9012974215799,Housing
24830,13928,10902,56.093435360451075,43.90656463954893,Housing
138958,1755,137203,1.2629715453590293,98.73702845464098,Healthcare
183321,53706,129615,29.296152650269203,70.7038473497308,Entertainment
24686,12871,11815,52.13886413351697,47.86113586648303,Housing
19423,2356,17067,12.129949029501107,87.8700509704989,Housing
36514,8082,28432,22.13397600920195,77.86602399079806,Food
53148,17543,35605,33.007827199518324,66.99217280048167,Food
228659,42828,185831,18.73007404038328,81.26992595961671,Entertainment
135373,1369,134004,1.0112799450407393,98.98872005495926,Healthcare
124217,69997,54220,56.35058003332877,43.649419966671225,Healthcare
93156,27381,65775,29.39263171454335,70.60736828545664,Transportation
105863,31471,74392,29.72804473706583,70.27195526293417,Transportation
61709,22971,38738,37.22471600576902,62.77528399423099,Transportation
119863,1780,118083,1.4850287411461418,98.51497125885386,Transportation
169839,32375,137464,19.062170643962812,80.93782935603718,Healthcare
127921,10920,117001,8.536518632593554,91.46348136740644,Healthcare
69613,9413,60200,13.521899645181215,86.47810035481879,Transportation
12103,3839,8264,31.719408411137735,68.28059158886226,Housing
74673,27209,47464,36.43753431628568,63.56246568371433,Transportation
76763,9441,67322,12.298893998410692,87.7011060015893,Transportation
67111,19649,47462,29.278359732383663,70.72164026761634,Transportation
50355,27667,22688,54.94389832191441,45.05610167808559,Food
173838,40956,132882,23.559866082214477,76.44013391778553,Healthcare
16671,2074,14597,12.440765400995742,87.55923459900426,Housing
94925,41491,53434,43.70924414011061,56.29075585988939,Transportation
42145,9650,32495,22.897140823347968,77.10285917665203,Food
172886,25682,147204,14.854875467070785,85.14512453292922,Healthcare
25330,318,25012,1.2554283458349782,98.74457165416503,Housing
225841,25571,200270,11.322567647149986,88.67743235285002,Entertainment
36028,10455,25573,29.019096258465638,70.98090374153436,Food
238968,59048,179920,24.709584546884937,75.29041545311506,Entertainment
202075,49699,152376,24.594333786960288,75.40566621303971,Entertainment
15165,8866,6299,58.46356742499176,41.53643257500824,Housing
19840,9343,10497,47.091733870967744,52.908266129032256,Housing
217959,68544,149415,31.448116388862125,68.55188361113788,Entertainment
237027,44365,192662,18.717276934695203,81.2827230653048,Entertainment
42158,14683,27475,34.828502300868166,65.17149769913185,Food
240927,46585,194342,19.335732400270622,80.66426759972938,Entertainment
68028,28301,39727,41.60198741694596,58.39801258305404,Transportation
160126,59620,100506,37.233178871638586,62.766821128361414,Healthcare
238754,34717,204037,14.540908215150322,85.45909178484969,Entertainment
96858,24441,72417,25.233847488075327,74.76615251192467,Transportation
248929,26933,221996,10.819550956296775,89.18044904370322,Entertainment
190968,51075,139893,26.74531858740731,73.25468141259267,Entertainment
21253,5949,15304,27.99134239872018,72.00865760127982,Housing
47644,20992,26652,44.060112501049446,55.93988749895055,Food
225532,32125,193407,14.244098398453433,85.75590160154657,Entertainment
45220,23946,21274,52.954444935869084,47.045555064130916,Food
70085,17646,52439,25.17799814510951,74.82200185489049,Transportation
221448,31383,190065,14.171724287417362,85.82827571258264,Entertainment
156653,38186,118467,24.376168984954006,75.623831015046,Healthcare
108154,3986,104168,3.6854855114004104,96.31451448859958,Transportation
246837,13198,233639,5.346848325008001,94.653151674992,Entertainment
189266,3045,186221,1.6088468081958727,98.39115319180412,Entertainment
93366,9883,83483,10.58522374311848,89.41477625688152,Transportation
238512,64551,173961,27.064047091970217,72.93595290802979,Entertainment
121828,49851,71977,40.91916472403717,59.080835275962826,Healthcare
54525,19927,34598,36.54653828519028,63.45346171480972,Food
192340,10872,181468,5.6524903816158885,94.34750961838411,Entertainment
229618,40377,189241,17.584422823994633,82.41557717600536,Entertainment
40317,11734,28583,29.10434804176898,70.89565195823101,Food
99787,17742,82045,17.77987112549731,82.22012887450269,Transportation
87187,30918,56269,35.461708740982026,64.53829125901798,Transportation
53132,31471,21661,59.23172476097267,40.76827523902733,Food
18656,3084,15572,16.530874785591767,83.46912521440824,Housing
90206,36368,53838,40.316608651309224,59.683391348690776,Transportation
245544,56300,189244,22.928680806698594,77.0713191933014,Entertainment
186762,15830,170932,8.476028314111007,91.523971685889,Entertainment
69859,4136,65723,5.92049700110222,94.07950299889778,Transportation
199913,48407,151506,24.214033104400414,75.78596689559959,Entertainment
124772,9619,115153,7.7092616933286315,92.29073830667137,Healthcare
244851,52870,191981,21.592723738110116,78.40727626188988,Entertainment
236705,15597,221108,6.58921442301599,93.41078557698401,Entertainment
127441,2336,125105,1.8330050768590955,98.1669949231409,Healthcare
238957,54639,184318,22.86562017434099,77.13437982565901,Entertainment
172748,65191,107557,37.737629379211334,62.262370620788666,Healthcare
47613,2543,45070,5.340978304244639,94.65902169575536,Food
165110,51248,113862,31.038701471746112,68.96129852825389,Healthcare
40130,3278,36852,8.16845252927984,91.83154747072015,Food
23512,14092,9420,59.93535216059884,40.06464783940116,Housing
101558,20043,81515,19.735520589219956,80.26447941078004,Transportation
78182,23388,54794,29.914814151595,70.085185848405,Transportation
68292,11433,56859,16.74134598488842,83.25865401511157,Transportation
68605,26461,42144,38.57007506741491,61.42992493258509,Transportation
22134,7998,14136,36.134453781512605,63.86554621848739,Housing
22133,3888,18245,17.566529616409884,82.43347038359012,Housing
130029,62591,67438,48.13618500488352,51.86381499511648,Healthcare
163151,37780,125371,23.156462418250577,76.84353758174942,Healthcare
231055,52201,178854,22.592456341563697,77.40754365843631,Entertainment
69256,3565,65691,5.147568441723461,94.85243155827654,Transportation
193711,49100,144611,25.347037597245382,74.65296240275462,Entertainment
71786,1204,70582,1.677207254896498,98.3227927451035,Transportation
29966,15725,14241,52.47613962490823,47.52386037509177,Housing
21327,7532,13795,35.31673465560088,64.68326534439912,Housing
14098,6752,7346,47.89331820116329,52.10668179883672,Housing
26656,4266,22390,16.00390156062425,83.99609843937576,Housing
166895,21594,145301,12.938674016597263,87.06132598340274,Healthcare
226405,29645,196760,13.093792098231047,86.90620790176895,Entertainment
37685,18135,19550,48.122595197028,51.877404802972,Food
35155,8963,26192,25.495662067984636,74.50433793201536,Food
28449,3700,24749,13.005729551126578,86.99427044887342,Housing
40506,15333,25173,37.8536513109169,62.1463486890831,Food
120532,57585,62947,47.77569442139847,52.22430557860154,Healthcare
191223,55466,135757,29.00592501947987,70.99407498052012,Entertainment
144970,36641,108329,25.27488445885356,74.72511554114645,Healthcare
122118,63352,58766,51.87769206832735,48.122307931672644,Healthcare
59672,10694,48978,17.92130312374313,82.07869687625687,Food
17341,2838,14503,16.36583818695577,83.63416181304423,Housing
30152,8000,22152,26.532236667551075,73.46776333244892,Food
15188,2944,12244,19.383723992625757,80.61627600737424,Housing
156338,54068,102270,34.584042267395006,65.415957732605,Healthcare
93302,9619,83683,10.309532485905983,89.69046751409402,Transportation
68692,25056,43636,36.47586327374367,63.52413672625633,Transportation
107355,54823,52532,51.06702063248102,48.93297936751898,Transportation
15962,5301,10661,33.21012404460594,66.78987595539407,Housing
61866,17247,44619,27.877994374939384,72.12200562506061,Transportation
10622,2307,8315,21.719073620787047,78.28092637921296,Housing
189000,41755,147245,22.09259259259259,77.9074074074074,Entertainment
75311,42761,32550,56.779222158781586,43.220777841218414,Transportation
11821,453,11368,3.832163099568565,96.16783690043144,Housing
219797,66176,153621,30.10778127089997,69.89221872910004,Entertainment
47518,5343,42175,11.244160107748643,88.75583989225136,Food
49792,1801,47991,3.617046915167095,96.3829530848329,Food
38641,21281,17360,55.07362645894257,44.92637354105742,Food
60399,15340,45059,25.397771486282885,74.60222851371712,Transportation
33359,15700,17659,47.06376090410384,52.93623909589616,Food
35773,19737,16036,55.1728957593716,44.82710424062841,Food
160277,50674,109603,31.616513910292802,68.38348608970719,Healthcare
50252,11982,38270,23.84382711135875,76.15617288864125,Food
235889,47619,188270,20.18703712339278,79.81296287660722,Entertainment
247229,23916,223313,9.673622431025485,90.32637756897451,Entertainment
44231,21200,23031,47.930184712079765,52.06981528792024,Food
94872,8230,86642,8.674846108440846,91.32515389155915,Transportation
79186,5720,73466,7.223499103376859,92.77650089662313,Transportation
10177,2349,7828,23.081458190036354,76.91854180996364,Housing
10821,3348,7473,30.939839201552537,69.06016079844747,Housing
68619,33099,35520,48.2359113365103,51.7640886634897,Transportation
249005,54259,194746,21.79032549547198,78.20967450452802,Entertainment
46688,9694,36994,20.763365318711447,79.23663468128855,Food
22854,7779,15075,34.037805198214755,65.96219480178524,Housing
172022,67386,104636,39.17289648998384,60.82710351001616,Healthcare
184679,18414,166265,9.970814223598785,90.0291857764012,Entertainment
47815,18336,29479,38.34779880790547,61.65220119209454,Food
62071,29532,32539,47.577773839635256,52.42222616036475,Transportation
77803,15532,62271,19.963240492011877,80.03675950798812,Transportation
27009,13460,13549,49.835240105150135,50.164759894849865,Housing
211141,20132,191009,9.534860590790041,90.46513940920995,Entertainment
20827,4267,16560,20.48782829980314,79.51217170019686,Housing
47788,9290,38498,19.44002678496694,80.55997321503307,Food
236445,46349,190096,19.60244454312842,80.39755545687157,Entertainment
194079,54772,139307,28.221497431458324,71.77850256854168,Entertainment
16520,4598,11922,27.83292978208232,72.16707021791767,Housing
216615,28621,187994,13.212843062576459,86.78715693742353,Entertainment
178065,69673,108392,39.12784657288069,60.872153427119315,Healthcare
26662,1095,25567,4.106968719525917,95.89303128047408,Housing
29749,4951,24798,16.642576221049445,83.35742377895056,Housing
107403,1831,105572,1.704794093274862,98.29520590672513,Transportation
25435,4971,20464,19.543935521918616,80.45606447808137,Housing
19647,6667,12980,33.933933933933936,66.06606606606607,Housing
113147,54570,58577,48.22929463441364,51.77070536558636,Transportation
11757,4158,7599,35.366164837968874,64.63383516203113,Housing
146302,43064,103238,29.43500430616123,70.56499569383877,Healthcare
24790,13552,11238,54.667204517950786,45.332795482049214,Housing
10906,5919,4987,54.27287731523932,45.72712268476069,Housing
164966,8886,156080,5.386564504200866,94.61343549579914,Healthcare
234810,39484,195326,16.815297474553894,83.18470252544611,Entertainment
188793,13419,175374,7.107784716594365,92.89221528340563,Entertainment
156213,48699,107514,31.174742178947973,68.82525782105202,Healthcare
165357,52120,113237,31.519681658472276,68.48031834152772,Healthcare
237441,47856,189585,20.154901638722883,79.84509836127712,Entertainment
249921,31512,218409,12.608784375862772,87.39121562413723,Entertainment
16422,6871,9551,41.84021434660821,58.15978565339179,Housing
115838,7291,108547,6.294134912550285,93.70586508744971,Transportation
53860,11592,42268,21.522465651689565,78.47753434831043,Food
35890,16918,18972,47.138478684870435,52.861521315129565,Food
15012,5929,9083,39.49507061017852,60.50492938982147,Housing
24944,1092,23852,4.377806286080821,95.62219371391917,Housing
162803,52225,110578,32.07864719937593,67.92135280062406,Healthcare
121375,26043,95332,21.45664263645726,78.54335736354274,Healthcare
65981,28819,37162,43.67772540579864,56.32227459420136,Transportation
199796,11679,188117,5.8454623716190515,94.15453762838095,Entertainment
148242,63082,85160,42.553392425898195,57.446607574101805,Healthcare
29010,4738,24272,16.332299207169942,83.66770079283006,Housing
232045,15112,216933,6.512529897218212,93.48747010278178,Entertainment
26694,6912,19782,25.893459204315576,74.10654079568442,Housing
193555,7319,186236,3.7813541370669834,96.21864586293302,Entertainment
118626,55150,63476,46.49065129061083,53.50934870938917,Transportation
16962,4054,12908,23.900483433557362,76.09951656644263,Housing
131946,33107,98839,25.091325239112972,74.90867476088702,Healthcare
229746,10806,218940,4.703455120002089,95.29654487999791,Entertainment
34965,19846,15119,56.75961675961676,43.24038324038324,Food
91575,28792,62783,31.44089544089544,68.55910455910455,Transportation
37165,10227,26938,27.517825911475853,72.48217408852415,Food
229625,5329,224296,2.3207403375068045,97.6792596624932,Entertainment
17326,1245,16081,7.185732425256839,92.81426757474316,Housing
157359,8952,148407,5.688902445999275,94.31109755400072,Healthcare
210696,69640,141056,33.05235979800281,66.94764020199719,Entertainment
138705,63063,75642,45.465556396669186,54.53444360333081,Healthcare
236348,34040,202308,14.402491241728299,85.5975087582717,Entertainment
99287,43505,55782,43.81741819170687,56.18258180829313,Transportation
184519,35471,149048,19.22349459947214,80.77650540052785,Entertainment
130196,5376,124820,4.129159113951274,95.87084088604873,Healthcare
104537,44547,59990,42.613620057969904,57.386379942030096,Transportation
27043,13452,13591,49.74300188588544,50.25699811411456,Housing
151765,38759,113006,25.53882647514249,74.4611735248575,Healthcare
222630,43809,178821,19.67794097830481,80.3220590216952,Entertainment
14817,4283,10534,28.905986367010865,71.09401363298915,Housing
150709,45045,105664,29.888725955317863,70.11127404468213,Healthcare
19705,5474,14231,27.7797513321492,72.2202486678508,Housing
144868,1889,142979,1.3039456608774884,98.69605433912251,Healthcare
146282,60991,85291,41.694125046143746,58.305874953856254,Healthcare
115609,35583,80026,30.77874559939105,69.22125440060894,Transportation
161005,41522,119483,25.789261203068225,74.21073879693178,Healthcare
169510,28631,140879,16.890448941065426,83.10955105893457,Healthcare
213553,22077,191476,10.337948893248983,89.66205110675102,Entertainment
215851,41796,174055,19.36335713061325,80.63664286938675,Entertainment
173509,39622,133887,22.835703047104186,77.16429695289581,Healthcare
86597,38115,48482,44.01422682079056,55.98577317920944,Transportation
27910,15796,12114,56.596202078108206,43.403797921891794,Housing
228836,46714,182122,20.413746088902094,79.5862539110979,Entertainment
102373,36504,65869,35.65783946939135,64.34216053060867,Transportation
146135,9697,136438,6.635645122660554,93.36435487733945,Healthcare
85133,32361,52772,38.012286657347914,61.987713342652086,Transportation
43185,6814,36371,15.778626838022461,84.22137316197754,Food
100392,99,100293,0.09861343533349272,99.90138656466651,Transportation
201879,26066,175813,12.911694628960912,87.08830537103908,Entertainment
128907,59465,69442,46.13015584879021,53.86984415120979,Healthcare
23528,3664,19864,15.572934376062564,84.42706562393744,Housing
224932,52158,172774,23.18834136539043,76.81165863460957,Entertainment
80876,24704,56172,30.545526484989367,69.45447351501063,Transportation
44981,21008,23973,46.70416398034726,53.29583601965274,Food
26127,2632,23495,10.073869942970873,89.92613005702913,Housing
45364,3026,42338,6.670487611321753,93.32951238867825,Food
36677,7429,29248,20.255200807045288,79.7447991929547,Food
226793,18329,208464,8.081819103764227,91.91818089623578,Entertainment
108948,38950,69998,35.75100047729192,64.24899952270809,Transportation
13500,3981,9519,29.488888888888887,70.51111111111112,Housing
11669,6504,5165,55.73742394378267,44.26257605621733,Housing
55810,25192,30618,45.13886400286687,54.861135997133125,Food
13253,1990,11263,15.015468195880178,84.98453180411983,Housing
42607,10652,31955,25.000586758044452,74.99941324195555,Food
97517,32071,65446,32.8875990852877,67.11240091471231,Transportation
58066,9155,48911,15.766541521716668,84.23345847828332,Food
59318,11235,48083,18.940287939579893,81.05971206042011,Food
223251,56914,166337,25.493278865492204,74.50672113450779,Entertainment
236359,51690,184669,21.86927512808905,78.13072487191096,Entertainment
26083,8101,17982,31.058543879155003,68.94145612084499,Housing
64431,28923,35508,44.88988219956232,55.11011780043768,Transportation
219715,24190,195525,11.009717133559384,88.99028286644062,Entertainment
57331,19064,38267,33.25251609077113,66.74748390922886,Food
162104,58938,103166,36.358140453042495,63.64185954695751,Healthcare
56971,6264,50707,10.995067666005513,89.00493233399449,Food
179070,25739,153331,14.37370860557324,85.62629139442676,Healthcare
22109,1427,20682,6.454385092043964,93.54561490795604,Housing
208879,16511,192368,7.90457633366686,92.09542366633315,Entertainment
44957,1869,43088,4.157305870053607,95.8426941299464,Food
58425,21636,36789,37.03209242618742,62.967907573812575,Food
59158,24436,34722,41.306332195138445,58.69366780486156,Food
150311,57623,92688,38.33585033696802,61.66414966303198,Healthcare
19084,9453,9631,49.533640746174804,50.466359253825196,Housing
219191,36045,183146,16.44456204862426,83.55543795137575,Entertainment
11180,2925,8255,26.16279069767442,73.83720930232558,Housing
140673,3453,137220,2.4546288200294297,97.54537117997057,Healthcare
44356,3088,41268,6.961854089638381,93.03814591036162,Food
117976,51226,66750,43.420695734725705,56.57930426527429,Transportation
231138,65974,165164,28.54312142529571,71.45687857470429,Entertainment
104975,21941,83034,20.9011669445106,79.09883305548941,Transportation
195632,31025,164607,15.858857446634497,84.1411425533655,Entertainment
14683,4152,10531,28.27759994551522,71.72240005448478,Housing
71135,24598,46537,34.579321009348426,65.42067899065158,Transportation
149884,16978,132906,11.327426543193402,88.6725734568066,Healthcare
46630,12220,34410,26.206304953892346,73.79369504610766,Food
49642,11813,37829,23.79638209580597,76.20361790419403,Food
198694,43125,155569,21.70422861284186,78.29577138715814,Entertainment
152494,51563,100931,33.81313363148714,66.18686636851287,Healthcare
33351,9282,24069,27.83124943779797,72.16875056220204,Food
164453,55129,109324,33.52264780818836,66.47735219181165,Healthcare
239596,42311,197285,17.65930983822768,82.34069016177232,Entertainment
89999,44806,45193,49.78499761108457,50.21500238891543,Transportation
248906,27132,221774,10.900500590584397,89.0994994094156,Entertainment
117228,32065,85163,27.352680247039956,72.64731975296004,Transportation
211551,11862,199689,5.607158557510955,94.39284144248904,Entertainment
138734,2254,136480,1.6246918563582107,98.37530814364179,Healthcare
26533,11252,15281,42.40756793427053,57.59243206572947,Housing
64494,29027,35467,45.00728749961237,54.99271250038763,Transportation
178448,15226,163222,8.532457634717117,91.46754236528288,Healthcare
219921,50485,169436,22.955970553062237,77.04402944693777,Entertainment
208155,46879,161276,22.521198145612644,77.47880185438736,Entertainment
50683,12611,38072,24.88211037231419,75.11788962768581,Food
19838,2635,17203,13.282588970662365,86.71741102933763,Housing
44868,19949,24919,44.46153160381564,55.538468396184356,Food
174756,42497,132259,24.317906109089243,75.68209389091075,Healthcare
233492,44287,189205,18.96724513045415,81.03275486954585,Entertainment
23488,634,22854,2.69925068119891,97.3007493188011,Housing
11431,2159,9272,18.88723646225177,81.11276353774824,Housing
122898,61297,61601,49.87632020049146,50.12367979950854,Healthcare
233272,27661,205611,11.857831201344354,88.14216879865565,Entertainment
127512,67049,60463,52.58250203902378,47.41749796097622,Healthcare
47474,13440,34034,28.31023296962548,71.68976703037451,Food
115547,54317,61230,47.00857659653647,52.99142340346352,Transportation
47291,23352,23939,49.379374511006326,50.620625488993674,Food
32195,6094,26101,18.928405031837244,81.07159496816277,Food
172752,38603,134149,22.345906270260258,77.65409372973974,Healthcare
81183,12323,68860,15.179286303782813,84.82071369621718,Transportation
19981,8172,11809,40.89885391121565,59.10114608878434,Housing
20669,876,19793,4.238231167448837,95.76176883255117,Housing
21032,4801,16231,22.827120578166603,77.1728794218334,Housing
35656,9956,25700,27.92236930670855,72.07763069329145,Food
230925,6192,224733,2.681390061708347,97.31860993829166,Entertainment
247563,20063,227500,8.104199739056321,91.89580026094369,Entertainment
15046,6068,8978,40.32965572245115,59.67034427754885,Housing
61424,4746,56678,7.726621516019796,92.27337848398021,Transportation
82147,5562,76585,6.770788951513749,93.22921104848625,Transportation
227202,36073,191129,15.877060941364954,84.12293905863505,Entertainment
21002,3004,17998,14.303399676221312,85.69660032377868,Housing
29505,5875,23630,19.911879342484326,80.08812065751567,Housing
97762,44225,53537,45.237413309875,54.76258669012499,Transportation
185750,31300,154450,16.850605652759086,83.14939434724091,Entertainment
112179,64728,47451,57.70063915706148,42.29936084293852,Transportation
65945,7538,58407,11.430737735992116,88.56926226400789,Transportation
215020,47944,167076,22.29746070133011,77.70253929866989,Entertainment
103519,50206,53313,48.49930930553811,51.50069069446188,Transportation
172311,42189,130122,24.484217490467817,75.51578250953219,Healthcare
39827,21315,18512,53.518969543274665,46.481030456725335,Food
209850,30642,179208,14.601858470335955,85.39814152966404,Entertainment
136471,61233,75238,44.86887324046867,55.13112675953133,Healthcare
27880,675,27205,2.4210903873744622,97.57890961262554,Housing
171819,65615,106204,38.1884424888982,61.8115575111018,Healthcare
108890,49802,59088,45.73606391771513,54.26393608228487,Transportation
41516,18270,23246,44.00712978128914,55.992870218710856,Food
115975,10624,105351,9.16059495580944,90.83940504419056,Transportation
69975,12734,57241,18.197927831368347,81.80207216863165,Transportation
69572,734,68838,1.0550221353418041,98.9449778646582,Transportation
235289,39306,195983,16.705413342740204,83.2945866572598,Entertainment
71770,39237,32533,54.670475128883936,45.329524871116064,Transportation
232700,57145,175555,24.55737000429738,75.44262999570263,Entertainment
120875,29438,91437,24.354084798345397,75.6459152016546,Healthcare
76856,41140,35716,53.52867700634953,46.47132299365047,Transportation
14071,8122,5949,57.721554971217394,42.2784450287826,Housing
234781,63686,171095,27.125704379826303,72.87429562017368,Entertainment
205959,40287,165672,19.560689263397084,80.43931073660292,Entertainment
32599,15028,17571,46.09957360655235,53.90042639344765,Food
234835,12608,222227,5.368876019332723,94.63112398066727,Entertainment
195464,35409,160055,18.115356280440388,81.88464371955962,Entertainment
175794,46674,129120,26.55039421140653,73.44960578859346,Healthcare
45951,7563,38388,16.45883658679898,83.54116341320102,Food
136222,21879,114343,16.06128231856822,83.93871768143178,Healthcare
34287,10508,23779,30.647184063930936,69.35281593606906,Food
46597,8358,38239,17.93677704573256,82.06322295426745,Food
140358,69257,71101,49.343108337251884,50.656891662748116,Healthcare
12568,635,11933,5.052514322087842,94.94748567791216,Housing
28086,15301,12785,54.479099907427184,45.520900092572816,Housing
151479,36520,114959,24.108952396041698,75.8910476039583,Healthcare
49249,14329,34920,29.09500700521838,70.90499299478162,Food
125895,3654,122241,2.9024186822351963,97.0975813177648,Healthcare
196835,18021,178814,9.15538395102497,90.84461604897504,Entertainment
29558,2250,27308,7.61215237837472,92.38784762162527,Housing
225523,41693,183830,18.487249637509258,81.51275036249075,Entertainment
106694,35883,70811,33.63169437831556,66.36830562168444,Transportation
113186,46158,67028,40.780661919318646,59.21933808068136,Transportation
38028,15646,22382,41.143368044598716,58.856631955401284,Food
182620,36378,146242,19.920052568174352,80.07994743182564,Entertainment
21267,6326,14941,29.74561527248789,70.2543847275121,Housing
33880,13280,20600,39.19716646989374,60.80283353010626,Food
54537,31864,22673,58.426389423694005,41.57361057630599,Food
247236,17515,229721,7.084324289342976,92.91567571065701,Entertainment
15184,8274,6910,54.49157007376185,45.50842992623815,Housing
13407,18,13389,0.13425822331617812,99.86574177668382,Housing
126224,22108,104116,17.514894156420333,82.48510584357966,Healthcare
233299,25,233274,0.010715862476907317,99.9892841375231,Entertainment
124930,37005,87925,29.62058752901625,70.37941247098375,Healthcare
32303,11304,20999,34.9936538402006,65.0063461597994,Food
160854,66767,94087,41.507826973528786,58.49217302647121,Healthcare
206346,32914,173432,15.950878621344733,84.04912137865527,Entertainment
27870,11986,15884,43.00681736634374,56.99318263365626,Housing
89278,11102,78176,12.435314411165125,87.56468558883488,Transportation
148460,33999,114461,22.901118146302036,77.09888185369796,Healthcare
12993,4558,8435,35.08042792272762,64.91957207727238,Housing
16040,4758,11282,29.66334164588529,70.33665835411472,Housing
85789,10960,74829,12.775530662439241,87.22446933756076,Transportation
163004,59737,103267,36.64756693087286,63.35243306912714,Healthcare
176220,63132,113088,35.82567245488594,64.17432754511407,Healthcare
14976,1755,13221,11.71875,88.28125,Housing
21945,1789,20156,8.152198678514468,91.84780132148553,Housing
78965,33448,45517,42.358006711834356,57.64199328816564,Transportation
138676,23425,115251,16.89189189189189,83.1081081081081,Healthcare
30634,2231,28403,7.282757720180191,92.71724227981981,Food
212649,61646,151003,28.98955555869061,71.01044444130939,Entertainment
16631,9968,6663,59.9362636041128,40.0637363958872,Housing
175803,37921,137882,21.570166606940724,78.42983339305928,Healthcare
209541,58632,150909,27.98115881856057,72.01884118143943,Entertainment
60788,33288,27500,54.76080805422123,45.23919194577877,Transportation
11118,4985,6133,44.83720093542004,55.16279906457996,Housing
26800,15965,10835,59.57089552238806,40.429104477611936,Housing
29530,5632,23898,19.072130037250254,80.92786996274974,Housing
86860,10617,76243,12.22311766060327,87.77688233939674,Transportation
29049,7873,21176,27.10248201315019,72.8975179868498,Housing
29771,14632,15139,49.14850021833328,50.85149978166672,Housing
17591,2162,15429,12.290375760331989,87.70962423966802,Housing
175591,22010,153581,12.534811009675895,87.46518899032411,Healthcare
59110,12054,47056,20.392488580612415,79.60751141938758,Food
155584,35266,120318,22.66685520361991,77.3331447963801,Healthcare
87144,26938,60206,30.91205361241164,69.08794638758836,Transportation
10951,154,10797,1.4062642681033695,98.59373573189663,Housing
12555,638,11917,5.081640780565512,94.91835921943449,Housing
190762,8124,182638,4.258709805936193,95.74129019406381,Entertainment
117395,36924,80471,31.452787597427488,68.54721240257251,Transportation
110313,55875,54438,50.65132849256207,49.34867150743793,Transportation
231476,69439,162037,29.998358361125995,70.00164163887402,Entertainment
55438,3864,51574,6.969948410837332,93.03005158916267,Food
76792,44300,32492,57.6883008646734,42.3116991353266,Transportation
26051,2495,23556,9.577367471498215,90.4226325285018,Housing
158598,19617,138981,12.369008436424167,87.63099156357583,Healthcare
27288,9128,18160,33.45060099677514,66.54939900322486,Housing
140762,29875,110887,21.223767778235604,78.7762322217644,Healthcare
43609,11634,31975,26.6779793161962,73.3220206838038,Food
16832,2923,13909,17.3657319391635,82.6342680608365,Housing
28228,2084,26144,7.382740541306504,92.6172594586935,Housing
221172,14016,207156,6.337149367912756,93.66285063208724,Entertainment
137883,19067,118816,13.828390737074187,86.17160926292581,Healthcare
94765,13910,80855,14.678415026644858,85.32158497335514,Transportation
44840,6097,38743,13.597234611953613,86.40276538804639,Food
58249,28898,29351,49.611152122783224,50.38884787721678,Food
60007,17654,42353,29.419901011548653,70.58009898845134,Transportation
38846,833,38013,2.1443649281779336,97.85563507182206,Food
221238,64245,156993,29.038863124779652,70.96113687522035,Entertainment
86556,1347,85209,1.5562179398308609,98.44378206016914,Transportation
226468,46731,179737,20.63470335764876,79.36529664235124,Entertainment
21508,942,20566,4.379765668588432,95.62023433141157,Housing
125277,8965,116312,7.156141989351597,92.8438580106484,Healthcare
210106,32904,177202,15.660666520708594,84.3393334792914,Entertainment
122145,21820,100325,17.864014081624298,82.1359859183757,Healthcare
24392,11303,13089,46.338963594621184,53.661036405378816,Housing
173574,21398,152176,12.32788320831461,87.6721167916854,Healthcare
72707,16423,56284,22.587921383085536,77.41207861691447,Transportation
48149,4486,43663,9.316912085401565,90.68308791459843,Food
27646,14788,12858,53.49055921290603,46.50944078709397,Housing
46685,16054,30631,34.387919031808934,65.61208096819107,Food
10753,2839,7914,26.401934343904028,73.59806565609597,Housing
79744,33807,45937,42.394412118780096,57.6055878812199,Transportation
94407,34609,59798,36.65935788659739,63.34064211340261,Transportation
11826,5035,6791,42.57568070353459,57.42431929646542,Housing
75408,12147,63261,16.108370464672184,83.89162953532782,Transportation
123704,53337,70367,43.11663325357304,56.88336674642696,Healthcare
99642,45176,54466,45.33831115393107,54.66168884606893,Transportation
241452,11212,230240,4.643573049715886,95.35642695028412,Entertainment
17650,2329,15321,13.195467422096318,86.80453257790369,Housing
29154,9412,19742,32.28373465047678,67.71626534952321,Housing
88777,22341,66436,25.165301823670543,74.83469817632945,Transportation
21953,3579,18374,16.30301097799845,83.69698902200155,Housing
140725,54016,86709,38.3840824302718,61.6159175697282,Healthcare
22211,6090,16121,27.418846517491335,72.58115348250867,Housing
120445,42996,77449,35.69762132093487,64.30237867906513,Healthcare
22730,12573,10157,55.3145622525297,44.6854377474703,Housing
17064,8336,8728,48.851383028598214,51.148616971401786,Housing
21303,4970,16333,23.330047411162745,76.66995258883725,Housing
40331,19735,20596,48.93258287669535,51.06741712330466,Food
15755,5068,10687,32.16756585211044,67.83243414788956,Housing
95292,27321,67971,28.670822314569953,71.32917768543004,Transportation
236820,47635,189185,20.11443290262647,79.88556709737354,Entertainment
118567,16209,102358,13.670751558190727,86.32924844180927,Transportation
79840,26820,53020,33.59218436873748,66.40781563126252,Transportation
128149,35896,92253,28.01114327852734,71.98885672147266,Healthcare
226219,26888,199331,11.885827450390993,88.11417254960901,Entertainment
175355,30590,144765,17.444612357788486,82.55538764221151,Healthcare
249184,8500,240684,3.4111339411840245,96.58886605881598,Entertainment
214914,33269,181645,15.480145546590729,84.51985445340927,Entertainment
16668,5709,10959,34.251259899208065,65.74874010079193,Housing
55225,953,54272,1.7256677229515616,98.27433227704844,Food
201843,13283,188560,6.580857399067592,93.4191426009324,Entertainment
20065,1507,18558,7.510590580613008,92.48940941938699,Housing
36112,2231,33881,6.178001772264068,93.82199822773593,Food
70604,35117,35487,49.73797518554189,50.26202481445811,Transportation
90965,33031,57934,36.31176826251855,63.68823173748145,Transportation
58635,10463,48172,17.844290952502774,82.15570904749723,Food
169971,25291,144680,14.87959710774191,85.1204028922581,Healthcare
94285,45352,48933,48.10097046189744,51.89902953810256,Transportation
198404,55708,142696,28.07806294227939,71.92193705772061,Entertainment
200685,14952,185733,7.45048209881157,92.54951790118842,Entertainment
230037,29033,201004,12.621013141364216,87.37898685863578,Entertainment
32825,10175,22650,30.997715156131,69.002284843869,Food
214805,10819,203986,5.036661157794279,94.96333884220573,Entertainment
54719,21598,33121,39.47075056196203,60.52924943803798,Food
57038,429,56609,0.752130158841474,99.24786984115853,Food
228747,28970,199777,12.664646968047668,87.33535303195234,Entertainment
207301,33829,173472,16.31878283269256,83.68121716730744,Entertainment
203045,23910,179135,11.775714743037257,88.22428525696274,Entertainment
146925,7331,139594,4.989620554704781,95.01037944529523,Healthcare
23696,917,22779,3.86985145172181,96.1301485482782,Housing
58272,17774,40498,30.501784733662824,69.49821526633718,Food
49524,10627,38897,21.45828285275826,78.54171714724174,Food
142598,50991,91607,35.75856603879437,64.24143396120563,Healthcare
59084,32880,26204,55.64958364362602,44.35041635637398,Food
26239,11975,14264,45.63817218644004,54.36182781355997,Housing
178112,41379,136733,23.232011318720804,76.76798868127919,Healthcare
74863,36932,37931,49.33278121368366,50.66721878631634,Transportation
91328,40487,50841,44.33142081289419,55.66857918710581,Transportation
22598,8448,14150,37.3838392778122,62.61616072218781,Housing
11098,1686,9412,15.191926473238421,84.80807352676158,Housing
203804,13886,189918,6.8134089615512945,93.18659103844871,Entertainment
249352,22410,226942,8.987295068818376,91.01270493118162,Entertainment
154574,11748,142826,7.6002432491880905,92.39975675081192,Healthcare
171653,18397,153256,10.717552271151684,89.28244772884831,Healthcare
58133,23088,35045,39.715824058624186,60.28417594137581,Food
137073,55755,81318,40.67540653520387,59.32459346479612,Healthcare
12817,2991,9826,23.336194117188107,76.66380588281189,Housing
39860,12161,27699,30.509282488710486,69.49071751128952,Food
41154,24481,16673,59.486319677309616,40.513680322690384,Food
26084,818,25266,3.136022082502684,96.86397791749731,Housing
81281,38657,42624,47.55970029896286,52.44029970103714,Transportation
245570,42586,202984,17.341694832430672,82.65830516756932,Entertainment
11258,1735,9523,15.411263101794278,84.58873689820572,Housing
90564,33836,56728,37.36142396537255,62.63857603462745,Transportation
85477,5210,80267,6.0952068977619716,93.90479310223803,Transportation
10401,660,9741,6.345543697721373,93.65445630227863,Housing
154896,48304,106592,31.18479495919843,68.81520504080157,Healthcare
205770,52958,152812,25.73650191961899,74.26349808038101,Entertainment
17185,7944,9241,46.22636019784696,53.77363980215304,Housing
27606,6770,20836,24.523654278055496,75.47634572194451,Housing
230727,30111,200616,13.050488239347802,86.9495117606522,Entertainment
227822,60602,167220,26.6005916900036,73.3994083099964,Entertainment
91874,26624,65250,28.978818817075556,71.02118118292444,Transportation
147070,24664,122406,16.77024546134494,83.22975453865507,Healthcare
33625,16503,17122,49.079553903345726,50.920446096654274,Food
69899,15120,54779,21.631210746934862,78.36878925306515,Transportation
47473,11401,36072,24.015756324647693,75.9842436753523,Food
52431,24009,28422,45.7916118326944,54.2083881673056,Food
86913,9461,77452,10.885598241920082,89.11440175807992,Transportation
97371,34670,62701,35.606083946965725,64.39391605303427,Transportation
213726,27656,186070,12.939932436858406,87.0600675631416,Entertainment
72370,41479,30891,57.315185850490536,42.684814149509464,Transportation
39827,3750,36077,9.41572300198358,90.58427699801642,Food
44370,1428,42942,3.218390804597701,96.7816091954023,Food
47342,27113,20229,57.270499767648175,42.729500232351825,Food
224782,25266,199516,11.24022386134121,88.75977613865878,Entertainment
15702,3314,12388,21.105591644376513,78.8944083556235,Housing
148372,64198,84174,43.26827164154962,56.73172835845038,Healthcare
140023,28689,111334,20.48877684380423,79.51122315619577,Healthcare
203533,19638,183895,9.648558219060298,90.3514417809397,Entertainment
23577,9453,14124,40.09415956228528,59.905840437714716,Housing
60563,5622,54941,9.282895497250797,90.71710450274921,Transportation
61033,17600,43433,28.83685874854587,71.16314125145414,Transportation
126239,44805,81434,35.492201300707386,64.50779869929261,Healthcare
20531,5790,14741,28.20125663630607,71.79874336369393,Housing
49917,28146,21771,56.38560009615963,43.61439990384037,Food
178291,47077,131214,26.404585761479826,73.59541423852018,Healthcare
68702,867,67835,1.2619719949928676,98.73802800500712,Transportation
44672,1456,43216,3.259312320916905,96.7406876790831,Food
17307,1056,16251,6.101577396429191,93.89842260357081,Housing
20168,9397,10771,46.59361364537882,53.40638635462118,Housing
10762,3772,6990,35.04924735179335,64.95075264820666,Housing
95902,55496,40406,57.86740631060875,42.13259368939125,Transportation
66738,17647,49091,26.44220683868261,73.55779316131739,Transportation
142701,25968,116733,18.19748985641306,81.80251014358694,Healthcare
246967,57375,189592,23.23184878951439,76.76815121048561,Entertainment
25846,13147,12699,50.86667182542753,49.13332817457247,Housing
116250,38785,77465,33.36344086021506,66.63655913978495,Transportation
59759,7957,51802,13.31514918254991,86.68485081745008,Food
246998,9763,237235,3.952663584320521,96.04733641567947,Entertainment
29809,5597,24212,18.776208527625883,81.22379147237412,Housing
113829,54372,59457,47.76638642173787,52.23361357826213,Transportation
27985,12947,15038,46.2640700375201,53.7359299624799,Housing
136625,58141,78484,42.5551692589204,57.4448307410796,Healthcare
86608,49332,37276,56.96009606502863,43.03990393497136,Transportation
126713,42699,84014,33.69741068398665,66.30258931601335,Healthcare
22739,10242,12497,45.041558555785215,54.95844144421479,Housing
42652,14378,28274,33.710025321204164,66.28997467879584,Food
197472,13293,184179,6.731587263004375,93.26841273699561,Entertainment
41905,15138,26767,36.12456747404844,63.87543252595156,Food
49389,14630,34759,29.62198060296827,70.37801939703174,Food
14421,7280,7141,50.4819360654601,49.51806393453991,Housing
215376,39841,175535,18.498347076740213,81.5016529232598,Entertainment
58850,1605,57245,2.727272727272727,97.27272727272728,Food
85090,33887,51203,39.82489129157363,60.17510870842637,Transportation
113463,26022,87441,22.934348642288676,77.06565135771133,Transportation
102865,36066,66799,35.06148835852817,64.93851164147183,Transportation
106166,62218,43948,58.60444963547652,41.39555036452348,Transportation
15895,5805,10090,36.520918527838944,63.479081472161056,Housing
145409,40292,105117,27.709426514177256,72.29057348582275,Healthcare
179690,1024,178666,0.5698703322388557,99.43012966776115,Healthcare
93599,26950,66649,28.79304266071219,71.20695733928781,Transportation
40335,19153,21182,47.48481467707946,52.515185322920544,Food
154479,24892,129587,16.113517047624594,83.8864829523754,Healthcare
49807,17222,32585,34.577469030457564,65.42253096954244,Food
20610,10393,10217,50.426977195536146,49.573022804463854,Housing
138402,2693,135709,1.9457811303304866,98.05421886966951,Healthcare
16431,3028,13403,18.42858012293835,81.57141987706166,Housing
19912,8297,11615,41.668340699075934,58.331659300924066,Housing
221219,22153,199066,10.014058466949042,89.98594153305096,Entertainment
228482,27020,201462,11.825876874327081,88.17412312567292,Entertainment
50002,16176,33826,32.35070597176113,67.64929402823887,Food
249814,36555,213259,14.632886867829665,85.36711313217033,Entertainment
41340,1045,40295,2.5278180938558297,97.47218190614417,Food
105089,62988,42101,59.93776703556033,40.062232964439666,Transportation
42418,15843,26575,37.34971002876137,62.65028997123863,Food
118084,36740,81344,31.113444666508588,68.88655533349142,Transportation
56718,33907,22811,59.78172714129554,40.218272858704466,Food
124850,55518,69332,44.46776131357629,55.53223868642371,Healthcare
150276,68602,81674,45.65066943490644,54.34933056509356,Healthcare
101483,28220,73263,27.807613097760214,72.19238690223978,Transportation
47809,9106,38703,19.04662302077015,80.95337697922986,Food
70413,14833,55580,21.065712297445074,78.93428770255493,Transportation
38386,11901,26485,31.003490856041267,68.99650914395875,Food
135856,66438,69418,48.90325050052997,51.09674949947003,Healthcare
139286,65671,73615,47.14831354192094,52.85168645807906,Healthcare
80330,30973,49357,38.557201543632516,61.442798456367484,Transportation
78407,4539,73868,5.789023939189103,94.21097606081089,Transportation
198329,17561,180768,8.854479173494546,91.14552082650546,Entertainment
46145,17571,28574,38.07779824466356,61.92220175533644,Food
24076,12356,11720,51.32081741153015,48.67918258846984,Housing
58046,25718,32328,44.30623987871688,55.69376012128312,Food
180421,53088,127333,29.424512667594126,70.57548733240587,Entertainment
45860,22154,23706,48.307893589184474,51.69210641081553,Food
186925,3261,183664,1.7445499531897821,98.25545004681022,Entertainment
57027,10430,46597,18.289582127764042,81.71041787223596,Food
167233,54308,112925,32.474451812740305,67.52554818725969,Healthcare
61624,4093,57531,6.64189276905102,93.35810723094899,Transportation
73459,32956,40503,44.863120924597396,55.136879075402604,Transportation
47902,24250,23652,50.62419105674084,49.37580894325915,Food
85715,40310,45405,47.02794143382138,52.97205856617862,Transportation
161258,32191,129067,19.962420469062,80.03757953093799,Healthcare
145306,3002,142304,2.065984887065916,97.93401511293408,Healthcare
28327,16278,12049,57.464609736293994,42.535390263706,Housing
43406,23431,19975,53.9810164493388,46.0189835506612,Food
179282,1812,177470,1.0106982296047566,98.98930177039524,Healthcare
59735,30002,29733,50.22516112831673,49.77483887168327,Food
38344,22596,15748,58.92968912998122,41.07031087001878,Food
86190,42461,43729,49.2644158255018,50.73558417449821,Transportation
189889,56445,133444,29.725260546951116,70.27473945304888,Entertainment
46685,16565,30120,35.48248902216986,64.51751097783014,Food
49568,25231,24337,50.90179147837315,49.09820852162686,Food
73397,37070,36327,50.50615147758083,49.49384852241917,Transportation
31254,2020,29234,6.463172713892622,93.53682728610738,Food
160459,29823,130636,18.58605625112957,81.41394374887044,Healthcare
179329,59714,119615,33.29857412911464,66.70142587088536,Healthcare
211043,20559,190484,9.741616637367741,90.25838336263226,Entertainment
61508,33647,27861,54.703453209338626,45.29654679066138,Transportation
167644,43325,124319,25.843453985827107,74.15654601417289,Healthcare
81753,39039,42714,47.75237605959414,52.24762394040585,Transportation
105894,21451,84443,20.25704950233252,79.74295049766748,Transportation
106224,17213,89011,16.204435909022443,83.79556409097756,Transportation
22281,90,22191,0.40393160091557834,99.59606839908443,Housing
232593,28495,204098,12.251013573065398,87.74898642693461,Entertainment
239738,6701,233037,2.795134688701833,97.20486531129818,Entertainment
132351,66340,66011,50.12429071181933,49.87570928818067,Healthcare
24271,14155,10116,58.32062955790861,41.67937044209138,Housing
122455,35400,87055,28.90857866154914,71.09142133845086,Healthcare
28318,5109,23209,18.041528356522356,81.95847164347765,Housing
47430,13449,33981,28.355471220746363,71.64452877925363,Food
180731,41892,138839,23.179200026558807,76.82079997344118,Entertainment
21878,5517,16361,25.21711308163452,74.78288691836548,Housing
60774,13764,47010,22.64784282752493,77.35215717247506,Transportation
202143,55603,146540,27.50676501288692,72.49323498711308,Entertainment
166740,4619,162121,2.770181120307065,97.22981887969293,Healthcare
105348,3200,102148,3.0375517333029576,96.96244826669704,Transportation
24985,13506,11479,54.05643386031619,45.94356613968381,Housing
11789,199,11590,1.6880142505725677,98.31198574942744,Housing
195603,19779,175824,10.111808101102744,89.88819189889725,Entertainment
101082,11007,90075,10.889179082329198,89.1108209176708,Transportation
15341,6274,9067,40.89694283293136,59.10305716706864,Housing
209354,43197,166157,20.633472491569304,79.36652750843069,Entertainment
59853,1810,58043,3.0240756520141012,96.9759243479859,Food
24394,14207,10187,58.23973108141346,41.76026891858653,Housing
206960,52524,154436,25.378817162736762,74.62118283726325,Entertainment
33820,19602,14218,57.959787108219984,42.04021289178001,Food
75177,17016,58161,22.634582385570052,77.36541761442994,Transportation
171195,63795,107400,37.26452291246824,62.73547708753176,Healthcare
247942,66236,181706,26.71431221818006,73.28568778181995,Entertainment
51378,815,50563,1.5862820662540387,98.41371793374596,Food
56093,15762,40331,28.09976289376571,71.90023710623429,Food
102295,44971,57324,43.962070482428274,56.037929517571726,Transportation
82962,8532,74430,10.284226513343459,89.71577348665654,Transportation
195457,39689,155768,20.305744997620963,79.69425500237904,Entertainment
183196,2023,181173,1.1042817528767004,98.8957182471233,Entertainment
37219,19061,18158,51.21309008839571,48.78690991160429,Food
32077,11457,20620,35.71718053433924,64.28281946566075,Food
54346,13724,40622,25.253008501085638,74.74699149891435,Food
229692,29031,200661,12.639099315605245,87.36090068439476,Entertainment
66231,14248,51983,21.512584741284293,78.48741525871571,Transportation
45696,18709,26987,40.94231442577031,59.05768557422969,Food
56424,3895,52529,6.903090883312066,93.09690911668793,Food
12624,4939,7685,39.123891001267424,60.87610899873257,Housing
50672,5629,45043,11.108699084306915,88.89130091569308,Food
107454,50777,56677,47.254639194446,52.74536080555401,Transportation
184486,49273,135213,26.708259705343494,73.2917402946565,Entertainment
178446,3326,175120,1.8638691817132353,98.13613081828676,Healthcare
61566,34691,26875,56.34765942240847,43.652340577591524,Transportation
184148,24340,159808,13.21762929817321,86.78237070182679,Entertainment
16274,3184,13090,19.56495022735652,80.43504977264348,Housing
139475,56217,83258,40.306148055207025,59.693851944792975,Healthcare
54630,13516,41114,24.740984806882665,75.25901519311734,Food
13971,1013,12958,7.250733662586787,92.74926633741322,Housing
13853,1095,12758,7.904425034288602,92.0955749657114,Housing
172667,31411,141256,18.191663722656905,81.8083362773431,Healthcare
131396,60714,70682,46.206886054369996,53.79311394563,Healthcare
36391,15048,21343,41.3508834601962,58.6491165398038,Food
20349,3751,16598,18.433338247579734,81.56666175242026,Housing
24523,5128,19395,20.91098152754557,79.08901847245443,Housing
95298,55976,39322,58.73785388990325,41.26214611009675,Transportation
69511,15156,54355,21.80374329242854,78.19625670757146,Transportation
156372,22190,134182,14.190520041951244,85.80947995804875,Healthcare
208191,18058,190133,8.673765916874409,91.32623408312558,Entertainment
38333,19165,19168,49.996086922494975,50.003913077505025,Food
38987,22841,16146,58.58619539846616,41.41380460153384,Food
12160,4241,7919,34.8766447368421,65.12335526315789,Housing
238913,27136,211777,11.358109437326558,88.64189056267344,Entertainment
143268,30816,112452,21.509339140631546,78.49066085936846,Healthcare
133422,15984,117438,11.980033277870216,88.01996672212978,Healthcare
23584,10602,12982,44.95420624151967,55.04579375848032,Housing
45932,12984,32948,28.26787424888966,71.73212575111033,Food
32748,1744,31004,5.325516062049591,94.6744839379504,Food
169123,53175,115948,31.441613500233558,68.55838649976644,Healthcare
183107,39222,143885,21.420262469485056,78.57973753051495,Entertainment
25044,7369,17675,29.42421338444338,70.57578661555662,Housing
85120,1304,83816,1.531954887218045,98.46804511278195,Transportation
222877,56962,165915,25.557594547665303,74.4424054523347,Entertainment
244677,4040,240637,1.6511564225489113,98.34884357745108,Entertainment
19172,7042,12130,36.730648862925094,63.269351137074906,Housing
21287,2578,18709,12.110677878517405,87.88932212148259,Housing
57085,21945,35140,38.442673206621706,61.557326793378294,Food
14959,7239,7720,48.39227221070927,51.60772778929073,Housing
230824,20349,210475,8.81580771496898,91.18419228503102,Entertainment
128247,6417,121830,5.003625815808557,94.99637418419144,Healthcare
75759,18864,56895,24.90001187977666,75.09998812022334,Transportation
102073,7617,94456,7.462306388565046,92.53769361143496,Transportation
39683,9432,30251,23.768364286974272,76.23163571302572,Food
156892,11241,145651,7.16480126456416,92.83519873543584,Healthcare
213433,31717,181716,14.860401156334774,85.13959884366523,Entertainment
13642,2813,10829,20.620143673948103,79.37985632605191,Housing
220112,28672,191440,13.026095805771606,86.9739041942284,Entertainment
21973,8682,13291,39.51212852136713,60.48787147863287,Housing
58967,21953,37014,37.229297742805294,62.7707022571947,Food
185707,31732,153975,17.08713187978913,82.91286812021087,Entertainment
127156,54907,72249,43.180817263833404,56.819182736166596,Healthcare
126905,64986,61919,51.208384224419845,48.79161577558016,Healthcare
24893,13252,11641,53.235849435584306,46.7641505644157,Housing
35806,15835,19971,44.22443165949841,55.77556834050159,Food
187165,18728,168437,10.006144311169288,89.99385568883072,Entertainment
135372,18265,117107,13.492450432881245,86.50754956711876,Healthcare
122859,10965,111894,8.924865089248652,91.07513491075136,Healthcare
51633,2424,49209,4.694672012085294,95.3053279879147,Food
124421,23956,100465,19.253984456000193,80.7460155439998,Healthcare
102063,4447,97616,4.3571127636851745,95.64288723631482,Transportation
242758,973,241785,0.40081068389095315,99.59918931610905,Entertainment
21401,3258,18143,15.22358768281856,84.77641231718144,Housing
15525,6729,8796,43.34299516908213,56.65700483091788,Housing
51495,17236,34259,33.47121079716477,66.52878920283523,Food
135363,18179,117184,13.429814646542997,86.57018535345699,Healthcare
107128,37215,69913,34.73881711597341,65.26118288402658,Transportation
232774,68315,164459,29.348208992413245,70.65179100758677,Entertainment
27254,5448,21806,19.98972627871138,80.01027372128861,Housing
120926,16139,104787,13.346178654714452,86.65382134528554,Healthcare
205886,69039,136847,33.53263456475914,66.46736543524086,Entertainment
118013,3603,114410,3.0530534771592963,96.9469465228407,Transportation
77494,32867,44627,42.41231579219036,57.587684207809644,Transportation
91581,26084,65497,28.481890348434717,71.51810965156528,Transportation
17014,3005,14009,17.661925473139767,82.33807452686023,Housing
151676,48186,103490,31.769033993512487,68.23096600648752,Healthcare
56768,16482,40286,29.033962795941378,70.96603720405864,Food
46498,26659,19839,57.33364875908641,42.666351240913585,Food
54331,10578,43753,19.469547771990207,80.53045222800979,Food
16686,2490,14196,14.922689679971231,85.07731032002877,Housing
127816,54512,73304,42.648807661012704,57.35119233898729,Healthcare
225098,8175,216923,3.6317515037894608,96.36824849621054,Entertainment
226003,43643,182360,19.310805608775105,80.68919439122489,Entertainment
73765,2165,71600,2.934996271944689,97.06500372805532,Transportation
26340,10419,15921,39.55580865603645,60.44419134396355,Housing
43619,15100,28519,34.6179417226438,65.38205827735621,Food
153026,5844,147182,3.8189588697345545,96.18104113026544,Healthcare
219931,30310,189621,13.781595136656497,86.2184048633435,Entertainment
13161,120,13041,0.9117848187827673,99.08821518121724,Housing
31628,4572,27056,14.45554571898318,85.54445428101683,Food
75007,26908,48099,35.87398509472449,64.12601490527551,Transportation
47036,24786,22250,52.69580746662131,47.30419253337869,Food
148308,4897,143411,3.3019122366966047,96.69808776330339,Healthcare
25896,9417,16479,36.364689527340126,63.63531047265987,Housing
15806,3675,12131,23.25066430469442,76.74933569530558,Housing
142831,64246,78585,44.98043141894967,55.019568581050336,Healthcare
171872,61360,110512,35.70098678086018,64.29901321913982,Healthcare
104796,23292,81504,22.226039161800067,77.77396083819993,Transportation
33870,9455,24415,27.915559492175966,72.08444050782403,Food
25359,7526,17833,29.677826412713436,70.32217358728656,Housing
140681,3460,137221,2.4594650308143957,97.5405349691856,Healthcare
57510,31598,25912,54.943488089027994,45.056511910972006,Food
81975,10456,71519,12.75510826471485,87.24489173528515,Transportation
37475,21016,16459,56.08005336891261,43.91994663108739,Food
196731,16381,180350,8.326598248369601,91.67340175163041,Entertainment
32454,5740,26714,17.686571763110866,82.31342823688912,Food
21208,10196,11012,48.0761976612599,51.9238023387401,Housing
18855,4071,14784,21.591089896579156,78.40891010342085,Housing
40060,7475,32585,18.65951073389915,81.34048926610085,Food
247077,17472,229605,7.071479741133331,92.92852025886667,Entertainment
130932,65303,65629,49.87550789722909,50.1244921027709,Healthcare
108912,54664,54248,50.19097987365947,49.80902012634053,Transportation
153893,20113,133780,13.069470346279557,86.93052965372044,Healthcare
71223,2574,68649,3.614001095151847,96.38599890484815,Transportation
75007,26337,48670,35.11272281253749,64.8872771874625,Transportation
226433,26706,199727,11.794217273983916,88.20578272601608,Entertainment
57047,18605,38442,32.61345907760268,67.38654092239732,Food
127247,13113,114134,10.305154541953838,89.69484545804616,Healthcare
11101,1023,10078,9.215386001261146,90.78461399873885,Housing
52692,351,52341,0.6661352767023457,99.33386472329765,Food
20050,1163,18887,5.800498753117207,94.19950124688279,Housing
30970,13534,17436,43.70035518243461,56.29964481756539,Food
47032,3013,44019,6.40627657764926,93.59372342235073,Food
43220,7660,35560,17.723276260990282,82.27672373900971,Food
157333,61723,95610,39.230803455092065,60.769196544907935,Healthcare
140292,34568,105724,24.640036495309783,75.35996350469021,Healthcare
59072,19053,40019,32.253859696641385,67.74614030335862,Food
27400,9901,17499,36.13503649635037,63.86496350364963,Housing
110592,48207,62385,43.58995225694444,56.41004774305556,Transportation
224620,62990,161630,28.042916926364526,71.95708307363547,Entertainment
37577,109,37468,0.2900710541022434,99.70992894589776,Food
174423,33728,140695,19.33689937680237,80.66310062319762,Healthcare
56754,25476,31278,44.888466011206255,55.11153398879374,Food
56514,8814,47700,15.596135470856778,84.40386452914322,Food
101159,54717,46442,54.090095789796266,45.90990421020374,Transportation
17297,6788,10509,39.24379950280395,60.75620049719605,Housing
134351,35788,98563,26.637687847503926,73.36231215249607,Healthcare
12672,733,11939,5.784406565656566,94.21559343434343,Housing
14959,6901,8058,46.132762885219606,53.867237114780394,Housing
248662,16593,232069,6.672913432691767,93.32708656730824,Entertainment
163904,10827,153077,6.605696017180788,93.39430398281921,Healthcare
13815,1735,12080,12.558812884545784,87.44118711545423,Housing
237385,64384,173001,27.122185479284706,72.87781452071529,Entertainment
129556,29292,100264,22.609527926147766,77.39047207385224,Healthcare
32472,4371,28101,13.460827790096083,86.53917220990391,Food
100002,44736,55266,44.73510529789404,55.26489470210596,Transportation
19352,9428,9924,48.71847871021083,51.28152128978917,Housing
18194,7060,11134,38.804001319116196,61.19599868088381,Housing
53715,23706,30009,44.13292376431164,55.86707623568835,Food
151013,18,150995,0.011919503618893736,99.9880804963811,Healthcare
121281,68110,53171,56.15883774045398,43.84116225954601,Healthcare
189685,63412,126273,33.430160529298576,66.56983947070142,Entertainment
179417,64095,115322,35.724039528026886,64.27596047197312,Healthcare
179863,52396,127467,29.131060862990164,70.86893913700983,Healthcare
155119,214,154905,0.13795859952681488,99.86204140047319,Healthcare
172124,68571,103553,39.8381399456206,60.1618600543794,Healthcare
59623,14693,44930,24.643174613823522,75.35682538617647,Food
72167,26358,45809,36.52361882855045,63.47638117144956,Transportation
154940,52571,102369,33.92990835161998,66.07009164838001,Healthcare
64478,16103,48375,24.974409876236855,75.02559012376314,Transportation
11220,4257,6963,37.94117647058823,62.05882352941177,Housing
135849,16541,119308,12.176018962230122,87.82398103776987,Healthcare
193220,38793,154427,20.077114170375737,79.92288582962426,Entertainment
211226,41619,169607,19.70354028386657,80.29645971613343,Entertainment
223088,31901,191187,14.29973821989529,85.70026178010471,Entertainment
23553,7417,16136,31.49068059270581,68.50931940729419,Housing
243359,65329,178030,26.844702682045867,73.15529731795414,Entertainment
26757,11341,15416,42.38517023582614,57.614829764173855,Housing
191635,68283,123352,35.63180003652777,64.36819996347222,Entertainment
142702,34235,108467,23.990553741363122,76.00944625863688,Healthcare
60787,10232,50555,16.8325464326254,83.16745356737461,Transportation
15250,1876,13374,12.301639344262295,87.6983606557377,Housing
46532,7978,38554,17.14519040660191,82.85480959339809,Food
109483,53240,56243,48.62855420476238,51.37144579523761,Transportation
76468,7004,69464,9.159386933096197,90.84061306690381,Transportation
246984,3307,243677,1.3389531305671623,98.66104686943284,Entertainment
243082,32430,210652,13.341177051365383,86.65882294863462,Entertainment
154814,58089,96725,37.521800353973155,62.478199646026845,Healthcare
22487,8006,14481,35.60279272468537,64.39720727531463,Housing
215035,65050,149985,30.250889390099285,69.74911060990071,Entertainment
179758,13127,166631,7.302595712012818,92.69740428798718,Healthcare
29629,14819,14810,50.01518782274124,49.98481217725877,Housing
10505,22,10483,0.20942408376963353,99.79057591623037,Housing
97136,28252,68884,29.08499423488717,70.91500576511282,Transportation
107123,39809,67314,37.161954015477534,62.83804598452246,Transportation
46261,8274,37987,17.885475886816106,82.11452411318389,Food
10070,739,9331,7.33862959285005,92.66137040714995,Housing
227008,55821,171187,24.589882294897098,75.4101177051029,Entertainment
58266,25640,32626,44.00508014965847,55.99491985034154,Food
90133,44140,45993,48.97207460086761,51.02792539913239,Transportation
132538,55209,77329,41.655223407626494,58.344776592373506,Healthcare
10545,4861,5684,46.09767662399241,53.90232337600759,Housing
105633,13356,92277,12.643776092698305,87.3562239073017,Transportation
110721,40674,70047,36.735578616522616,63.264421383477384,Transportation
168390,38975,129415,23.14567373359463,76.85432626640537,Healthcare
41919,4174,37745,9.957298599680337,90.04270140031967,Food
35998,19776,16222,54.93638535474194,45.06361464525807,Food
157146,48861,108285,31.092741781528005,68.907258218472,Healthcare
171662,67277,104385,39.19155083827521,60.80844916172479,Healthcare
72967,9689,63278,13.27860539696027,86.72139460303973,Transportation
237072,49879,187193,21.039599784031857,78.96040021596814,Entertainment
11212,5411,5801,48.260792008562255,51.73920799143774,Housing
40311,11562,28749,28.68199746967329,71.31800253032671,Food
38106,21210,16896,55.66052590143285,44.33947409856715,Food
231905,57596,174309,24.836031995860374,75.16396800413962,Entertainment
28723,13725,14998,47.784005848971205,52.21599415102879,Housing
126256,56622,69634,44.84697756938284,55.15302243061716,Healthcare
27527,10518,17009,38.20975769244742,61.79024230755259,Housing
234052,15562,218490,6.648949806026011,93.35105019397399,Entertainment
23553,11404,12149,48.41846049335541,51.58153950664459,Housing
93417,38327,55090,41.02786430735305,58.972135692646944,Transportation
40902,3759,37143,9.190259645005135,90.80974035499486,Food
167728,54772,112956,32.6552513593437,67.3447486406563,Healthcare
191344,1261,190083,0.659022493519525,99.34097750648047,Entertainment
135222,1647,133575,1.217997071482451,98.78200292851756,Healthcare
17277,10363,6914,59.981478265902645,40.018521734097355,Housing
18652,3049,15603,16.346772464078917,83.65322753592108,Housing
42204,1561,40643,3.6987015448772627,96.30129845512275,Food
20053,5271,14782,26.285343838827107,73.71465616117288,Housing
97465,33948,63517,34.83096496178115,65.16903503821885,Transportation
48560,20226,28334,41.651565074135085,58.348434925864915,Food
47877,27070,20807,56.54071892558014,43.45928107441987,Food
131248,435,130813,0.3314336218456662,99.66856637815434,Healthcare
220715,50941,169774,23.07999003239472,76.92000996760528,Entertainment
133231,28326,104905,21.260817677567534,78.73918232243247,Healthcare
132304,46156,86148,34.88632240899746,65.11367759100254,Healthcare
59266,16734,42532,28.235413221746025,71.76458677825397,Food
103205,41841,61364,40.54164042439805,59.45835957560196,Transportation
238712,40673,198039,17.038523408961424,82.96147659103858,Entertainment
181655,4815,176840,2.6506289394731772,97.34937106052682,Entertainment
101441,60082,41359,59.228517069035206,40.771482930964794,Transportation
21990,9179,12811,41.74170077307867,58.25829922692133,Housing
119965,53849,66116,44.887258783811944,55.112741216188056,Transportation
24346,12128,12218,49.81516470878173,50.18483529121826,Housing
122653,37721,84932,30.7542416410524,69.2457583589476,Healthcare
68887,24556,44331,35.64678386342852,64.35321613657149,Transportation
58016,34625,23391,59.681811913954775,40.31818808604523,Food
178262,21586,156676,12.109142722509565,87.89085727749043,Healthcare
57527,7451,50076,12.952178976828272,87.04782102317172,Food
23378,12637,10741,54.05509453332192,45.94490546667807,Housing
95840,12359,83481,12.895450751252085,87.10454924874792,Transportation
122797,42779,80018,34.83717028917644,65.16282971082356,Healthcare
161385,66299,95086,41.081265297270505,58.9187347027295,Healthcare
170099,62539,107560,36.766236133075445,63.233763866924555,Healthcare
245494,33693,211801,13.72457167995959,86.2754283200404,Entertainment
219420,38388,181032,17.495214656822533,82.50478534317747,Entertainment
127118,20694,106424,16.279362482103245,83.72063751789676,Healthcare
204894,5381,199513,2.6262360049586615,97.37376399504134,Entertainment
247705,4775,242930,1.9276962515895926,98.0723037484104,Entertainment
37626,3259,34367,8.661563812257482,91.33843618774252,Food
128253,45775,82478,35.69117291603315,64.30882708396685,Healthcare
53685,9907,43778,18.453944304740617,81.54605569525938,Food
80971,5657,75314,6.986451939583308,93.0135480604167,Transportation
170652,30372,140280,17.797623233246608,82.20237676675339,Healthcare
162592,50936,111656,31.32749458767959,68.6725054123204,Healthcare
27316,9684,17632,35.451749890174256,64.54825010982574,Housing
27738,4052,23686,14.60811882615906,85.39188117384094,Housing
11190,2588,8602,23.127792672028598,76.8722073279714,Housing
243886,42863,201023,17.57501455598107,82.42498544401893,Entertainment
44681,13218,31463,29.583044246995367,70.41695575300463,Food
227805,43385,184420,19.0447970852264,80.95520291477361,Entertainment
121802,11074,110728,9.091804732270406,90.9081952677296,Healthcare
219971,60035,159936,27.292233976296878,72.70776602370313,Entertainment
34374,1349,33025,3.924477802990632,96.07552219700936,Food
33415,11392,22023,34.09247344007183,65.90752655992817,Food
73918,13095,60823,17.715576720149354,82.28442327985064,Transportation
65068,5749,59319,8.835372225978976,91.16462777402103,Transportation
48159,15142,33017,31.441682759193508,68.5583172408065,Food
134203,30701,103502,22.876537782314852,77.12346221768514,Healthcare
128929,11266,117663,8.738142698694631,91.26185730130537,Healthcare
43349,6044,37305,13.942651502918176,86.05734849708182,Food
26129,15166,10963,58.042787707145315,41.957212292854685,Housing
241046,20919,220127,8.678426524397832,91.32157347560216,Entertainment
32196,18082,14114,56.16225618089204,43.83774381910796,Food
41708,11593,30115,27.79562673827563,72.20437326172437,Food
89691,27124,62567,30.241607296161266,69.75839270383874,Transportation
233411,9074,224337,3.887563139697786,96.11243686030221,Entertainment
14708,1739,12969,11.823497416372042,88.17650258362796,Housing
221066,29931,191135,13.539395474654627,86.46060452534537,Entertainment
180946,23510,157436,12.992826589148143,87.00717341085186,Entertainment
27790,6813,20977,24.51601295430011,75.48398704569989,Housing
58416,10281,48135,17.599630238290878,82.40036976170913,Food
191906,27887,164019,14.531593592696424,85.46840640730358,Entertainment
42383,19918,22465,46.99525753250124,53.004742467498765,Food
52638,25973,26665,49.342680193016456,50.657319806983544,Food
26976,8828,18148,32.72538552787663,67.27461447212337,Housing
27136,656,26480,2.4174528301886795,97.58254716981132,Housing
212010,18745,193265,8.84156407716617,91.15843592283383,Entertainment
49587,26981,22606,54.411438481860166,45.588561518139834,Food
120168,65449,54719,54.46458291724918,45.53541708275082,Healthcare
45813,2890,42923,6.308253115927793,93.6917468840722,Food
109907,61913,47994,56.332171745202764,43.667828254797236,Transportation
247250,52681,194569,21.306774519716885,78.69322548028312,Entertainment
116995,58631,58364,50.11410744048891,49.88589255951109,Transportation
66917,16623,50294,24.841221214340152,75.15877878565985,Transportation
160786,60866,99920,37.85528590797706,62.14471409202294,Healthcare
29018,7994,21024,27.548418223171822,72.45158177682818,Housing
93862,4032,89830,4.295668108499712,95.70433189150029,Transportation
233050,46960,186090,20.150182364299507,79.84981763570049,Entertainment
196049,46519,149530,23.728251610566748,76.27174838943326,Entertainment
14480,8341,6139,57.603591160220994,42.396408839779006,Housing
192128,62145,129983,32.34562375083278,67.65437624916723,Entertainment
47439,1836,45603,3.870233352305066,96.12976664769494,Food
12080,5845,6235,48.38576158940398,51.61423841059602,Housing
169899,50761,119138,29.877162314080717,70.12283768591928,Healthcare
28937,15125,13812,52.26872170577461,47.73127829422539,Housing
43625,25852,17773,59.25959885386819,40.7404011461318,Food
185536,48315,137221,26.0407683684029,73.9592316315971,Entertainment
28708,3276,25432,11.411453253448515,88.58854674655149,Housing
138945,1999,136946,1.4386987656986576,98.56130123430134,Healthcare
139884,56674,83210,40.51499814131709,59.48500185868291,Healthcare
121951,37517,84434,30.763995375191676,69.23600462480832,Healthcare
46317,8765,37552,18.923937215277327,81.07606278472267,Food
181097,63432,117665,35.026532742121624,64.97346725787837,Entertainment
52836,1930,50906,3.6528124763418877,96.3471875236581,Food
220413,39896,180517,18.100565756103315,81.89943424389668,Entertainment
146358,22604,123754,15.444321458341875,84.55567854165812,Healthcare
51011,12755,38256,25.004410813353985,74.99558918664601,Food
216466,32714,183752,15.11276597710495,84.88723402289506,Entertainment
138406,36432,101974,26.322558270595202,73.67744172940479,Healthcare
47375,26331,21044,55.57994722955145,44.42005277044855,Food
208338,65750,142588,31.559293071835192,68.4407069281648,Entertainment
171259,52437,118822,30.6185368360203,69.3814631639797,Healthcare
18503,489,18014,2.642814678700751,97.35718532129924,Housing
67578,29356,38222,43.440172837313916,56.559827162686084,Transportation
170324,31250,139074,18.347384983913013,81.65261501608698,Healthcare
13711,529,13182,3.8582160309240754,96.14178396907592,Housing
18419,2597,15822,14.099571095064878,85.90042890493513,Housing
103436,57771,45665,55.851927762094434,44.148072237905566,Transportation
206168,16199,189969,7.857184432113616,92.14281556788639,Entertainment
41753,2644,39109,6.332479103297967,93.66752089670203,Food
95799,3648,92151,3.8079729433501392,96.19202705664986,Transportation
189246,69845,119401,36.90698878708136,63.09301121291864,Entertainment
109019,23806,85213,21.836560599528525,78.16343940047147,Transportation
20871,9987,10884,47.8510852378899,52.14891476211011,Housing
132325,63663,68662,48.11109011902513,51.88890988097488,Healthcare
84381,3466,80915,4.107559758713455,95.89244024128655,Transportation
28147,3491,24656,12.40274274345401,87.59725725654599,Housing
81350,1015,80335,1.2476951444376152,98.75230485556239,Transportation
229103,2591,226512,1.1309323753944733,98.86906762460552,Entertainment
200144,50843,149301,25.403209689023903,74.5967903109761,Entertainment
80602,3198,77404,3.96764348279199,96.032356517208,Transportation
180215,60514,119701,33.57878090059096,66.42121909940903,Entertainment
33785,17465,16320,51.694538996596116,48.30546100340388,Food
21519,5808,15711,26.99010177052837,73.00989822947163,Housing
72399,902,71497,1.2458735617895276,98.75412643821048,Transportation
18458,9574,8884,51.8691082457471,48.1308917542529,Housing
87286,51260,36026,58.726485347020144,41.273514652979856,Transportation
145830,35938,109892,24.64376328601797,75.35623671398204,Healthcare
29447,11842,17605,40.21462288178762,59.78537711821238,Housing
67657,13092,54565,19.350547615176552,80.64945238482345,Transportation
46479,25687,20792,55.26581897200886,44.73418102799114,Food
44397,6879,37518,15.494290154740185,84.50570984525982,Food
25501,12700,12801,49.80196855025293,50.19803144974707,Housing
31808,8066,23742,25.35840040241449,74.64159959758551,Food
110242,2770,107472,2.5126539794270784,97.48734602057291,Transportation
164984,14249,150735,8.636595063763759,91.36340493623624,Healthcare
164881,26096,138785,15.827172324282362,84.17282767571764,Healthcare
66844,25467,41377,38.09915624438992,61.90084375561008,Transportation
64190,16648,47542,25.935503972581397,74.0644960274186,Transportation
160812,65157,95655,40.517498694127305,59.482501305872695,Healthcare
16824,8487,8337,50.44579172610556,49.55420827389443,Housing
74465,39183,35282,52.61935137312832,47.38064862687168,Transportation
98735,13305,85430,13.475464627538361,86.52453537246164,Transportation
152677,50896,101781,33.33573491750558,66.66426508249441,Healthcare
17244,5443,11801,31.56460218046857,68.43539781953143,Housing
37047,2580,34467,6.964126649931169,93.03587335006883,Food
36326,1324,35002,3.6447723393712494,96.35522766062876,Food
149136,7037,142099,4.718511962235811,95.28148803776418,Healthcare
187252,16196,171056,8.6493068164826,91.3506931835174,Entertainment
49724,8720,41004,17.536803153406805,82.46319684659319,Food
69964,35883,34081,51.28780515693785,48.71219484306214,Transportation
58346,30931,27415,53.01306002125252,46.98693997874747,Food
58848,5474,53374,9.301930396954866,90.69806960304513,Food
31165,17570,13595,56.37734638215947,43.62265361784053,Food
121770,50244,71526,41.26139443212614,58.73860556787386,Healthcare
83731,3787,79944,4.5228171167190165,95.47718288328099,Transportation
73139,25445,47694,34.78992056221715,65.21007943778285,Transportation
22778,12257,10521,53.81069452980947,46.18930547019053,Housing
84560,3577,80983,4.2301324503311255,95.76986754966887,Transportation
81845,47462,34383,57.99010324393671,42.00989675606329,Transportation
104997,58567,46430,55.779688943493625,44.220311056506375,Transportation
239053,37205,201848,15.563494287877583,84.43650571212241,Entertainment
58826,3164,55662,5.378574099887805,94.6214259001122,Food
41684,16667,25017,39.984166586699935,60.015833413300065,Food
249676,49985,199691,20.01994584982137,79.98005415017863,Entertainment
92955,32097,60858,34.5296111021462,65.47038889785381,Transportation
132177,17948,114229,13.578761811812948,86.42123818818706,Healthcare
185291,46234,139057,24.952102368706523,75.04789763129348,Entertainment
67486,28256,39230,41.86942476958183,58.13057523041816,Transportation
201895,40264,161631,19.943039698853365,80.05696030114665,Entertainment
200192,37390,162802,18.677070012787723,81.32292998721228,Entertainment
93630,11624,82006,12.414824308448146,87.58517569155185,Transportation
17598,2345,15253,13.325377883850436,86.67462211614956,Housing
207724,50435,157289,24.27981359881381,75.72018640118618,Entertainment
48098,21527,26571,44.75653873341927,55.24346126658073,Food
36194,19883,16311,54.93451953362436,45.06548046637564,Food
46507,19166,27341,41.21100049454921,58.78899950545079,Food
160375,16050,144325,10.007794232268122,89.99220576773187,Healthcare
46946,6351,40595,13.528309121117879,86.47169087888213,Food
183414,34814,148600,18.98110286019606,81.01889713980394,Entertainment
121047,24999,96048,20.652308607400432,79.34769139259957,Healthcare
82868,22530,60338,27.187816768837187,72.8121832311628,Transportation
206876,7507,199369,3.6287437885496625,96.37125621145034,Entertainment
17414,3925,13489,22.539336166302977,77.46066383369703,Housing
51054,849,50205,1.66294511693501,98.337054883065,Food
85949,47723,38226,55.524787955648115,44.47521204435188,Transportation
53727,16941,36786,31.53163214026467,68.46836785973532,Food
41843,14718,27125,35.174342183877826,64.82565781612217,Food
19935,2303,17632,11.552545773764736,88.44745422623527,Housing
141571,63389,78182,44.775413043631815,55.224586956368185,Healthcare
92191,15286,76905,16.580794220693996,83.41920577930601,Transportation
80044,1543,78501,1.9276897706261558,98.07231022937385,Transportation
21022,5932,15090,28.218057273332697,71.7819427266673,Housing
93731,55619,38112,59.338959362430785,40.661040637569215,Transportation
90946,48802,42144,53.66041387196798,46.33958612803202,Transportation
16808,4879,11929,29.02784388386483,70.97215611613518,Housing
36416,10170,26246,27.927284710017574,72.07271528998243,Food
86691,51151,35540,59.003818158747734,40.996181841252266,Transportation
42769,15701,27068,36.71116930487035,63.28883069512965,Food
150221,28671,121550,19.085880136598746,80.91411986340125,Healthcare
78969,34897,44072,44.19075839886538,55.809241601134616,Transportation
107786,765,107021,0.7097396693448128,99.29026033065519,Transportation
124699,26546,98153,21.288061652459124,78.71193834754088,Healthcare
53953,7968,45985,14.768409541638091,85.23159045836191,Food
47039,8590,38449,18.26144263270903,81.73855736729098,Food
160554,18202,142352,11.336995652553036,88.66300434744696,Healthcare
138108,57858,80250,41.89330089495178,58.10669910504822,Healthcare
23889,1744,22145,7.300431160785299,92.69956883921469,Housing
128723,41515,87208,32.25142359951213,67.74857640048786,Healthcare
169818,39605,130213,23.322027111378063,76.67797288862194,Healthcare
59026,23164,35862,39.24372310507234,60.756276894927666,Food
89017,3340,85677,3.752092296976982,96.24790770302302,Transportation
204843,25571,179272,12.4832188554161,87.5167811445839,Entertainment
189467,56552,132915,29.84794185794888,70.15205814205112,Entertainment
39387,7740,31647,19.65115393403915,80.34884606596086,Food
156220,55590,100630,35.58443221098451,64.4155677890155,Healthcare
31748,12079,19669,38.046491117550715,61.95350888244929,Food
11442,826,10616,7.219017654256249,92.78098234574375,Housing
16658,1646,15012,9.881138191859767,90.11886180814024,Housing
146054,1346,144708,0.9215769509907293,99.07842304900927,Healthcare
209240,61292,147948,29.292678264194226,70.70732173580578,Entertainment
43357,17380,25977,40.08579929423161,59.91420070576838,Food
104006,47481,56525,45.65217391304348,54.347826086956516,Transportation
26657,15112,11545,56.69055032449263,43.30944967550737,Housing
33509,14818,18691,44.22095556417679,55.77904443582321,Food
25223,13916,11307,55.171866946834236,44.828133053165764,Housing
12495,5704,6791,45.65026010404162,54.34973989595838,Housing
23342,3860,19482,16.536714934452917,83.46328506554708,Housing
78331,43262,35069,55.22973024728396,44.77026975271604,Transportation
129003,29199,99804,22.634357340526964,77.36564265947304,Healthcare
74627,20467,54160,27.425730633684857,72.57426936631514,Transportation
14883,6052,8831,40.66384465497547,59.33615534502452,Housing
22099,11399,10700,51.58151952577039,48.418480474229604,Housing
133573,65869,67704,49.3131096853406,50.68689031465941,Healthcare
125079,39422,85657,31.51768082571815,68.48231917428186,Healthcare
11506,5347,6159,46.47140622284026,53.52859377715974,Housing
20683,5348,15335,25.856983996518878,74.14301600348112,Housing
31523,6908,24615,21.91415791644196,78.08584208355803,Food
228346,2101,226245,0.9200949436381632,99.07990505636184,Entertainment
216451,24980,191471,11.540718222600034,88.45928177739997,Entertainment
11324,1803,9521,15.921935711762627,84.07806428823737,Housing
152697,45232,107465,29.622061992049613,70.37793800795038,Healthcare
11231,4301,6930,38.295788442703234,61.70421155729677,Housing
179303,40191,139112,22.415129696658727,77.58487030334126,Healthcare
175406,57215,118191,32.61861053783793,67.38138946216206,Healthcare
145146,61096,84050,42.09278932936492,57.90721067063509,Healthcare
48214,17058,31156,35.37976521342349,64.62023478657652,Food
34853,19547,15306,56.08412475253206,43.91587524746794,Food
31220,9724,21496,31.14670083279949,68.8532991672005,Food
109326,1361,107965,1.2449005725993816,98.75509942740062,Transportation
35041,3232,31809,9.223481065038099,90.7765189349619,Food
28115,7028,21087,24.997332384847944,75.00266761515205,Housing
122888,55651,67237,45.28595143545342,54.71404856454658,Healthcare
120773,53173,67600,44.02722462802116,55.972775371978834,Healthcare
130647,25134,105513,19.238099611931386,80.76190038806861,Healthcare
28673,6086,22587,21.225543193945523,78.77445680605447,Housing
30001,2903,27098,9.676344121862604,90.3236558781374,Food
199173,69021,130152,34.653793435857274,65.34620656414273,Entertainment
99570,53522,46048,53.753138495530784,46.246861504469216,Transportation
15880,4703,11177,29.61586901763224,70.38413098236775,Housing
10041,3705,6336,36.898715267403645,63.101284732596355,Housing
205634,9993,195641,4.859604929145958,95.14039507085404,Entertainment
63507,30566,32941,48.130127387532085,51.869872612467915,Transportation
26761,10077,16684,37.65554351481634,62.34445648518366,Housing
144161,10852,133309,7.527694730197487,92.47230526980252,Healthcare
240275,56983,183292,23.715742378524606,76.28425762147539,Entertainment
238417,44731,193686,18.761665485263215,81.23833451473679,Entertainment
156525,10146,146379,6.48203162434116,93.51796837565884,Healthcare
233201,65305,167896,28.003739263553758,71.99626073644623,Entertainment
240485,21830,218655,9.07748924049317,90.92251075950682,Entertainment
245687,37784,207903,15.378917077419644,84.62108292258036,Entertainment
156372,2882,153490,1.8430409536234107,98.15695904637658,Healthcare
24109,10259,13850,42.552573727653574,57.447426272346426,Housing
42798,4933,37865,11.526239543903921,88.47376045609609,Food
133380,60258,73122,45.17768780926676,54.82231219073325,Healthcare
11343,4436,6907,39.10781980075818,60.89218019924182,Housing
133727,6381,127346,4.771661668922507,95.2283383310775,Healthcare
17820,7225,10595,40.54433221099888,59.45566778900112,Housing
53150,11434,41716,21.51269990592662,78.48730009407338,Food
247986,8272,239714,3.3356721750421396,96.66432782495787,Entertainment
25888,2251,23637,8.695148331273177,91.30485166872683,Housing
76498,17576,58922,22.975764072263328,77.02423592773667,Transportation
134268,59632,74636,44.41266720290762,55.58733279709238,Healthcare
38884,17838,21046,45.874909988684294,54.12509001131571,Food
82249,532,81717,0.6468163746671692,99.35318362533283,Transportation
161782,22001,139781,13.59916430752494,86.40083569247507,Healthcare
205573,23900,181673,11.626040384680868,88.37395961531914,Entertainment
196061,20807,175254,10.612513452445922,89.38748654755408,Entertainment
143030,41915,101115,29.30504090051038,70.69495909948962,Healthcare
84160,23615,60545,28.05964828897338,71.94035171102662,Transportation
11413,5455,5958,47.79637255760974,52.20362744239026,Housing
26298,4851,21447,18.44626967830253,81.55373032169747,Housing
51282,22928,28354,44.70964470964471,55.290355290355286,Food
239412,61744,177668,25.78985180358545,74.21014819641455,Entertainment
202210,45393,156817,22.448444686217297,77.5515553137827,Entertainment
193382,9749,183633,5.041317185673951,94.95868281432604,Entertainment
49587,6929,42658,13.973420452941296,86.0265795470587,Food
31831,2465,29366,7.744023122113662,92.25597687788634,Food
51500,22754,28746,44.182524271844656,55.817475728155344,Food
41779,15036,26743,35.989372651332005,64.010627348668,Food
202251,13977,188274,6.910719848109527,93.08928015189048,Entertainment
75297,16666,58631,22.133683944911482,77.86631605508852,Transportation
23375,10997,12378,47.045989304812835,52.95401069518717,Housing
185640,20542,165098,11.065503124326654,88.93449687567335,Entertainment
11372,4496,6876,39.53570172353148,60.46429827646852,Housing
124518,26970,97548,21.659519105671468,78.34048089432854,Healthcare
41767,9419,32348,22.551296478080783,77.44870352191921,Food
58373,7090,51283,12.146026416322615,87.85397358367739,Food
80001,13517,66484,16.896038799515008,83.103961200485,Transportation
49993,28831,21162,57.67007381033344,42.32992618966656,Food
121557,61389,60168,50.502233520077,49.497766479923,Healthcare
51991,1998,49993,3.84297282221923,96.15702717778078,Food
97277,56665,40612,58.25117962108206,41.748820378917934,Transportation
25375,4970,20405,19.586206896551726,80.41379310344827,Housing
67379,26757,40622,39.711185977826915,60.28881402217308,Transportation
179291,52863,126428,29.484469382177576,70.51553061782242,Healthcare
217264,41314,175950,19.015575521025113,80.98442447897489,Entertainment
12880,5325,7555,41.34316770186335,58.65683229813664,Housing
49479,15996,33483,32.32886679197235,67.67113320802764,Food
30912,5860,25052,18.95703933747412,81.04296066252587,Food
75173,12849,62324,17.09257313131044,82.90742686868956,Transportation
34950,13604,21346,38.9241773962804,61.0758226037196,Food
180650,28873,151777,15.982839745363965,84.01716025463604,Entertainment
78448,4152,74296,5.292677952274118,94.70732204772588,Transportation
22940,4050,18890,17.654751525719266,82.34524847428074,Housing
28771,14271,14500,49.60202982169546,50.39797017830454,Housing
107250,57139,50111,53.276456876456876,46.723543123543124,Transportation
34672,6323,28349,18.236617443470234,81.76338255652976,Food
107333,51788,55545,48.249839285215174,51.75016071478483,Transportation
233970,1808,232162,0.7727486429884173,99.22725135701158,Entertainment
12842,5632,7210,43.85609718112444,56.14390281887557,Housing
135062,25931,109131,19.199330677762806,80.8006693222372,Healthcare
187930,32854,155076,17.48204118554781,82.51795881445219,Entertainment
230696,24361,206335,10.559784304886085,89.4402156951139,Entertainment
205508,53110,152398,25.843276174163538,74.15672382583647,Entertainment
17099,3327,13772,19.457278203403707,80.5427217965963,Housing
54827,4257,50570,7.76442263848104,92.23557736151896,Food
36322,8819,27503,24.280050658003415,75.71994934199658,Food
162893,65700,97193,40.33322487768044,59.66677512231956,Healthcare
36863,365,36498,0.9901527276673088,99.00984727233269,Food
27980,7601,20379,27.165832737669763,72.83416726233024,Housing
27730,6648,21082,23.974035340786152,76.02596465921386,Housing
233940,43915,190025,18.77190732666496,81.22809267333504,Entertainment
121797,17399,104398,14.285245120979992,85.71475487902,Healthcare
22903,4793,18110,20.92738942496616,79.07261057503383,Housing
18681,764,17917,4.089716824581125,95.91028317541887,Housing
227188,11114,216074,4.891983731535117,95.10801626846488,Entertainment
226151,29298,196853,12.955060999066994,87.04493900093301,Entertainment
21136,4563,16573,21.58875851627555,78.41124148372445,Housing
82416,8085,74331,9.809988351776354,90.19001164822365,Transportation
26497,2716,23781,10.250217005698758,89.74978299430124,Housing
139604,61920,77684,44.35402997048795,55.64597002951205,Healthcare
224274,63904,160370,28.49371750626466,71.50628249373534,Entertainment
185824,40534,145290,21.813113483726536,78.18688651627347,Entertainment
128562,298,128264,0.2317947760613556,99.76820522393865,Healthcare
16027,9438,6589,58.88812628689087,41.11187371310913,Housing
80065,47908,32157,59.83638293886217,40.16361706113783,Transportation
40008,18420,21588,46.04079184163167,53.95920815836832,Food
138768,25646,113122,18.48120604173873,81.51879395826127,Healthcare
228289,69967,158322,30.64843246936996,69.35156753063004,Entertainment
146938,22427,124511,15.262899998638883,84.73710000136111,Healthcare
20382,2266,18116,11.117652830929252,88.88234716907075,Housing
123854,41483,82371,33.49346811568459,66.50653188431541,Healthcare
120676,7376,113300,6.112234412807849,93.88776558719215,Healthcare
200447,28061,172386,13.999211761712571,86.00078823828743,Entertainment
35405,13221,22184,37.34218330744245,62.657816692557546,Food
68496,40941,27555,59.77137351086195,40.22862648913805,Transportation
58133,14654,43479,25.2077133469802,74.7922866530198,Food
170615,25407,145208,14.89142220789497,85.10857779210504,Healthcare
20048,8195,11853,40.8768954509178,59.12310454908221,Housing
26411,2292,24119,8.678202264208094,91.3217977357919,Housing
37400,10989,26411,29.38235294117647,70.61764705882354,Food
84434,33441,50993,39.6060828576166,60.3939171423834,Transportation
25224,6833,18391,27.089280050745323,72.91071994925467,Housing
110664,39384,71280,35.588809368900456,64.41119063109954,Transportation
86790,39127,47663,45.08238276299113,54.917617237008876,Transportation
104038,51763,52275,49.753936061823566,50.246063938176434,Transportation
114383,7412,106971,6.479983913693468,93.52001608630654,Transportation
217520,39890,177630,18.33854358219934,81.66145641780066,Entertainment
101649,19243,82406,18.930830603350746,81.06916939664926,Transportation
54371,22567,31804,41.50558201982675,58.49441798017325,Food
92512,41263,51249,44.60286233137323,55.39713766862677,Transportation
249540,62104,187436,24.887392802757073,75.11260719724294,Entertainment
146320,43849,102471,29.967878622197926,70.03212137780208,Healthcare
218415,24667,193748,11.29363825744569,88.70636174255431,Entertainment
14224,1089,13135,7.656074240719909,92.34392575928008,Housing
72710,36079,36631,49.62040984733874,50.37959015266126,Transportation
51957,28068,23889,54.0215947802991,45.97840521970091,Food
55257,268,54989,0.48500642452539955,99.51499357547459,Food
58718,1848,56870,3.147246159610341,96.85275384038967,Food
136907,12872,124035,9.40200281943217,90.59799718056783,Healthcare
219731,188,219543,0.08555916097410014,99.9144408390259,Entertainment
179870,50141,129729,27.876243953966757,72.12375604603325,Healthcare
35625,3617,32008,10.152982456140352,89.84701754385965,Food
86989,32646,54343,37.52888296221361,62.471117037786385,Transportation
62128,18637,43491,29.99774658768993,70.00225341231007,Transportation
118216,48586,69630,41.09934357447385,58.90065642552615,Transportation
163503,61155,102348,37.40298343149667,62.59701656850333,Healthcare
151531,61193,90338,40.38315592189057,59.61684407810943,Healthcare
93939,45599,48340,48.54107452708673,51.45892547291327,Transportation
11279,269,11010,2.384963205957975,97.61503679404203,Housing
109166,8551,100615,7.833024934503417,92.16697506549659,Transportation
64670,28627,36043,44.26627493428174,55.73372506571827,Transportation
35072,8127,26945,23.172331204379564,76.82766879562044,Food
36437,5675,30762,15.574827784943876,84.42517221505612,Food
107082,53490,53592,49.95237294783437,50.04762705216563,Transportation
180531,20309,160222,11.249591482903213,88.75040851709679,Entertainment
20242,2871,17371,14.183381088825215,85.81661891117479,Housing
116740,63257,53483,54.186225800925136,45.81377419907487,Transportation
57472,27850,29622,48.458379732739424,51.541620267260576,Food
243542,7554,235988,3.1017237273242397,96.89827627267576,Entertainment
195609,15131,180478,7.7353291515216585,92.26467084847835,Entertainment
36394,3974,32420,10.919382315766335,89.08061768423366,Food
103374,34214,69160,33.097297192717704,66.9027028072823,Transportation
157518,44066,113452,27.975215530923446,72.02478446907655,Healthcare
99321,39978,59343,40.25130637025403,59.74869362974597,Transportation
152490,57926,94564,37.98675322971998,62.01324677028002,Healthcare
137852,50934,86918,36.948321388155414,63.051678611844586,Healthcare
133431,60294,73137,45.18740022933201,54.81259977066798,Healthcare
39040,12079,26961,30.940061475409834,69.05993852459017,Food
169198,19365,149833,11.445170746699134,88.55482925330087,Healthcare
195196,62084,133112,31.805979630730135,68.19402036926986,Entertainment
233715,61209,172506,26.189589885116487,73.81041011488351,Entertainment
58247,2225,56022,3.8199392243377344,96.18006077566227,Food
35608,11988,23620,33.66659177712874,66.33340822287126,Food
94188,14418,79770,15.307682507325774,84.69231749267423,Transportation
121681,3569,118112,2.933079116706799,97.06692088329321,Healthcare
88365,45592,42773,51.59508855316018,48.40491144683981,Transportation
232340,8618,223722,3.7092192476543,96.2907807523457,Entertainment
29550,16167,13383,54.710659898477154,45.28934010152284,Housing
155303,50048,105255,32.22603555629962,67.77396444370038,Healthcare
242602,17440,225162,7.188728864560061,92.81127113543994,Entertainment
90673,49094,41579,54.144011999161826,45.855988000838174,Transportation
204796,23161,181635,11.309302916072578,88.69069708392742,Entertainment
18169,9867,8302,54.30678628433046,45.69321371566954,Housing
179694,48877,130817,27.200129108373122,72.79987089162687,Healthcare
195877,49472,146405,25.256666173159687,74.74333382684031,Entertainment
230410,37814,192596,16.411614079250032,83.58838592074996,Entertainment
45444,25771,19673,56.70935657072441,43.29064342927559,Food
183419,65665,117754,35.80054410938889,64.19945589061112,Entertainment
42463,9986,32477,23.516944163153806,76.48305583684619,Food
33482,9719,23763,29.027537184158653,70.97246281584135,Food
166091,20605,145486,12.405849805227255,87.59415019477275,Healthcare
24122,7779,16343,32.248569770334136,67.75143022966587,Housing
152104,65111,86993,42.806895282175354,57.19310471782465,Healthcare
46135,27324,18811,59.2261840251436,40.7738159748564,Food
146553,60892,85661,41.54947356928893,58.45052643071107,Healthcare
45465,5321,40144,11.703508193115583,88.29649180688442,Food
80037,27987,52050,34.96757749540838,65.03242250459162,Transportation
149511,59398,90113,39.72818053521146,60.27181946478854,Healthcare
168325,49014,119311,29.11866924105154,70.88133075894845,Healthcare
48879,9109,39770,18.635814971664725,81.36418502833529,Food
70308,10798,59510,15.358138476418045,84.64186152358195,Transportation
110753,58135,52618,52.49067745343241,47.50932254656759,Transportation
30402,18194,12208,59.844747056114734,40.15525294388527,Food
223308,52914,170394,23.695523671341824,76.30447632865818,Entertainment
89036,30316,58720,34.04914865896941,65.95085134103059,Transportation
246636,29834,216802,12.096368737734961,87.90363126226504,Entertainment
232782,11461,221321,4.923490647902329,95.07650935209767,Entertainment
200858,16044,184814,7.987732627030041,92.01226737296996,Entertainment
29086,16317,12769,56.099154232276696,43.900845767723304,Housing
16090,3672,12418,22.821628340584212,77.17837165941579,Housing
154934,45196,109738,29.171130933171547,70.82886906682846,Healthcare
199303,68489,130814,34.36425944416291,65.6357405558371,Entertainment
45509,632,44877,1.388736293919884,98.61126370608012,Food
130210,39748,90462,30.526073266262195,69.47392673373781,Healthcare
16393,2214,14179,13.505764655645702,86.4942353443543,Housing
138906,53359,85547,38.41374742631708,61.58625257368292,Healthcare
35098,1700,33398,4.84358083081657,95.15641916918342,Food
11534,5489,6045,47.58973469741633,52.41026530258367,Housing
107805,41620,66185,38.606743657529805,61.3932563424702,Transportation
129298,13540,115758,10.471933053875542,89.52806694612445,Healthcare
138984,43016,95968,30.950325217291198,69.0496747827088,Healthcare
14436,2429,12007,16.825990579107785,83.17400942089222,Housing
149095,10724,138371,7.192729467788994,92.807270532211,Healthcare
140212,373,139839,0.2660257324622714,99.73397426753773,Healthcare
74695,24113,50582,32.28194658276993,67.71805341723007,Transportation
74649,15101,59548,20.229339977762596,79.77066002223741,Transportation
146159,61333,84826,41.96320445542184,58.03679554457817,Healthcare
50804,7235,43569,14.241004645303521,85.75899535469648,Food
46501,25153,21348,54.091309864303994,45.908690135696006,Food
215083,52642,162441,24.475202596207048,75.52479740379296,Entertainment
55757,22910,32847,41.08901124522482,58.91098875477518,Food
56220,29406,26814,52.305229455709714,47.694770544290286,Food
161354,1902,159452,1.1787746197801108,98.82122538021989,Healthcare
23796,12843,10953,53.971255673222394,46.02874432677761,Housing
128489,3053,125436,2.37607888613033,97.62392111386967,Healthcare
111143,10504,100639,9.45088759526016,90.54911240473984,Transportation
33831,4501,29330,13.304365818332297,86.6956341816677,Food
59302,20992,38310,35.39846885433881,64.6015311456612,Food
25024,3467,21557,13.854699488491049,86.14530051150895,Housing
71620,22963,48657,32.06227310807037,67.93772689192963,Transportation
34653,8626,26027,24.89250569936225,75.10749430063775,Food
236420,19250,217170,8.142289146434312,91.85771085356569,Entertainment
134142,15244,118898,11.364076873760641,88.63592312623936,Healthcare
88724,22359,66365,25.200622154095846,74.79937784590415,Transportation
14618,792,13826,5.4179778355452175,94.58202216445478,Housing
15034,3862,11172,25.688439537049355,74.31156046295064,Housing
55332,12728,42604,23.00296392684161,76.99703607315838,Food
194832,25765,169067,13.224213681530756,86.77578631846924,Entertainment
20832,652,20180,3.129800307219662,96.87019969278033,Housing
10260,1874,8386,18.265107212475634,81.73489278752437,Housing
101502,50456,51046,49.7093653327028,50.2906346672972,Transportation
31330,4527,26803,14.449409511650174,85.55059048834983,Food
25201,4243,20958,16.836633466925914,83.16336653307408,Housing
197659,33845,163814,17.12292382335234,82.87707617664766,Entertainment
74954,11149,63805,14.874456333217706,85.12554366678229,Transportation
115124,48505,66619,42.132830686911504,57.867169313088496,Transportation
24826,11273,13553,45.40803995810844,54.59196004189156,Housing
248832,18141,230691,7.290461033950617,92.7095389660494,Entertainment
153351,6040,147311,3.938676630736024,96.06132336926397,Healthcare
157668,12188,145480,7.730167186746835,92.26983281325316,Healthcare
248100,37050,211050,14.933494558645707,85.0665054413543,Entertainment
39947,201,39746,0.5031666958720304,99.49683330412797,Food
35991,14067,21924,39.0847711927982,60.91522880720181,Food
55596,13059,42537,23.48909993524714,76.51090006475286,Food
41992,8769,33223,20.88254905696323,79.11745094303677,Food
21597,10885,10712,50.40051859054498,49.59948140945502,Housing
122680,38720,83960,31.561786762308447,68.43821323769156,Healthcare
10979,441,10538,4.016759267692868,95.98324073230712,Housing
149205,10652,138553,7.139170939311685,92.8608290606883,Healthcare
176815,30439,146376,17.215168396346463,82.78483160365354,Healthcare
177227,19166,158061,10.814379298865298,89.18562070113471,Healthcare
14638,5766,8872,39.39062713485449,60.60937286514552,Housing
164573,14300,150273,8.689153141766875,91.31084685823312,Healthcare
235945,41978,193967,17.791434444467992,82.208565555532,Entertainment
107479,16973,90506,15.791922142930249,84.20807785706975,Transportation
26002,9441,16561,36.30874548111684,63.69125451888317,Housing
37132,18533,18599,49.911127868146075,50.088872131853925,Food
107717,33335,74382,30.94683290474113,69.05316709525887,Transportation
72586,24532,48054,33.79715096575097,66.20284903424903,Transportation
158501,15691,142810,9.899622084403253,90.10037791559675,Healthcare
134722,51852,82870,38.48814595982839,61.51185404017161,Healthcare
199952,27698,172254,13.852324557893894,86.1476754421061,Entertainment
156042,34455,121587,22.080593686315222,77.91940631368477,Healthcare
118256,26725,91531,22.599276146664863,77.40072385333514,Transportation
237892,2710,235182,1.139172397558556,98.86082760244145,Entertainment
49482,19944,29538,40.30556566024009,59.694434339759916,Food
163957,51264,112693,31.266734570649625,68.73326542935038,Healthcare
22913,12928,9985,56.42211844804259,43.577881551957404,Housing
172808,43666,129142,25.268506087681125,74.73149391231887,Healthcare
94945,11398,83547,12.004844910211174,87.99515508978882,Transportation
95268,45726,49542,47.99722887013478,52.00277112986522,Transportation
59489,7586,51903,12.75193733295231,87.24806266704769,Food
87380,13324,74056,15.248340581368735,84.75165941863126,Transportation
183969,1383,182586,0.7517570895096457,99.24824291049036,Entertainment
14195,3541,10654,24.945403311025007,75.054596688975,Housing
220306,60027,160279,27.247101758463227,72.75289824153677,Entertainment
123756,41370,82386,33.428682245709304,66.5713177542907,Healthcare
202595,2465,200130,1.2167131469187293,98.78328685308128,Entertainment
169866,66885,102981,39.37515453357353,60.62484546642648,Healthcare
36122,11973,24149,33.14600520458446,66.85399479541555,Food
150921,29292,121629,19.408829785119366,80.59117021488063,Healthcare
243161,63999,179162,26.319598948844593,73.68040105115541,Entertainment
163576,16390,147186,10.019807306695359,89.98019269330464,Healthcare
137374,8263,129111,6.01496644197592,93.98503355802407,Healthcare
220204,66909,153295,30.385006630215617,69.61499336978439,Entertainment
230149,27175,202974,11.807568140639326,88.19243185936068,Entertainment
19003,1753,17250,9.224859232752722,90.77514076724728,Housing
19255,7149,12106,37.12801869644248,62.871981303557526,Housing
136496,33213,103283,24.332581174539914,75.66741882546009,Healthcare
42517,14100,28417,33.16320530611285,66.83679469388714,Food
110032,29666,80366,26.961247637051038,73.03875236294896,Transportation
57430,311,57119,0.5415288176911022,99.4584711823089,Food
42456,17622,24834,41.50650084793669,58.49349915206331,Food
28843,17060,11783,59.1478001594841,40.852199840515894,Housing
15779,3495,12284,22.1496926294442,77.85030737055581,Housing
110809,19332,91477,17.446236316544685,82.55376368345532,Transportation
24270,5879,18391,24.223320972393903,75.7766790276061,Housing
119370,27042,92328,22.653933149032422,77.34606685096757,Transportation
111995,11951,100044,10.67101209875441,89.3289879012456,Transportation
36584,18895,17689,51.648261535097305,48.35173846490269,Food
26972,9896,17076,36.68990063769835,63.31009936230164,Housing
23594,12108,11486,51.318131728405525,48.681868271594475,Housing
12620,5267,7353,41.735340729001585,58.26465927099842,Housing
32006,13393,18613,41.845279010185585,58.154720989814415,Food
26738,11812,14926,44.176826987807615,55.823173012192385,Housing
141466,24946,116520,17.633919104237062,82.36608089576293,Healthcare
102354,32756,69598,32.00265744377357,67.99734255622643,Transportation
243952,2556,241396,1.0477470977897292,98.95225290221028,Entertainment
230086,8358,221728,3.632554783863425,96.36744521613657,Entertainment
29853,274,29579,0.9178307037818644,99.08216929621814,Housing
22341,10201,12140,45.660444921892484,54.339555078107516,Housing
132076,24044,108032,18.2046700384627,81.7953299615373,Healthcare
213130,53321,159809,25.01806409233801,74.98193590766199,Entertainment
11098,4080,7018,36.763380789331414,63.236619210668586,Housing
210320,28228,182092,13.421453023963483,86.57854697603652,Entertainment
131737,41291,90446,31.343510175577098,68.6564898244229,Healthcare
229352,16405,212947,7.152760821793574,92.84723917820642,Entertainment
152083,66482,85601,43.7142875929591,56.28571240704089,Healthcare
27990,16650,11340,59.4855305466238,40.51446945337621,Housing
179586,17588,161998,9.79363647500362,90.20636352499638,Healthcare
184202,9756,174446,5.296359431493687,94.7036405685063,Entertainment
23262,11240,12022,48.31914710686957,51.68085289313042,Housing
26155,10850,15305,41.48346396482508,58.516536035174916,Housing
124639,61102,63537,49.02317894078097,50.97682105921903,Healthcare
155851,14122,141729,9.061218728144189,90.9387812718558,Healthcare
73862,40498,33364,54.829276217811596,45.170723782188404,Transportation
192435,22100,170335,11.484397328968223,88.51560267103179,Entertainment
169853,10039,159814,5.910404879513462,94.08959512048654,Healthcare
58445,11797,46648,20.184789117974162,79.81521088202584,Food
39094,10470,28624,26.781603315086716,73.21839668491329,Food
76477,44788,31689,58.564012709703576,41.435987290296424,Transportation
28143,13559,14584,48.17894325409516,51.82105674590485,Housing
51167,17532,33635,34.26427189399418,65.73572810600582,Food
60733,32901,27832,54.1731842655558,45.8268157344442,Transportation
246838,33741,213097,13.669289169414759,86.33071083058525,Entertainment
161304,15582,145722,9.660020830233597,90.33997916976641,Healthcare
142801,50292,92509,35.21824076862207,64.78175923137793,Healthcare
202715,66900,135815,33.00199787879535,66.99800212120465,Entertainment
79640,29226,50414,36.69763937719739,63.30236062280261,Transportation
186410,44814,141596,24.040555764175743,75.95944423582426,Entertainment
238101,14292,223809,6.002494739627301,93.99750526037269,Entertainment
149067,6538,142529,4.3859472586152535,95.61405274138475,Healthcare
146147,39601,106546,27.096690318651767,72.90330968134823,Healthcare
236298,40351,195947,17.07631888547512,82.92368111452488,Entertainment
132793,53634,79159,40.38917714036131,59.61082285963869,Healthcare
238310,1953,236357,0.8195207922453946,99.1804792077546,Entertainment
29751,12087,17664,40.627205808208124,59.372794191791876,Housing
99949,15607,84342,15.614963631452042,84.38503636854796,Transportation
21259,9278,11981,43.64269250670304,56.35730749329696,Housing
26840,436,26404,1.6244411326378538,98.37555886736214,Housing
60195,11972,48223,19.888695074341722,80.11130492565827,Transportation
137729,22293,115436,16.186133639248087,83.81386636075192,Healthcare
11200,3065,8135,27.36607142857143,72.63392857142857,Housing
207213,48139,159074,23.231650523857095,76.7683494761429,Entertainment
99212,49444,49768,49.83671330081039,50.16328669918961,Transportation
37595,12422,25173,33.04162787604735,66.95837212395266,Food
222910,67235,155675,30.162397380108562,69.83760261989144,Entertainment
52086,28027,24059,53.809084974849284,46.190915025150716,Food
188839,68513,120326,36.281170732740584,63.718829267259416,Entertainment
240937,35299,205638,14.650717822501319,85.34928217749868,Entertainment
70128,28606,41522,40.79112480036505,59.20887519963496,Transportation
22133,2116,20017,9.56038494555641,90.43961505444359,Housing
63941,19523,44418,30.53283495722619,69.4671650427738,Transportation
137760,58589,79171,42.529761904761905,57.47023809523809,Healthcare
59565,22111,37454,37.12079241165114,62.87920758834886,Food
64431,9388,55043,14.570625940929055,85.42937405907094,Transportation
231845,67015,164830,28.905087450667473,71.09491254933252,Entertainment
47551,3993,43558,8.397299741330361,91.60270025866963,Food
30871,5519,25352,17.87761977260212,82.12238022739788,Food
115218,43442,71776,37.704178166605914,62.295821833394086,Transportation
211501,5649,205852,2.6709093574025653,97.32909064259744,Entertainment
91669,28508,63161,31.098844756678922,68.90115524332107,Transportation
213581,39324,174257,18.411750108857998,81.58824989114201,Entertainment
70663,1676,68987,2.371821179400818,97.62817882059919,Transportation
103251,17284,85967,16.739789445138545,83.26021055486146,Transportation
179712,27414,152298,15.254407051282051,84.74559294871796,Healthcare
174014,19085,154929,10.96750836139621,89.0324916386038,Healthcare
17736,7174,10562,40.4488046910239,59.55119530897609,Housing
39348,5041,34307,12.811324590830539,87.18867540916946,Food
78881,12877,66004,16.324590205499423,83.67540979450058,Transportation
10277,3543,6734,34.47504135448088,65.52495864551912,Housing
112349,40010,72339,35.612243989710635,64.38775601028937,Transportation
195956,38030,157926,19.407417991794077,80.59258200820592,Entertainment
96039,40792,55247,42.47441143702038,57.52558856297962,Transportation
171427,26326,145101,15.356974105595969,84.64302589440403,Healthcare
142821,9311,133510,6.519349395397035,93.48065060460297,Healthcare
184740,22120,162620,11.973584497131103,88.0264155028689,Entertainment
27907,11245,16662,40.29454975454187,59.705450245458124,Housing
22584,6361,16223,28.16595820049593,71.83404179950408,Housing
43729,16634,27095,38.038830067003595,61.961169932996405,Food
12071,3451,8620,28.589180680970923,71.41081931902907,Housing
44984,11304,33680,25.12893473234928,74.87106526765072,Food
205083,7981,197102,3.8915951102724264,96.10840488972757,Entertainment
58566,24070,34496,41.09893112044531,58.901068879554686,Food
172936,33065,139871,19.119789980108248,80.88021001989175,Healthcare
203685,24830,178855,12.190392026904288,87.80960797309572,Entertainment
167890,49501,118389,29.48418607421526,70.51581392578474,Healthcare
222450,37870,184580,17.024050348392898,82.97594965160711,Entertainment
165948,68456,97492,41.251476366090586,58.74852363390942,Healthcare
28925,12304,16621,42.537597234226446,57.462402765773554,Housing
18887,6578,12309,34.82818870122306,65.17181129877694,Housing
198331,49394,148937,24.904830813135618,75.09516918686438,Entertainment
163015,27483,135532,16.859184737600835,83.14081526239917,Healthcare
18315,303,18012,1.6543816543816543,98.34561834561835,Housing
26807,355,26452,1.3242809713880703,98.67571902861194,Housing
21390,307,21083,1.4352501168770453,98.56474988312296,Housing
155057,13013,142044,8.39239763441831,91.60760236558168,Healthcare
61215,20272,40943,33.11606632361349,66.8839336763865,Transportation
31944,6255,25689,19.58114199849737,80.41885800150263,Food
89709,50112,39597,55.86061599170652,44.13938400829348,Transportation
190257,57471,132786,30.207035746385152,69.79296425361484,Entertainment
28312,3592,24720,12.687199773947444,87.31280022605256,Housing
62076,15281,46795,24.616599007668018,75.38340099233199,Transportation
30717,7338,23379,23.88905166520168,76.11094833479832,Food
18219,480,17739,2.634612218014161,97.36538778198583,Housing
14161,5124,9037,36.18388531883341,63.81611468116658,Housing
109721,15192,94529,13.846027651953591,86.15397234804641,Transportation
14198,3623,10575,25.517678546274126,74.48232145372587,Housing
40523,24309,16214,59.98815487500926,40.01184512499075,Food
177307,54617,122690,30.803634374277383,69.1963656257226,Healthcare
128159,8717,119442,6.801707254270087,93.19829274572992,Healthcare
20926,3546,17380,16.94542674185224,83.05457325814776,Housing
54918,22708,32210,41.348920208310574,58.65107979168943,Food
90356,26060,64296,28.841471512683164,71.15852848731684,Transportation
117817,48595,69222,41.24616990756852,58.75383009243148,Transportation
80709,37773,42936,46.801471954800576,53.198528045199424,Transportation
20282,432,19850,2.12996745883049,97.87003254116951,Housing
102482,19790,82692,19.310708221931655,80.68929177806834,Transportation
127779,920,126859,0.7199931131093529,99.28000688689065,Healthcare
39824,499,39325,1.2530132583366815,98.74698674166332,Food
206507,34685,171822,16.796040812175857,83.20395918782414,Entertainment
136299,41108,95191,30.160162583731353,69.83983741626865,Healthcare
13026,6364,6662,48.856133886074005,51.143866113925995,Housing
197321,46835,150486,23.73543616746317,76.26456383253684,Entertainment
21704,5186,16518,23.89421304828603,76.10578695171397,Housing
133787,59226,74561,44.26887515229432,55.73112484770568,Healthcare
18994,11041,7953,58.128882805096346,41.871117194903654,Housing
22305,11617,10688,52.08249271463797,47.91750728536203,Housing
225971,48929,177042,21.652778453872397,78.3472215461276,Entertainment
59981,28735,31246,47.90683716510228,52.09316283489772,Food
11304,2775,8529,24.54883227176221,75.45116772823779,Housing
69644,32036,37608,45.99965539027052,54.00034460972948,Transportation
216570,747,215823,0.3449231195456435,99.65507688045435,Entertainment
45404,16763,28641,36.919654655977446,63.08034534402255,Food
98959,20113,78846,20.324578865995008,79.67542113400499,Transportation
97748,28783,68965,29.446126774972374,70.55387322502762,Transportation
96673,16734,79939,17.30990038583679,82.69009961416322,Transportation
145917,51422,94495,35.24058197468424,64.75941802531577,Healthcare
35891,15363,20528,42.804602825220805,57.195397174779195,Food
24685,2568,22117,10.403078792789143,89.59692120721085,Housing
91490,23536,67954,25.725215870586947,74.27478412941305,Transportation
185099,38939,146160,21.036850550246083,78.96314944975391,Entertainment
22610,11274,11336,49.86289252543122,50.13710747456878,Housing
128884,26962,101922,20.919586605009155,79.08041339499084,Healthcare
15254,5059,10195,33.16507145666711,66.8349285433329,Housing
176625,56983,119642,32.2621372965322,67.7378627034678,Healthcare
90465,32237,58228,35.63477588017465,64.36522411982534,Transportation
121501,44268,77233,36.43426803071579,63.5657319692842,Healthcare
88141,16185,71956,18.362623523672298,81.6373764763277,Transportation
59186,34397,24789,58.116784374683206,41.8832156253168,Food
42269,17714,24555,41.90778111618444,58.09221888381556,Food
101325,27951,73374,27.585492227979273,72.41450777202073,Transportation
181532,32210,149322,17.743428155917414,82.25657184408259,Entertainment
133277,45350,87927,34.0268763552601,65.9731236447399,Healthcare
136236,33909,102327,24.889896943539153,75.11010305646084,Healthcare
14142,2723,11419,19.254702305190214,80.74529769480978,Housing
17612,5506,12106,31.262775380422443,68.73722461957756,Housing
88698,8654,80044,9.75670251865882,90.24329748134117,Transportation
180108,49446,130662,27.45352788327004,72.54647211672996,Entertainment
30348,11227,19121,36.99420060630025,63.005799393699746,Food
12065,1374,10691,11.388313302942395,88.6116866970576,Housing
84932,29554,55378,34.79724956435737,65.20275043564263,Transportation
48500,16417,32083,33.84948453608247,66.15051546391753,Food
117054,4512,112542,3.854631195858322,96.14536880414167,Transportation
213360,11217,202143,5.257311586051744,94.74268841394826,Entertainment
57240,12418,44822,21.694619147449338,78.30538085255067,Food
31527,7787,23740,24.699463951533605,75.3005360484664,Food
59201,12363,46838,20.883093190993396,79.11690680900661,Food
133733,16780,116953,12.54738920087039,87.4526107991296,Healthcare
223114,19410,203704,8.699588551144258,91.30041144885574,Entertainment
139874,52698,87176,37.67533637416532,62.324663625834674,Healthcare
180987,59851,121136,33.06922596650588,66.93077403349412,Entertainment
241461,37042,204419,15.340779670422966,84.65922032957704,Entertainment
175057,24281,150776,13.870339375174941,86.12966062482505,Healthcare
180845,63743,117102,35.24731123337665,64.75268876662335,Entertainment
158459,20006,138453,12.625347881786455,87.37465211821355,Healthcare
12902,3669,9233,28.437451557898,71.562548442102,Housing
248783,49579,199204,19.9286124855798,80.0713875144202,Entertainment
199895,19114,180781,9.562020060531779,90.43797993946822,Entertainment
154400,67984,86416,44.031088082901555,55.96891191709844,Healthcare
89210,31163,58047,34.932182490752155,65.06781750924785,Transportation
245441,43531,201910,17.735830606948312,82.26416939305169,Entertainment
83389,1628,81761,1.9522958663612706,98.04770413363872,Transportation
19686,5438,14248,27.623691963832165,72.37630803616784,Housing
176820,42647,134173,24.11887795498247,75.88112204501753,Healthcare
24154,826,23328,3.4197234412519664,96.58027655874804,Housing
33229,1728,31501,5.200276866592434,94.79972313340757,Food
58662,3680,54982,6.273226279363131,93.72677372063687,Food
26497,2446,24051,9.231233724572594,90.76876627542741,Housing
52133,1792,50341,3.437362131471429,96.56263786852857,Food
10060,4983,5077,49.53280318091451,50.467196819085494,Housing
25701,4950,20751,19.259950974670247,80.74004902532975,Housing
140470,42257,98213,30.08257991030113,69.91742008969887,Healthcare
248337,63863,184474,25.716264592066423,74.28373540793358,Entertainment
10408,1165,9243,11.193312836279786,88.80668716372021,Housing
50304,12420,37884,24.689885496183205,75.31011450381679,Food
192289,18685,173604,9.717144506446026,90.28285549355397,Entertainment
20185,3496,16689,17.319791924696556,82.68020807530344,Housing
68844,12381,56463,17.984138051246294,82.0158619487537,Transportation
21344,3576,17768,16.754122938530735,83.24587706146926,Housing
101667,13837,87830,13.610119311084226,86.38988068891578,Transportation
201785,37811,163974,18.738261020392994,81.26173897960702,Entertainment
35128,15019,20109,42.755067182874065,57.244932817125935,Food
46424,13890,32534,29.91986903325866,70.08013096674134,Food
66602,28506,38096,42.80051650100597,57.19948349899402,Transportation
101610,35538,66072,34.974904044877476,65.02509595512252,Transportation
64038,23246,40792,36.300321684000124,63.699678315999876,Transportation
94515,23704,70811,25.07961699201185,74.92038300798815,Transportation
73998,18786,55212,25.387172626287196,74.6128273737128,Transportation
197501,67169,130332,34.009448053427576,65.99055194657242,Entertainment
84827,19636,65191,23.148290049158877,76.85170995084111,Transportation
84462,47986,36476,56.813715043451495,43.18628495654851,Transportation
202802,1429,201373,0.7046281594856066,99.29537184051439,Entertainment
15836,3251,12585,20.52917403384693,79.47082596615307,Housing
194433,14631,179802,7.5249571831942115,92.47504281680578,Entertainment
114959,33482,81477,29.12516636366009,70.87483363633991,Transportation
63168,422,62746,0.6680597771023303,99.33194022289767,Transportation
152425,35192,117233,23.088076103001477,76.91192389699853,Healthcare
31772,14088,17684,44.340929119979855,55.659070880020145,Food
141967,57221,84746,40.30584572471067,59.69415427528932,Healthcare
212134,21400,190734,10.087963268500099,89.9120367314999,Entertainment
53374,22734,30640,42.59377224866039,57.4062277513396,Food
16801,8188,8613,48.73519433367062,51.26480566632938,Housing
47541,16970,30571,35.695504932584505,64.30449506741549,Food
63932,35811,28121,56.01420259025214,43.98579740974785,Transportation
42240,1295,40945,3.065814393939394,96.93418560606061,Food
47422,9344,38078,19.703934882543965,80.29606511745602,Food
22524,13198,9326,58.59527614988457,41.40472385011543,Housing
29515,2847,26668,9.645942740979162,90.35405725902083,Housing
141490,4456,137034,3.1493391759134926,96.8506608240865,Healthcare
159252,32457,126795,20.380905734307888,79.61909426569211,Healthcare
78521,39674,38847,50.52661071560475,49.47338928439526,Transportation
77256,36094,41162,46.7199958579269,53.28000414207311,Transportation
67139,35494,31645,52.866441263647054,47.13355873635294,Transportation
66826,18129,48697,27.128662496633048,72.87133750336695,Transportation
227578,40207,187371,17.667349216532354,82.33265078346764,Entertainment
39978,14571,25407,36.447546150382706,63.55245384961729,Food
139253,37685,101568,27.062253595972795,72.93774640402721,Healthcare
12208,5354,6854,43.8564875491481,56.143512450851894,Housing
97891,18251,79640,18.644206311101122,81.35579368889888,Transportation
130057,48569,81488,37.34439514981893,62.65560485018108,Healthcare
55836,8712,47124,15.602836879432624,84.39716312056737,Food
242350,6337,236013,2.614813286569012,97.385186713431,Entertainment
40967,19581,21386,47.79700734737716,52.20299265262285,Food
225828,30827,195001,13.650654480401014,86.34934551959898,Entertainment
21355,924,20431,4.326855537344884,95.67314446265512,Housing
28625,2863,25762,10.001746724890829,89.99825327510918,Housing
201574,15050,186524,7.466240685802733,92.53375931419727,Entertainment
28918,11113,17805,38.42935196071651,61.57064803928349,Housing
164425,17466,146959,10.622472251786528,89.37752774821347,Healthcare
63729,36397,27332,57.1121467463792,42.8878532536208,Transportation
83535,43899,39636,52.55162506733705,47.44837493266296,Transportation
119023,51642,67381,43.38825269065643,56.61174730934357,Transportation
111438,48037,63401,43.10648073368151,56.89351926631849,Transportation
40943,20289,20654,49.55425835918228,50.44574164081772,Food
156478,2251,154227,1.4385408811462315,98.56145911885376,Healthcare
117068,28134,88934,24.032186421566955,75.96781357843305,Transportation
124572,23090,101482,18.5354654336448,81.4645345663552,Healthcare
72795,15883,56912,21.818806236692083,78.18119376330792,Transportation
187799,30004,157795,15.976655892736384,84.02334410726363,Entertainment
74015,43221,30794,58.39491994865905,41.60508005134094,Transportation
33028,7673,25355,23.231803318396512,76.76819668160348,Food
148716,34777,113939,23.384840904811856,76.61515909518815,Healthcare
140546,21739,118807,15.467533761188507,84.5324662388115,Healthcare
153397,21681,131716,14.133913961811508,85.8660860381885,Healthcare
205291,35501,169790,17.29301333229416,82.70698666770583,Entertainment
213556,62840,150716,29.425537095656406,70.57446290434359,Entertainment
239669,26465,213204,11.04231252268754,88.95768747731246,Entertainment
12219,4595,7624,37.60536868810868,62.39463131189132,Housing
34878,19121,15757,54.822524227306616,45.177475772693384,Food
31603,14265,17338,45.13811979875329,54.86188020124671,Food
52244,4194,48050,8.027716101370492,91.9722838986295,Food
192657,9376,183281,4.8666801621534646,95.13331983784653,Entertainment
36260,10348,25912,28.53833425261997,71.46166574738004,Food
15037,3503,11534,23.29587018687238,76.70412981312762,Housing
213937,27865,186072,13.024862459509107,86.97513754049089,Entertainment
110345,18580,91765,16.838098690470797,83.16190130952921,Transportation
230516,7318,223198,3.1746169463291047,96.8253830536709,Entertainment
13306,7676,5630,57.68826093491658,42.31173906508342,Housing
16576,1216,15360,7.335907335907336,92.66409266409266,Housing
168798,46951,121847,27.814903020177965,72.18509697982203,Healthcare
194437,29339,165098,15.089206272468717,84.91079372753128,Entertainment
39871,2684,37187,6.731709763988864,93.26829023601113,Food
181033,55356,125677,30.57785044715604,69.42214955284396,Entertainment
103233,60300,42933,58.41155444479963,41.58844555520037,Transportation
108734,27142,81592,24.961833465153493,75.03816653484651,Transportation
216893,25839,191054,11.913247546024998,88.08675245397501,Entertainment
118995,32378,86617,27.209546619605867,72.79045338039414,Transportation
137492,58333,79159,42.426468449073404,57.5735315509266,Healthcare
85575,3167,82408,3.700847210049664,96.29915278995034,Transportation
12170,3186,8984,26.17912900575185,73.82087099424815,Housing
22665,6962,15703,30.716964482682553,69.28303551731744,Housing
139369,45234,94135,32.456285113619245,67.54371488638076,Healthcare
93116,4495,88621,4.827312169766743,95.17268783023326,Transportation
28322,12801,15521,45.19807923169268,54.80192076830732,Housing
47697,23461,24236,49.18757993165189,50.81242006834812,Food
193925,6077,187848,3.1336857032357868,96.86631429676422,Entertainment
58947,26789,32158,45.44590903693148,54.554090963068525,Food
65722,34692,31030,52.78597729831716,47.21402270168284,Transportation
158590,10686,147904,6.738129768585662,93.26187023141433,Healthcare
15612,6475,9137,41.47450678964899,58.52549321035101,Housing
172841,46366,126475,26.825811005490596,73.17418899450941,Healthcare
28828,2146,26682,7.444151519356182,92.55584848064382,Housing
23577,13988,9589,59.329007083174275,40.670992916825725,Housing
54141,10962,43179,20.247132487394026,79.75286751260597,Food
170879,61039,109840,35.72059761585684,64.27940238414317,Healthcare
241897,15074,226823,6.23157790299177,93.76842209700823,Entertainment
19956,11710,8246,58.67909400681499,41.32090599318501,Housing
202671,34193,168478,16.87118532005072,83.12881467994929,Entertainment
10052,5676,4376,56.46637485077597,43.53362514922404,Housing
51437,6417,45020,12.47545541147423,87.52454458852577,Food
79878,16034,63844,20.07311149502992,79.92688850497008,Transportation
16546,4007,12539,24.21733349450018,75.78266650549982,Housing
29646,16435,13211,55.43749578357957,44.56250421642043,Housing
147570,53204,94366,36.05339838720607,63.94660161279393,Healthcare
221057,49974,171083,22.606838960087217,77.39316103991278,Entertainment
20613,5039,15574,24.44573812642507,75.55426187357493,Housing
236817,4826,231991,2.0378604576529558,97.96213954234705,Entertainment
186370,1638,184732,0.8788968181574288,99.12110318184257,Entertainment
177889,48482,129407,27.254074169847485,72.74592583015252,Healthcare
24625,1224,23401,4.970558375634518,95.02944162436549,Housing
165706,36223,129483,21.859799886546053,78.14020011345394,Healthcare
155716,35026,120690,22.493513832875234,77.50648616712476,Healthcare
228016,697,227319,0.305680303136622,99.69431969686337,Entertainment
105257,18477,86780,17.554176919349782,82.44582308065021,Transportation
115195,30458,84737,26.44038369720908,73.55961630279091,Transportation
63671,33229,30442,52.188594493568495,47.8114055064315,Transportation
23006,5821,17185,25.302095105624623,74.69790489437538,Housing
31121,9447,21674,30.355708364127114,69.64429163587288,Food
24152,2205,21947,9.129678701556806,90.87032129844319,Housing
96631,41902,54729,43.36289596506297,56.637104034937025,Transportation
21882,11884,9998,54.309478109861985,45.690521890138015,Housing
28980,14966,14014,51.64251207729469,48.35748792270532,Housing
59960,29449,30511,49.114409606404266,50.88559039359573,Food
227633,28249,199384,12.409887845786859,87.59011215421314,Entertainment
169636,67784,101852,39.95849937513264,60.04150062486736,Healthcare
100944,20840,80104,20.645110160088763,79.35488983991124,Transportation
45984,757,45227,1.6462247738343772,98.35377522616562,Food
33864,18844,15020,55.64611386723364,44.353886132766355,Food
51133,3384,47749,6.618035319656582,93.38196468034342,Food
79328,2272,77056,2.864058087938685,97.13594191206131,Transportation
198596,68349,130247,34.41610102922516,65.58389897077484,Entertainment
10400,781,9619,7.509615384615384,92.49038461538461,Housing
87636,24297,63339,27.724907572230588,72.27509242776941,Transportation
91604,41087,50517,44.85284485393651,55.14715514606349,Transportation
166101,5930,160171,3.5701169770200063,96.42988302298,Healthcare
119575,27650,91925,23.123562617604016,76.87643738239599,Transportation
55265,3900,51365,7.056907626888627,92.94309237311137,Food
82530,11431,71099,13.85072094995759,86.14927905004241,Transportation
46635,12177,34458,26.111289803795433,73.88871019620457,Food
79539,9466,70073,11.901079973346409,88.09892002665359,Transportation
22871,6318,16553,27.624502645271303,72.3754973547287,Housing
40782,21003,19779,51.50066205678976,48.49933794321024,Food
91741,24259,67482,26.442920831471206,73.55707916852879,Transportation
169979,12472,157507,7.337376970096305,92.66262302990368,Healthcare
167035,5232,161803,3.1322776663573504,96.86772233364265,Healthcare
155989,60471,95518,38.76619505221522,61.233804947784776,Healthcare
219647,35488,184159,16.15683346460457,83.84316653539543,Entertainment
26564,2819,23745,10.612106610450233,89.38789338954976,Housing
41991,23012,18979,54.802219523231166,45.197780476768834,Food
230379,69033,161346,29.96497076556457,70.03502923443543,Entertainment
40184,1643,38541,4.088692016723074,95.91130798327693,Food
134413,49446,84967,36.78662034178242,63.21337965821758,Healthcare
172686,6347,166339,3.6754571881912836,96.32454281180871,Healthcare
16034,1390,14644,8.669078208806287,91.3309217911937,Housing
100851,20170,80681,19.9998016876382,80.0001983123618,Transportation
20644,6203,14441,30.047471420267392,69.95252857973261,Housing
94527,11519,83008,12.18593629333418,87.81406370666582,Transportation
129224,13691,115533,10.594781155203368,89.40521884479664,Healthcare
146934,61694,85240,41.98755904011325,58.01244095988676,Healthcare
208159,67911,140248,32.62458024875215,67.37541975124785,Entertainment
21929,12043,9886,54.91814492224908,45.08185507775092,Housing
174156,48899,125257,28.0777004524679,71.92229954753209,Healthcare
122558,20530,102028,16.75125246821913,83.24874753178088,Healthcare
51417,6751,44666,13.129898671645565,86.87010132835444,Food
73533,27699,45834,37.66880176247399,62.33119823752601,Transportation
38214,9916,28298,25.94860522321662,74.05139477678337,Food
36430,12201,24229,33.491627779302775,66.50837222069723,Food
150716,63294,87422,41.99554128294275,58.00445871705725,Healthcare
57354,12773,44581,22.27046064790599,77.72953935209401,Food
15940,8244,7696,51.71894604767879,48.28105395232121,Housing
208113,43732,164381,21.01358396640287,78.98641603359712,Entertainment
52287,24244,28043,46.367165834719906,53.63283416528009,Food
94144,44383,49761,47.143737253569,52.85626274643101,Transportation
18824,10868,7956,57.73480662983425,42.26519337016575,Housing
15211,3349,11862,22.016961409506276,77.98303859049372,Housing
96080,27932,68148,29.07160699417152,70.92839300582847,Transportation
98595,6995,91600,7.094680257619555,92.90531974238044,Transportation
20642,1875,18767,9.083422149016569,90.91657785098343,Housing
173593,9693,163900,5.583750496851832,94.41624950314817,Healthcare
114954,66110,48844,57.50996050594151,42.49003949405849,Transportation
19733,4420,15313,22.399027010591396,77.6009729894086,Housing
24028,10304,13724,42.88330281338438,57.11669718661562,Housing
92729,44512,48217,48.002243095471755,51.997756904528245,Transportation
32571,9281,23290,28.494673175524238,71.50532682447576,Food
175578,14137,161441,8.051692125437128,91.94830787456287,Healthcare
62430,24381,38049,39.053339740509365,60.94666025949063,Transportation
44732,11314,33418,25.292855226683358,74.70714477331664,Food
14202,6416,7786,45.17673567103225,54.823264328967745,Housing
39567,8628,30939,21.806050496625975,78.19394950337403,Food
56882,1536,55346,2.700326992721775,97.29967300727822,Food
92066,1790,90276,1.944257380574805,98.05574261942519,Transportation
167015,24625,142390,14.744184654072987,85.255815345927,Healthcare
12294,3914,8380,31.836668293476496,68.16333170652351,Housing
166053,19874,146179,11.968467898803393,88.0315321011966,Healthcare
49744,22361,27383,44.95215503377292,55.047844966227075,Food
102403,17962,84441,17.540501743112994,82.459498256887,Transportation
22214,10743,11471,48.3613937156748,51.638606284325206,Housing
17601,1293,16308,7.346173512868587,92.65382648713141,Housing
207909,2445,205464,1.175995267160152,98.82400473283984,Entertainment
17979,7880,10099,43.828911507870295,56.171088492129705,Housing
21341,11161,10180,52.29839276510005,47.70160723489995,Housing
42252,8841,33411,20.924453280318094,79.07554671968191,Food
199911,8661,191250,4.332427930429041,95.66757206957097,Entertainment
101467,55289,46178,54.489637024845514,45.510362975154486,Transportation
91096,41179,49917,45.203960656889436,54.79603934311057,Transportation
214957,60600,154357,28.191684848597625,71.80831515140237,Entertainment
29994,3962,26032,13.20930852837234,86.79069147162765,Housing
103994,5943,98051,5.714752774198511,94.2852472258015,Transportation
234960,64250,170710,27.345080013619338,72.65491998638066,Entertainment
35599,9317,26282,26.172083485491164,73.82791651450883,Food
43636,1120,42516,2.5666880557337977,97.4333119442662,Food
156254,28530,127724,18.258732576446043,81.74126742355395,Healthcare
122981,24302,98679,19.760776054837738,80.23922394516227,Healthcare
119436,1374,118062,1.1504069124886969,98.8495930875113,Transportation
55413,29459,25954,53.162615270784826,46.83738472921517,Food
32161,16847,15314,52.38332141413513,47.61667858586487,Food
25326,9882,15444,39.01918976545842,60.98081023454158,Housing
79942,20291,59651,25.38215206024368,74.61784793975632,Transportation
35705,19666,16039,55.07912057134855,44.92087942865145,Food
84309,35562,48747,42.180550119204355,57.819449880795645,Transportation
244634,48858,195776,19.97187635406362,80.02812364593638,Entertainment
226338,53218,173120,23.512622714701024,76.48737728529898,Entertainment
175854,3855,171999,2.192159404960934,97.80784059503907,Healthcare
70013,7543,62470,10.773713453215832,89.22628654678417,Transportation
176976,35251,141725,19.91852002531417,80.08147997468583,Healthcare
142364,62855,79509,44.15090893765278,55.84909106234722,Healthcare
28374,5622,22752,19.813914146754072,80.18608585324593,Housing
123393,37456,85937,30.35504445146807,69.64495554853193,Healthcare
56404,26987,29417,47.84589745408127,52.15410254591873,Food
35000,6610,28390,18.885714285714286,81.11428571428571,Food
99182,14790,84392,14.91197999637031,85.0880200036297,Transportation
223254,44978,178276,20.14655952412947,79.85344047587053,Entertainment
210322,55304,155018,26.294919219102137,73.70508078089786,Entertainment
75103,757,74346,1.007949083258991,98.99205091674102,Transportation
10593,2840,7753,26.810157651279148,73.18984234872086,Housing
12747,6996,5751,54.8835020004707,45.1164979995293,Housing
175916,21584,154332,12.269492257668432,87.73050774233157,Healthcare
30826,1832,28994,5.943035100240057,94.05696489975995,Food
110437,31890,78547,28.876191855990292,71.1238081440097,Transportation
74561,26613,47948,35.692922573463335,64.30707742653667,Transportation
146722,54492,92230,37.13962459617508,62.86037540382492,Healthcare
147783,68239,79544,46.175135164396444,53.824864835603556,Healthcare
105736,32844,72892,31.062268290837558,68.93773170916245,Transportation
48028,6917,41111,14.402015490963604,85.5979845090364,Food
20196,1454,18742,7.199445434739553,92.80055456526046,Housing
182829,40448,142381,22.123404930290054,77.87659506970995,Entertainment
70957,35316,35641,49.7709880631932,50.2290119368068,Transportation
233661,40977,192684,17.536944547870633,82.46305545212937,Entertainment
226109,49991,176118,22.109248194454885,77.89075180554511,Entertainment
75335,34607,40728,45.937479259308425,54.062520740691575,Transportation
172277,25945,146332,15.060048642593033,84.93995135740697,Healthcare
222283,27903,194380,12.55291677726142,87.44708322273858,Entertainment
13577,1368,12209,10.075863592840834,89.92413640715917,Housing
171072,63410,107662,37.066264496820054,62.933735503179946,Healthcare
45715,15645,30070,34.22290276714426,65.77709723285574,Food
191679,42222,149457,22.027452146557525,77.97254785344248,Entertainment
154492,53368,101124,34.54418351759315,65.45581648240686,Healthcare
58684,19643,39041,33.472496762320226,66.52750323767978,Food
15318,4648,10670,30.343386865125993,69.65661313487401,Housing
30404,10532,19872,34.640178923825815,65.35982107617419,Food
79381,26023,53358,32.782403849787734,67.21759615021227,Transportation
225432,63919,161513,28.354004755314243,71.64599524468575,Entertainment
16613,4017,12596,24.179859146451573,75.82014085354842,Housing
248441,20478,227963,8.242600858956454,91.75739914104355,Entertainment
115341,18484,96857,16.025524314857684,83.97447568514231,Transportation
214465,41426,173039,19.315972303173012,80.68402769682699,Entertainment
36218,55,36163,0.1518581920591971,99.8481418079408,Food
154530,64215,90315,41.55503785672685,58.44496214327315,Healthcare
31830,8411,23419,26.424756519007225,73.57524348099277,Food
107814,59509,48305,55.19598567903983,44.80401432096017,Transportation
226975,44335,182640,19.532988214561076,80.46701178543893,Entertainment
98344,57689,40655,58.66041649719352,41.33958350280648,Transportation
29009,1911,27098,6.58761074149402,93.41238925850598,Housing
59897,9396,50501,15.686929228508939,84.31307077149106,Food
191053,25105,165948,13.14033278723705,86.85966721276294,Entertainment
57052,32709,24343,57.33190773329594,42.66809226670406,Food
50175,8340,41835,16.621823617339313,83.37817638266068,Food
26413,7746,18667,29.326468027107865,70.67353197289214,Housing
222657,33235,189422,14.926546212335564,85.07345378766443,Entertainment
191804,3322,188482,1.7319763925674125,98.26802360743258,Entertainment
80095,14145,65950,17.66027841937699,82.33972158062302,Transportation
172606,13968,158638,8.092418571776184,91.90758142822382,Healthcare
53058,29263,23795,55.15285159636624,44.84714840363376,Food
110648,6566,104082,5.934133468295857,94.06586653170415,Transportation
226149,14963,211186,6.616434297741754,93.38356570225824,Entertainment
80727,1230,79497,1.5236537961276897,98.47634620387231,Transportation
117054,40496,76558,34.59599842807593,65.40400157192407,Transportation
221503,58740,162763,26.51882818742861,73.48117181257139,Entertainment
14779,1327,13452,8.978956627647337,91.02104337235266,Housing
52670,21016,31654,39.901272071387886,60.098727928612114,Food
152087,21114,130973,13.882843372543347,86.11715662745665,Healthcare
242635,6650,235985,2.7407422671914605,97.25925773280854,Entertainment
148877,17996,130881,12.087830893959444,87.91216910604057,Healthcare
60958,7912,53046,12.97942845893894,87.02057154106106,Transportation
64967,31332,33635,48.22756168516324,51.77243831483677,Transportation
132246,47340,84906,35.796923914522935,64.20307608547706,Healthcare
144668,9175,135493,6.342107446014323,93.65789255398568,Healthcare
121531,24762,96769,20.3750483415754,79.6249516584246,Healthcare
14671,8673,5998,59.11662463363098,40.88337536636903,Housing
73001,19207,53794,26.310598484952262,73.68940151504773,Transportation
82336,5031,77305,6.110328410415857,93.88967158958414,Transportation
132806,45701,87105,34.4118488622502,65.58815113774979,Healthcare
237871,69890,167981,29.381471469830284,70.61852853016971,Entertainment
13711,826,12885,6.024360002917366,93.97563999708264,Housing
181172,40283,140889,22.23467202437463,77.76532797562538,Entertainment
134714,6050,128664,4.490995739121398,95.50900426087861,Healthcare
84815,24074,60741,28.384130165654657,71.61586983434533,Transportation
111124,65383,45741,58.837874806522436,41.16212519347756,Transportation
23301,4343,18958,18.63868503497704,81.36131496502296,Housing
39430,14136,25294,35.85087496829825,64.14912503170174,Food
212246,62313,149933,29.358857175164665,70.64114282483533,Entertainment
31428,3422,28006,10.888379788723432,89.11162021127656,Food
31133,5655,25478,18.16400603860855,81.83599396139145,Food
38520,12648,25872,32.834890965732086,67.16510903426791,Food
206363,34511,171852,16.723443640575102,83.27655635942489,Entertainment
39774,20358,19416,51.1841906773269,48.815809322673104,Food
21754,10021,11733,46.06509147742944,53.93490852257056,Housing
183666,42596,141070,23.192098700902726,76.80790129909727,Entertainment
125546,28502,97044,22.70243576059771,77.29756423940229,Healthcare
34469,614,33855,1.7813107429864516,98.21868925701355,Food
39632,2478,37154,6.252523213564796,93.7474767864352,Food
42882,25353,17529,59.12270882887925,40.87729117112075,Food
103668,42667,61001,41.157348458540724,58.842651541459276,Transportation
30354,5419,24935,17.852671806022272,82.14732819397773,Food
63075,11386,51689,18.051525961157353,81.94847403884265,Transportation
50554,19769,30785,39.104719705661275,60.895280294338725,Food
195037,10096,184941,5.176453698528997,94.82354630147101,Entertainment
14976,191,14785,1.2753739316239316,98.72462606837607,Housing
23090,13054,10036,56.53529666522304,43.464703334776964,Housing
224340,29978,194362,13.36275296425069,86.63724703574931,Entertainment
31890,7019,24871,22.010034493571652,77.98996550642835,Food
28039,12505,15534,44.598594814365704,55.4014051856343,Housing
13025,7544,5481,57.91938579654511,42.0806142034549,Housing
36757,3260,33497,8.869058954756918,91.13094104524309,Food
35328,14663,20665,41.505321557971016,58.49467844202898,Food
50817,23598,27219,46.4372158923195,53.56278410768051,Food
29227,16825,12402,57.56663359222637,42.43336640777363,Housing
52334,12401,39933,23.695876485649865,76.30412351435012,Food
209382,10467,198915,4.9989970484568875,95.00100295154311,Entertainment
11960,460,11500,3.8461538461538463,96.15384615384616,Housing
221880,27766,194114,12.513971516134848,87.48602848386516,Entertainment
113235,42524,70711,37.55375987989579,62.446240120104214,Transportation
130747,25856,104891,19.775597145632403,80.2244028543676,Healthcare
167296,47054,120242,28.126195485845447,71.87380451415454,Healthcare
48919,7726,41193,15.793454485987041,84.20654551401296,Food
53103,15183,37920,28.59160499406813,71.40839500593187,Food
32599,5342,27257,16.38700573637228,83.61299426362771,Food
14954,2509,12445,16.778119566671123,83.22188043332888,Housing
232799,30363,202436,13.04258179803178,86.95741820196822,Entertainment
15013,7358,7655,49.010857257043895,50.989142742956105,Housing
40570,18971,21599,46.76115356174513,53.238846438254875,Food
73284,38631,34653,52.71409857540527,47.28590142459473,Transportation
189338,1956,187382,1.0330731284792276,98.96692687152078,Entertainment
20489,1711,18778,8.350822392503295,91.6491776074967,Housing
176597,55876,120721,31.64040159232603,68.35959840767397,Healthcare
62813,36892,25921,58.733064811424384,41.266935188575616,Transportation
110465,14973,95492,13.554519531073192,86.4454804689268,Transportation
24120,6511,17609,26.994195688225535,73.00580431177445,Housing
15853,324,15529,2.04377720305305,97.95622279694695,Housing
104392,181,104211,0.1733849337113955,99.82661506628861,Transportation
118904,60843,58061,51.16985130861872,48.83014869138128,Transportation
149018,35071,113947,23.53474076957146,76.46525923042854,Healthcare
217827,58736,159091,26.964517713598408,73.0354822864016,Entertainment
10636,378,10258,3.553967657013915,96.44603234298609,Housing
221879,66662,155217,30.04430342664245,69.95569657335756,Entertainment
209307,46139,163168,22.043696579665276,77.95630342033473,Entertainment
227189,47002,180187,20.68850164400565,79.31149835599435,Entertainment
230214,9927,220287,4.312074852094138,95.68792514790586,Entertainment
94020,38280,55740,40.714741544352265,59.285258455647735,Transportation
12918,3196,9722,24.74067193063942,75.25932806936059,Housing
105698,63376,42322,59.959507275445134,40.040492724554866,Transportation
216825,980,215845,0.4519774011299435,99.54802259887006,Entertainment
150036,66722,83314,44.47066037484337,55.529339625156624,Healthcare
27115,14007,13108,51.657754010695186,48.342245989304814,Housing
13944,5297,8647,37.98766494549627,62.01233505450373,Housing
195681,45532,150149,23.268482887965618,76.73151711203438,Entertainment
33400,15359,18041,45.98502994011976,54.01497005988024,Food
242536,45213,197323,18.641768644654814,81.3582313553452,Entertainment
145651,33322,112329,22.877975434428873,77.12202456557112,Healthcare
78534,38287,40247,48.75213283418647,51.24786716581353,Transportation
41467,16522,24945,39.843731159717365,60.156268840282635,Food
134822,39734,95088,29.47145124682915,70.52854875317085,Healthcare
131814,3291,128523,2.4966998953070236,97.50330010469298,Healthcare
46022,15291,30731,33.22541393246708,66.77458606753291,Food
63311,32661,30650,51.58819162546793,48.41180837453207,Transportation
165538,35551,129987,21.476035713854223,78.52396428614577,Healthcare
214430,22971,191459,10.712586858182158,89.28741314181784,Entertainment
195377,29716,165661,15.209569191870075,84.79043080812993,Entertainment
104361,49792,54569,47.71130978047355,52.28869021952646,Transportation
23836,10902,12934,45.73753985568048,54.26246014431951,Housing
153525,45396,108129,29.569125549584758,70.43087445041523,Healthcare
47371,6928,40443,14.624981528783431,85.37501847121656,Food
150768,21382,129386,14.182054547384059,85.81794545261594,Healthcare
70992,17706,53286,24.94083840432725,75.05916159567275,Transportation
94982,21137,73845,22.253690172874858,77.74630982712513,Transportation
145985,52149,93836,35.7221632359489,64.2778367640511,Healthcare
199702,61793,137909,30.942604480676206,69.05739551932379,Entertainment
63558,374,63184,0.5884389061959155,99.41156109380408,Transportation
10057,83,9974,0.8252958138609924,99.17470418613901,Housing
21638,5310,16328,24.54016082817266,75.45983917182734,Housing
14382,6687,7695,46.495619524405505,53.504380475594495,Housing
64309,11081,53228,17.230869707194948,82.76913029280504,Transportation
55787,12777,43010,22.90318532991557,77.09681467008443,Food
193401,19252,174149,9.954446978040444,90.04555302195956,Entertainment
21104,11321,9783,53.643858984078854,46.35614101592115,Housing
204965,37844,167121,18.463640133681363,81.53635986631865,Entertainment
159625,42334,117291,26.520908379013314,73.4790916209867,Healthcare
88513,40785,47728,46.077977246280206,53.92202275371979,Transportation
113087,27126,85961,23.98684198891119,76.0131580110888,Transportation
10060,1187,8873,11.79920477137177,88.20079522862822,Housing
167019,64653,102366,38.70996712948826,61.29003287051174,Healthcare
134684,54727,79957,40.63363131478127,59.36636868521873,Healthcare
79839,1661,78178,2.080436879219429,97.91956312078057,Transportation
188055,41747,146308,22.199356571215866,77.80064342878413,Entertainment
154061,39631,114430,25.724226118225896,74.2757738817741,Healthcare
35045,5368,29677,15.317448994150379,84.68255100584963,Food
150088,15654,134434,10.429881136399977,89.57011886360003,Healthcare
116771,66718,50053,57.13576144761971,42.8642385523803,Transportation
242964,37313,205651,15.357419206137536,84.64258079386246,Entertainment
13692,6680,7012,48.78761320479112,51.212386795208886,Housing
95343,20649,74694,21.657594160032723,78.34240583996728,Transportation
115235,17143,98092,14.876556601726906,85.1234433982731,Transportation
40404,10530,29874,26.061776061776058,73.93822393822393,Food
27716,12354,15362,44.57353153413191,55.4264684658681,Housing
36511,15670,20841,42.91857248500452,57.081427514995475,Food
172352,8672,163680,5.031563312291125,94.96843668770887,Healthcare
11684,1439,10245,12.315987675453611,87.68401232454639,Housing
179403,17970,161433,10.016554907108578,89.98344509289143,Healthcare
180314,56957,123357,31.587674833900863,68.41232516609914,Entertainment
158294,3759,154535,2.374695187436037,97.62530481256397,Healthcare
87918,36843,51075,41.906094315157304,58.093905684842696,Transportation
56811,28653,28158,50.43565506680044,49.56434493319956,Food
170975,15463,155512,9.044012282497441,90.95598771750257,Healthcare
21332,8583,12749,40.2353272079505,59.7646727920495,Housing
103438,58696,44742,56.74510334693246,43.25489665306754,Transportation
201310,47544,153766,23.617306641498185,76.38269335850183,Entertainment
12241,2913,9328,23.79707540233641,76.2029245976636,Housing
248101,22438,225663,9.04389744499216,90.95610255500785,Entertainment
104158,56688,47470,54.42500816067897,45.57499183932103,Transportation
44985,2992,41993,6.651105924196954,93.34889407580305,Food
97200,31969,65231,32.88991769547325,67.11008230452676,Transportation
24877,2777,22100,11.162921574144793,88.83707842585521,Housing
246889,23981,222908,9.713271956223242,90.28672804377675,Entertainment
56242,237,56005,0.4213932648198855,99.57860673518012,Food
36598,4246,32352,11.601726870320784,88.39827312967921,Food
56009,14896,41113,26.595725686943172,73.40427431305683,Food
238694,59454,179240,24.908041257844772,75.09195874215523,Entertainment
120628,19115,101513,15.846238021023312,84.15376197897669,Healthcare
74284,35330,38954,47.560712939529374,52.43928706047063,Transportation
137262,7948,129314,5.7903862685958245,94.20961373140418,Healthcare
248686,11251,237435,4.52417908527219,95.4758209147278,Entertainment
22698,4529,18169,19.953299850207067,80.04670014979294,Housing
247282,36704,210578,14.842972800284695,85.1570271997153,Entertainment
55486,20981,34505,37.81314205385142,62.18685794614858,Food
26888,3695,23193,13.742189824457007,86.257810175543,Housing
24130,14041,10089,58.18897637795276,41.811023622047244,Housing
20086,6127,13959,30.503833515881706,69.49616648411829,Housing
132232,56545,75687,42.76196382116281,57.23803617883719,Healthcare
84013,16454,67559,19.585064216252245,80.41493578374775,Transportation
30713,13613,17100,44.32325074072868,55.67674925927132,Food
197262,31522,165740,15.979762954851923,84.02023704514806,Entertainment
37175,15990,21185,43.01277740416947,56.98722259583053,Food
43409,16528,26881,38.07505356032159,61.92494643967841,Food
132175,55338,76837,41.86722148666541,58.13277851333459,Healthcare
163174,15564,147610,9.53828428548666,90.46171571451335,Healthcare
143780,49750,94030,34.6014744748922,65.39852552510781,Healthcare
204031,40989,163042,20.089594228328046,79.91040577167196,Entertainment
171303,60731,110572,35.45238553907404,64.54761446092596,Healthcare
108151,15055,93096,13.920352100304203,86.0796478996958,Transportation
244647,51316,193331,20.97552800565713,79.02447199434287,Entertainment
47482,18226,29256,38.38507223790068,61.61492776209933,Food
29298,13171,16127,44.9552870503106,55.0447129496894,Housing
37896,19472,18424,51.38273168672155,48.617268313278444,Food
125573,17086,108487,13.606428133436326,86.39357186656366,Healthcare
17249,5308,11941,30.772798423096994,69.22720157690301,Housing
104512,56552,47960,54.11053276178812,45.88946723821188,Transportation
18121,9123,8998,50.34490370288616,49.65509629711384,Housing
103830,44178,59652,42.54839641722046,57.45160358277954,Transportation
170789,59969,110820,35.11291710824468,64.88708289175533,Healthcare
216830,9515,207315,4.388230410920998,95.611769589079,Entertainment
248131,51670,196461,20.823677815347537,79.17632218465246,Entertainment
53607,17625,35982,32.87816889585316,67.12183110414685,Food
58813,30419,28394,51.72155815891044,48.27844184108955,Food
150989,59261,91728,39.248554530462485,60.751445469537515,Healthcare
233197,29910,203287,12.826065515422583,87.17393448457742,Entertainment
48915,1334,47581,2.727179801696821,97.27282019830318,Food
159121,25792,133329,16.209048459976998,83.790951540023,Healthcare
52508,2617,49891,4.984002437723775,95.01599756227623,Food
11111,2447,8664,22.023220232202323,77.97677976779768,Housing
103052,8281,94771,8.035748942281566,91.96425105771844,Transportation
73103,36071,37032,49.342708233588226,50.657291766411774,Transportation
223334,62036,161298,27.777230515729805,72.2227694842702,Entertainment
158260,68357,89903,43.19284721344623,56.80715278655377,Healthcare
55819,8492,47327,15.213457783192103,84.78654221680789,Food
22281,786,21495,3.527669314662717,96.47233068533728,Housing
32287,9374,22913,29.033357078700405,70.9666429212996,Food
27898,12923,14975,46.32231701197219,53.67768298802782,Housing
19042,9367,9675,49.191261422119524,50.808738577880476,Housing
19325,5206,14119,26.9391979301423,73.0608020698577,Housing
10886,1657,9229,15.221385265478595,84.77861473452141,Housing
83604,40984,42620,49.0215779149323,50.9784220850677,Transportation
27228,14334,12894,52.644336712208016,47.35566328779198,Housing
32878,15622,17256,47.51505566031997,52.48494433968003,Food
170488,32293,138195,18.941509079817934,81.05849092018207,Healthcare
44886,22404,22482,49.91311322015773,50.08688677984227,Food
94124,54395,39729,57.790786621903024,42.209213378096976,Transportation
10308,5229,5079,50.72759022118743,49.27240977881257,Housing
149711,36347,113364,24.278109156975773,75.72189084302423,Healthcare
73025,16766,56259,22.959260527216706,77.04073947278329,Transportation
40693,5172,35521,12.70980266876367,87.29019733123633,Food
130249,64173,66076,49.26947615720658,50.73052384279342,Healthcare
10191,413,9778,4.052595427337847,95.94740457266215,Housing
11730,2358,9372,20.10230179028133,79.89769820971867,Housing
11222,6284,4938,55.99714845838532,44.00285154161468,Housing
13072,6823,6249,52.19553243574051,47.80446756425948,Housing
183447,32766,150681,17.861289636788825,82.13871036321117,Entertainment
202377,60836,141541,30.06072824481043,69.93927175518957,Entertainment
10636,447,10189,4.202707784881535,95.79729221511847,Housing
37108,17683,19425,47.652797240487224,52.347202759512776,Food
24728,12451,12277,50.35182788741508,49.64817211258492,Housing
236274,36742,199532,15.55058956973683,84.44941043026317,Entertainment
71019,7166,63853,10.090257536715526,89.90974246328447,Transportation
198052,45857,152195,23.154020156322584,76.84597984367741,Entertainment
164859,21517,143342,13.051759382259991,86.94824061774001,Healthcare
23385,13020,10365,55.67671584348942,44.32328415651058,Housing
191515,10978,180537,5.732188079262722,94.26781192073727,Entertainment
94899,35135,59764,37.02357242963572,62.97642757036428,Transportation
26808,15832,10976,59.05699791107132,40.94300208892868,Housing
102826,51524,51302,50.10794935133137,49.89205064866862,Transportation
57713,17259,40454,29.904874118482837,70.09512588151716,Food
177144,53559,123585,30.23472429210134,69.76527570789865,Healthcare
11406,342,11064,2.998421883219358,97.00157811678064,Housing
14419,7182,7237,49.809279422983565,50.190720577016435,Housing
43966,21973,21993,49.977255151708135,50.022744848291865,Food
187116,48855,138261,26.10947219906368,73.89052780093633,Entertainment
22654,11502,11152,50.77249050940231,49.22750949059769,Housing
119396,48603,70793,40.70739388254213,59.29260611745787,Transportation
44561,12588,31973,28.248917214604703,71.7510827853953,Food
246855,43833,203022,17.75657774807073,82.24342225192926,Entertainment
132881,27619,105262,20.784762306123525,79.21523769387647,Healthcare
109654,64289,45365,58.62896018385102,41.37103981614898,Transportation
131738,23787,107951,18.056293552353914,81.94370644764608,Healthcare
18110,4187,13923,23.11982330204307,76.88017669795693,Housing
220424,21158,199266,9.598773273327769,90.40122672667223,Entertainment
14202,4662,9540,32.826362484157166,67.17363751584284,Housing
45654,15889,29765,34.8030840671135,65.19691593288648,Food
13970,1910,12060,13.672154617036506,86.3278453829635,Housing
151870,42342,109528,27.8804240468822,72.1195759531178,Healthcare
15497,7279,8218,46.970381364134994,53.029618635865006,Housing
49916,17134,32782,34.32566712076288,65.67433287923711,Food
210169,18947,191222,9.015125922471915,90.98487407752809,Entertainment
235845,26770,209075,11.350675231613984,88.64932476838602,Entertainment
185478,53689,131789,28.946290126052688,71.05370987394731,Entertainment
180770,13174,167596,7.2877136693035345,92.71228633069647,Entertainment
223580,9242,214338,4.133643438590213,95.86635656140979,Entertainment
197422,69373,128049,35.13944747799131,64.8605525220087,Entertainment
23802,14279,9523,59.990757079237035,40.00924292076296,Housing
56948,28313,28635,49.717285945072696,50.282714054927304,Food
102413,39219,63194,38.2949430248113,61.7050569751887,Transportation
51106,7834,43272,15.328924196767503,84.6710758032325,Food
176023,64148,111875,36.44296483982207,63.55703516017793,Healthcare
61739,35741,25998,57.89047441649524,42.109525583504755,Transportation
249422,61230,188192,24.54875672554947,75.45124327445053,Entertainment
137712,64558,73154,46.87899384222145,53.12100615777855,Healthcare
83968,33704,50264,40.1391006097561,59.8608993902439,Transportation
83120,11307,71813,13.60322425409047,86.39677574590952,Transportation
234940,10510,224430,4.4734825912999066,95.5265174087001,Entertainment
51784,8043,43741,15.531824501776612,84.46817549822339,Food
28590,11917,16673,41.68240643581672,58.31759356418328,Housing
191856,23282,168574,12.135143023934617,87.86485697606538,Entertainment
211103,51106,159997,24.20903539978115,75.79096460021884,Entertainment
25212,8699,16513,34.5034110740917,65.4965889259083,Housing
58018,17085,40933,29.4477575924713,70.5522424075287,Food
170525,23995,146530,14.07125054977276,85.92874945022724,Healthcare
194433,10744,183689,5.525810947730067,94.47418905226994,Entertainment
245431,67392,178039,27.45863399489062,72.54136600510938,Entertainment
161445,51618,109827,31.972498374059278,68.02750162594073,Healthcare
25866,12929,12937,49.98453568390938,50.01546431609062,Housing
139575,18990,120585,13.605588393336914,86.39441160666308,Healthcare
108211,51903,56308,47.964624668471785,52.03537533152822,Transportation
55142,14714,40428,26.68383446374814,73.31616553625186,Food
41703,22296,19407,53.46377958420258,46.53622041579742,Food
44414,5355,39059,12.057009051200072,87.94299094879993,Food
39413,15431,23982,39.152056428082105,60.847943571917895,Food
33491,11460,22031,34.218148159206955,65.78185184079305,Food
24846,4229,20617,17.020848426306046,82.97915157369395,Housing
30083,16155,13928,53.70142605458233,46.29857394541767,Food
166275,55995,110280,33.67613892647722,66.32386107352278,Healthcare
200803,49734,151069,24.76755825361175,75.23244174638826,Entertainment
24165,12953,11212,53.60231740120008,46.39768259879992,Housing
44894,3599,41295,8.01666146923865,91.98333853076134,Food
23022,11214,11808,48.70992963252541,51.29007036747459,Housing
19058,1872,17186,9.822646657571624,90.17735334242838,Housing
86770,41453,45317,47.77342399446813,52.22657600553187,Transportation
246154,61284,184870,24.8966094396191,75.1033905603809,Entertainment
233446,58677,174769,25.13514902804075,74.86485097195926,Entertainment
145269,52683,92586,36.265824091857176,63.734175908142824,Healthcare
28704,830,27874,2.891583054626533,97.10841694537346,Housing
20570,8224,12346,39.98055420515313,60.01944579484686,Housing
102479,21219,81260,20.705705559187738,79.29429444081227,Transportation
195774,51492,144282,26.301756106531,73.698243893469,Entertainment
147062,29544,117518,20.08948606710095,79.91051393289905,Healthcare
87887,25615,62272,29.14537986277834,70.85462013722166,Transportation
14531,479,14052,3.2964007982933037,96.7035992017067,Housing
217420,8860,208560,4.075062091803882,95.92493790819611,Entertainment
225383,46756,178627,20.745131620397277,79.25486837960271,Entertainment
25132,2625,22507,10.444851185739298,89.5551488142607,Housing
94736,33109,61627,34.94869954399595,65.05130045600406,Transportation
195707,62948,132759,32.16440904004455,67.83559095995544,Entertainment
30190,5339,24851,17.684663795958926,82.31533620404107,Food
91543,40993,50550,44.780048720273534,55.219951279726466,Transportation
241742,38743,202999,16.026590331841383,83.97340966815861,Entertainment
68644,8861,59783,12.908630033214846,87.09136996678515,Transportation
34825,12918,21907,37.09404163675521,62.90595836324479,Food
225430,25955,199475,11.513551878631947,88.48644812136806,Entertainment
120443,8969,111474,7.446676021022393,92.5533239789776,Healthcare
50541,6148,44393,12.164381393324232,87.83561860667577,Food
10763,3329,7434,30.930038093468365,69.06996190653165,Housing
16122,2709,13413,16.80312616300707,83.19687383699292,Housing
13615,1779,11836,13.066470804260009,86.93352919574,Housing
37597,535,37062,1.422985876532702,98.5770141234673,Food
233632,21829,211803,9.343326256677168,90.65667374332284,Entertainment
239546,11980,227566,5.001127132158333,94.99887286784167,Entertainment
249746,53077,196669,21.2523924307096,78.7476075692904,Entertainment
157168,32901,124267,20.933650615901456,79.06634938409854,Healthcare
208765,32606,176159,15.618518429813427,84.38148157018658,Entertainment
69980,1340,68640,1.914832809374107,98.08516719062588,Transportation
82357,5176,77181,6.284833104654128,93.71516689534587,Transportation
226742,69597,157145,30.694357463548876,69.30564253645112,Entertainment
14048,6434,7614,45.8001138952164,54.1998861047836,Housing
233449,11603,221846,4.970250461556914,95.02974953844308,Entertainment
13273,7347,5926,55.35297219920139,44.64702780079861,Housing
209868,65873,143995,31.38782472792422,68.61217527207579,Entertainment
67187,37564,29623,55.909625373956274,44.090374626043726,Transportation
202873,67291,135582,33.16902692817674,66.83097307182327,Entertainment
50639,13761,36878,27.174707241454215,72.82529275854579,Food
44379,9915,34464,22.341648076793078,77.65835192320692,Food
205793,63401,142392,30.808142162269853,69.19185783773014,Entertainment
213662,67266,146396,31.482434873772597,68.51756512622741,Entertainment
241907,32833,209074,13.572571277391726,86.42742872260828,Entertainment
161406,17125,144281,10.609890586471382,89.39010941352862,Healthcare
83184,3705,79479,4.453981534910559,95.54601846508945,Transportation
77307,37330,39977,48.28799461885728,51.71200538114271,Transportation
53364,5073,48291,9.506408814931415,90.4935911850686,Food
32219,18959,13260,58.84416027809678,41.15583972190323,Food
223535,63870,159665,28.572706734963205,71.4272932650368,Entertainment
149667,37940,111727,25.349609466348628,74.65039053365136,Healthcare
40626,7058,33568,17.373110815733767,82.62688918426623,Food
132658,30781,101877,23.20327458577696,76.79672541422305,Healthcare
84615,24170,60445,28.56467529397861,71.43532470602139,Transportation
54586,30270,24316,55.45377935734438,44.546220642655626,Food
34652,10290,24362,29.695255685097543,70.30474431490245,Food
84940,34342,50598,40.430892394631506,59.5691076053685,Transportation
242147,54300,187847,22.424395098844915,77.57560490115509,Entertainment
55805,15068,40737,27.001164770181884,72.99883522981811,Food
100817,5047,95770,5.006100161679082,94.99389983832091,Transportation
12483,6857,5626,54.93070575983337,45.06929424016663,Housing
175991,56889,119102,32.324948434863146,67.67505156513685,Healthcare
247454,50822,196632,20.53795857007767,79.46204142992232,Entertainment
105867,6114,99753,5.775170733089632,94.22482926691038,Transportation
42424,11069,31355,26.091363379219313,73.90863662078068,Food
30407,14228,16179,46.791857138158974,53.208142861841026,Food
11215,731,10484,6.518056174765939,93.48194382523405,Housing
28187,11556,16631,40.99762301770319,59.0023769822968,Housing
160355,15375,144980,9.588101400018708,90.41189859998128,Healthcare
47845,12781,35064,26.713345177134496,73.2866548228655,Food
201495,51239,150256,25.429415121963324,74.57058487803667,Entertainment
177527,47928,129599,26.997583466176977,73.00241653382302,Healthcare
57137,28943,28194,50.65544218282374,49.34455781717626,Food
90335,46264,44071,51.213815243261195,48.786184756738805,Transportation
13250,542,12708,4.090566037735849,95.90943396226415,Housing
12856,1146,11710,8.914125700062229,91.08587429993777,Housing
22833,3136,19697,13.734507073095958,86.26549292690405,Housing
209727,56165,153562,26.780052163050062,73.21994783694994,Entertainment
36897,1477,35420,4.003035477139063,95.99696452286094,Food
59497,21098,38399,35.46061145940131,64.53938854059868,Food
25701,8740,16961,34.006458892650095,65.99354110734991,Housing
18498,10043,8455,54.29235593037085,45.70764406962915,Housing
22945,9515,13430,41.468729570712576,58.53127042928743,Housing
21909,3062,18847,13.975991601624905,86.0240083983751,Housing
35087,1528,33559,4.354889275230142,95.64511072476985,Food
66999,38499,28500,57.46205167241302,42.537948327586975,Transportation
86847,8785,78062,10.115490460234666,89.88450953976533,Transportation
65966,24145,41821,36.60218900645788,63.39781099354212,Transportation
58390,8570,49820,14.677170748415824,85.32282925158418,Food
32554,9393,23161,28.853597100202737,71.14640289979725,Food
44995,5208,39787,11.574619402155795,88.42538059784421,Food
23313,9593,13720,41.148715309055035,58.85128469094497,Housing
82785,4,82781,0.004831793199251072,99.99516820680074,Transportation
63199,1783,61416,2.8212471716324625,97.17875282836755,Transportation
66756,11449,55307,17.15051830547067,82.84948169452933,Transportation
58685,6759,51926,11.517423532418846,88.48257646758115,Food
244403,49215,195188,20.136823197751255,79.86317680224874,Entertainment
197890,21514,176376,10.871696396988225,89.12830360301177,Entertainment
242705,32067,210638,13.212335963412372,86.78766403658763,Entertainment
95473,21577,73896,22.6001068364878,77.3998931635122,Transportation
95709,44344,51365,46.33211087776489,53.66788912223511,Transportation
19974,2361,17613,11.820366476419345,88.17963352358066,Housing
54715,15110,39605,27.61582746961528,72.38417253038472,Food
51645,3736,47909,7.2340013554071065,92.7659986445929,Food
31965,718,31247,2.246206788675113,97.75379321132489,Food
176165,55484,120681,31.495472994068063,68.50452700593193,Healthcare
98611,21784,76827,22.090841792497795,77.9091582075022,Transportation
154397,54933,99464,35.57905917861098,64.42094082138901,Healthcare
31926,11576,20350,36.258848587358266,63.74115141264174,Food
57112,18139,38973,31.760400616332817,68.23959938366718,Food
216624,32319,184305,14.919399512519387,85.08060048748061,Entertainment
14449,5848,8601,40.473389161879716,59.526610838120284,Housing
101835,36763,65072,36.10055481907006,63.89944518092994,Transportation
13686,4903,8783,35.82493058600029,64.17506941399971,Housing
27815,15229,12586,54.75103361495596,45.24896638504404,Housing
193607,64605,129002,33.369144710676785,66.63085528932322,Entertainment
54537,31349,23188,57.48207638850688,42.51792361149312,Food
18515,9011,9504,48.668647042938154,51.33135295706184,Housing
87974,22874,65100,26.000863891604336,73.99913610839566,Transportation
192244,46319,145925,24.093859886394373,75.90614011360563,Entertainment
117960,22565,95395,19.12936588674127,80.87063411325873,Transportation
21799,11420,10379,52.38772420753246,47.61227579246754,Housing
74683,16607,58076,22.236653589170228,77.76334641082977,Transportation
234397,69280,165117,29.556692278484793,70.4433077215152,Entertainment
177359,65564,111795,36.966829988892584,63.03317001110742,Healthcare
57610,34281,23329,59.505294219753516,40.494705780246484,Food
25120,11998,13122,47.76273885350319,52.23726114649681,Housing
197400,16413,180987,8.314589665653495,91.6854103343465,Entertainment
110067,65177,44890,59.21575040657054,40.78424959342946,Transportation
95168,36589,58579,38.44674680564896,61.55325319435104,Transportation
229810,57220,172590,24.898829467821244,75.10117053217876,Entertainment
27060,12061,14999,44.57132298595713,55.42867701404287,Housing
236682,39454,197228,16.669624221529308,83.33037577847068,Entertainment
15329,7994,7335,52.14952051666776,47.85047948333225,Housing
26166,13029,13137,49.79362531529466,50.206374684705345,Housing
140915,39686,101229,28.163077032253486,71.83692296774652,Healthcare
92105,54553,37552,59.22914065468758,40.77085934531242,Transportation
64615,31184,33431,48.261239650236014,51.73876034976399,Transportation
173696,14663,159033,8.44176031687546,91.55823968312454,Healthcare
179648,62216,117432,34.63216957605985,65.36783042394015,Healthcare
29238,1444,27794,4.938778302209453,95.06122169779054,Housing
57326,20054,37272,34.982381467397,65.01761853260301,Food
19134,3058,16076,15.98202153235079,84.01797846764921,Housing
25194,2406,22788,9.549892831626577,90.45010716837342,Housing
57957,10367,47590,17.887399278775646,82.11260072122435,Food
105680,5661,100019,5.356737320211961,94.64326267978804,Transportation
234823,53521,181302,22.79206040294179,77.2079395970582,Entertainment
28283,10272,18011,36.318636636848986,63.681363363151014,Housing
44470,24444,20026,54.96739374859456,45.03260625140545,Food
14305,7719,6586,53.96015379238028,46.03984620761971,Housing
58482,3084,55398,5.273417461783112,94.72658253821689,Food
162717,1417,161300,0.8708370975374423,99.12916290246255,Healthcare
59022,25214,33808,42.719663854156074,57.280336145843926,Food
235154,39132,196022,16.641009721289027,83.35899027871098,Entertainment
95639,18628,77011,19.477409843264777,80.52259015673522,Transportation
76439,28282,48157,36.99943745993537,63.00056254006463,Transportation
83025,34054,48971,41.01656127672388,58.98343872327613,Transportation
28350,13358,14992,47.11816578483245,52.881834215167544,Housing
109182,18149,91033,16.62270337601436,83.37729662398564,Transportation
200128,52186,147942,26.076311160857053,73.92368883914295,Entertainment
30946,3401,27545,10.990111807664965,89.00988819233504,Food
186880,41169,145711,22.029644691780824,77.97035530821917,Entertainment
11524,3088,8436,26.79625130163138,73.20374869836861,Housing
202154,35358,166796,17.49062595842773,82.50937404157227,Entertainment
191862,54085,137777,28.189532059501097,71.8104679404989,Entertainment
127720,9556,118164,7.481991857187598,92.5180081428124,Healthcare
36108,5653,30455,15.655810346737564,84.34418965326243,Food
211092,65552,145540,31.05375855077407,68.94624144922594,Entertainment
16354,2219,14135,13.568545921487098,86.4314540785129,Housing
46991,8507,38484,18.103466621267902,81.8965333787321,Food
192059,6855,185204,3.569215709755856,96.43078429024415,Entertainment
166869,55181,111688,33.06845489575655,66.93154510424345,Healthcare
78631,7169,71462,9.117269270389542,90.88273072961046,Transportation
101416,6873,94543,6.777037153900765,93.22296284609924,Transportation
83671,38275,45396,45.744642707748206,54.255357292251794,Transportation
132247,54174,78073,40.96425627802521,59.03574372197479,Healthcare
117901,17900,100001,15.182229158361677,84.81777084163834,Transportation
73186,39158,34028,53.50476867160386,46.495231328396144,Transportation
32405,13473,18932,41.57691714241629,58.42308285758371,Food
160746,51118,109628,31.80048026078409,68.1995197392159,Healthcare
29612,15873,13739,53.603268945022286,46.396731054977714,Housing
22907,7451,15456,32.52717509931462,67.47282490068538,Housing
46873,11203,35670,23.900753098798884,76.09924690120113,Food
132202,43200,89002,32.67726660716177,67.32273339283823,Healthcare
206640,41558,165082,20.111304684475417,79.88869531552459,Entertainment
75491,2909,72582,3.8534394828522602,96.14656051714773,Transportation
106097,34347,71750,32.37320565143218,67.62679434856781,Transportation
22149,5204,16945,23.4954174003341,76.50458259966591,Housing
221448,33151,188297,14.970105848777141,85.02989415122286,Entertainment
176138,2212,173926,1.255833494192054,98.74416650580795,Healthcare
17259,8165,9094,47.30865055912857,52.69134944087143,Housing
86090,6208,79882,7.211058194912301,92.7889418050877,Transportation
14231,1452,12779,10.203077787927764,89.79692221207223,Housing
204921,42626,162295,20.801186798815152,79.19881320118485,Entertainment
50168,17480,32688,34.84292776271727,65.15707223728273,Food
191717,6568,185149,3.425882942044785,96.5741170579552,Entertainment
15608,1669,13939,10.69323423885187,89.30676576114813,Housing
147408,42594,104814,28.895310973624227,71.10468902637578,Healthcare
236909,58084,178825,24.517430743450017,75.48256925654998,Entertainment
28764,15121,13643,52.56918370184953,47.43081629815046,Housing
38142,7441,30701,19.50867809763515,80.49132190236485,Food
126698,57882,68816,45.685014759506856,54.314985240493144,Healthcare
68897,16249,52648,23.584481182054372,76.41551881794562,Transportation
214281,8975,205306,4.188425478693865,95.81157452130613,Entertainment
45817,6326,39491,13.807102167317808,86.19289783268219,Food
156243,39329,116914,25.171687691608586,74.82831230839142,Healthcare
10968,6010,4958,54.795769511305615,45.204230488694385,Housing
68921,17029,51892,24.70799901336313,75.29200098663688,Transportation
65775,27323,38452,41.540098821740784,58.45990117825922,Transportation
46005,8481,37524,18.43495272253016,81.56504727746984,Food
16805,3796,13009,22.58851532282059,77.41148467717942,Housing
118755,42429,76326,35.7281798661109,64.27182013388911,Transportation
145433,66333,79100,45.61069358398713,54.38930641601287,Healthcare
71181,17044,54137,23.94459195571852,76.05540804428148,Transportation
80838,19749,61089,24.43034216581311,75.56965783418688,Transportation
53002,16913,36089,31.910116599373605,68.08988340062639,Food
40188,8495,31693,21.13815069174878,78.86184930825122,Food
28405,1958,26447,6.8931526139764125,93.10684738602359,Housing
25801,12159,13642,47.12608038448122,52.87391961551878,Housing
94710,15323,79387,16.178861788617883,83.82113821138212,Transportation
213850,29381,184469,13.739069441197103,86.2609305588029,Entertainment
19049,1616,17433,8.483384954590791,91.51661504540921,Housing
153736,29968,123768,19.493157100483945,80.50684289951604,Healthcare
19634,10426,9208,53.10176224915962,46.89823775084038,Housing
105163,1065,104098,1.0127135969875336,98.98728640301246,Transportation
114244,19721,94523,17.262175694128356,82.73782430587164,Transportation
225963,5167,220796,2.2866575501298883,97.71334244987011,Entertainment
169584,64815,104769,38.21999716954429,61.78000283045571,Healthcare
113837,44022,69815,38.671082337025744,61.32891766297425,Transportation
242542,55699,186843,22.96468240552152,77.03531759447849,Entertainment
248425,1657,246768,0.6670021133138774,99.33299788668613,Entertainment
222643,50097,172546,22.501044272669702,77.4989557273303,Entertainment
74239,12324,61915,16.600439122294212,83.3995608777058,Transportation
26070,4034,22036,15.473724587648638,84.52627541235135,Housing
19568,10845,8723,55.4221177432543,44.57788225674571,Housing
145272,40913,104359,28.16303210529214,71.83696789470785,Healthcare
46918,16568,30350,35.31267317447461,64.68732682552539,Food
186441,7123,179318,3.8205115827527205,96.17948841724728,Entertainment
122807,58053,64754,47.27173532453362,52.728264675466384,Healthcare
26203,14206,11997,54.21516620234325,45.78483379765675,Housing
116806,31217,85589,26.725510675821447,73.27448932417855,Transportation
218894,69985,148909,31.972096083035623,68.02790391696438,Entertainment
81469,1151,80318,1.4128073254857676,98.58719267451423,Transportation
35172,20754,14418,59.007164790174,40.992835209826,Food
157508,30104,127404,19.112679990857607,80.8873200091424,Healthcare
53574,5199,48375,9.704334191958786,90.29566580804122,Food
27070,15937,11133,58.873291466568155,41.126708533431845,Housing
153813,14024,139789,9.117564835221991,90.882435164778,Healthcare
205512,61690,143822,30.017711861107866,69.98228813889213,Entertainment
32338,937,31401,2.8975199455748655,97.10248005442513,Food
24920,12291,12629,49.32182985553772,50.67817014446228,Housing
73291,22554,50737,30.77321908556303,69.22678091443697,Transportation
51659,28115,23544,54.42420488201475,45.57579511798525,Food
91594,38575,53019,42.1152040526672,57.88479594733279,Transportation
219560,67158,152402,30.58753871379122,69.41246128620878,Entertainment
27426,14191,13235,51.74287172755779,48.25712827244221,Housing
56956,7480,49476,13.132944729264695,86.8670552707353,Food
51440,25873,25567,50.29743390357698,49.70256609642302,Food
18367,5270,13097,28.692764196657052,71.30723580334295,Housing
175926,18335,157591,10.42199561179132,89.57800438820868,Healthcare
52309,23385,28924,44.705500009558584,55.294499990441416,Food
220345,7588,212757,3.443690576141959,96.55630942385804,Entertainment
158695,56,158639,0.03528781625129967,99.9647121837487,Healthcare
76600,9711,66889,12.677545691906007,87.322454308094,Transportation
172998,16617,156381,9.605313356223771,90.39468664377623,Healthcare
134020,50997,83023,38.051783315923,61.948216684077,Healthcare
14441,2558,11883,17.713454746901185,82.28654525309882,Housing
137355,17218,120137,12.535400968293835,87.46459903170616,Healthcare
23726,5728,17998,24.14229115738009,75.85770884261991,Housing
41577,11456,30121,27.553695552829687,72.4463044471703,Food
132768,33674,99094,25.363039286575077,74.63696071342493,Healthcare
58744,7660,51084,13.039629579191066,86.96037042080893,Food
200035,22791,177244,11.393506136426126,88.60649386357387,Entertainment
232816,32628,200188,14.014500721599891,85.98549927840011,Entertainment
34621,8453,26168,24.415816989688338,75.58418301031166,Food
63869,17367,46502,27.191595296622772,72.80840470337722,Transportation
120234,54975,65259,45.7233394879984,54.2766605120016,Healthcare
211516,48500,163016,22.929707445299645,77.07029255470034,Entertainment
38631,17161,21470,44.42287282234475,55.57712717765525,Food
242632,12413,230219,5.115978106762505,94.88402189323749,Entertainment
187841,14066,173775,7.488248039565377,92.51175196043462,Entertainment
224085,57635,166450,25.720150835620416,74.27984916437958,Entertainment
97589,48715,48874,49.91853590056257,50.08146409943743,Transportation
26493,3445,23048,13.003434869588194,86.99656513041181,Housing
212713,40829,171884,19.194407488023767,80.80559251197623,Entertainment
81559,33578,47981,41.170195809168824,58.82980419083118,Transportation
72838,41212,31626,56.58035640736978,43.41964359263022,Transportation
59276,22147,37129,37.36250759160537,62.63749240839462,Food
28154,15517,12637,55.11472614903744,44.88527385096256,Housing
165327,48246,117081,29.182166252336277,70.81783374766371,Healthcare
85164,35253,49911,41.394251092010705,58.60574890798929,Transportation
65611,1053,64558,1.6049138101842677,98.39508618981573,Transportation
33041,6022,27019,18.225840622257195,81.7741593777428,Food
58355,16736,41619,28.679633279067772,71.32036672093223,Food
49113,20346,28767,41.42691344450552,58.57308655549447,Food
172472,28350,144122,16.437450716638065,83.56254928336195,Healthcare
20327,6532,13795,32.13459930142176,67.86540069857824,Housing
206593,21975,184618,10.63685604062093,89.36314395937906,Entertainment
177428,24058,153370,13.559302928511846,86.44069707148815,Healthcare
93650,40977,52673,43.755472504004274,56.24452749599573,Transportation
139049,12031,127018,8.652345576019965,91.34765442398005,Healthcare
120888,67060,53828,55.472834359076174,44.52716564092383,Healthcare
16002,8673,7329,54.199475065616795,45.800524934383205,Housing
31095,18216,12879,58.581765557163536,41.41823444283647,Food
66629,35237,31392,52.88538023983551,47.114619760164494,Transportation
246903,62114,184789,25.157247988076286,74.84275201192371,Entertainment
31059,670,30389,2.157184712965646,97.84281528703436,Food
20586,11928,8658,57.94229087729524,42.05770912270475,Housing
38182,6205,31977,16.251113089937665,83.74888691006234,Food
100909,55832,45077,55.32905885500797,44.67094114499202,Transportation
65807,33571,32236,51.01432978254593,48.98567021745407,Transportation
72393,2377,70016,3.2834666335142897,96.71653336648572,Transportation
206097,57897,148200,28.092111966695292,71.9078880333047,Entertainment
18113,2512,15601,13.868492243140285,86.13150775685972,Housing
27619,13125,14494,47.521633657989064,52.47836634201093,Housing
182625,46006,136619,25.19151266255989,74.80848733744011,Entertainment
191261,64473,126788,33.70943370577378,66.29056629422621,Entertainment
131775,3277,128498,2.4868146461771956,97.5131853538228,Healthcare
231010,3263,227747,1.4124929656724816,98.58750703432752,Entertainment
91504,4234,87270,4.627120125896136,95.37287987410387,Transportation
21697,5141,16556,23.6945199797207,76.3054800202793,Housing
185264,37290,147974,20.128033508938596,79.87196649106141,Entertainment
15155,3187,11968,21.02936324645332,78.97063675354669,Housing
200420,37339,163081,18.630376209959085,81.36962379004092,Entertainment
150245,49511,100734,32.95350926819528,67.04649073180472,Healthcare
208322,24922,183400,11.963210798667449,88.03678920133255,Entertainment
16092,3462,12630,21.513795674869503,78.4862043251305,Housing
197129,33179,163950,16.831110592556144,83.16888940744386,Entertainment
68873,6002,62871,8.714590623321184,91.28540937667881,Transportation
43594,12974,30620,29.760976281139605,70.2390237188604,Food
120162,29558,90604,24.598458747357736,75.40154125264226,Healthcare
205219,51220,153999,24.95870265423767,75.04129734576233,Entertainment
120649,10380,110269,8.603469568749016,91.396530431251,Healthcare
50747,24968,25779,49.20093798648196,50.79906201351804,Food
159441,68140,91301,42.736811736002664,57.26318826399734,Healthcare
58050,428,57622,0.7372954349698536,99.26270456503015,Food
225307,28718,196589,12.746164122730319,87.25383587726968,Entertainment
33353,6537,26816,19.599436332563787,80.4005636674362,Food
36093,3737,32356,10.353808217659934,89.64619178234007,Food
25567,11757,13810,45.98505886494309,54.0149411350569,Housing
50839,4103,46736,8.070575739097936,91.92942426090205,Food
100708,14658,86050,14.554950947293163,85.44504905270684,Transportation
237908,12291,225617,5.166282764766212,94.83371723523378,Entertainment
203740,40485,163255,19.87091390988515,80.12908609011485,Entertainment
64051,5486,58565,8.565049725999595,91.4349502740004,Transportation
172462,12485,159977,7.239275898458791,92.76072410154121,Healthcare
157009,36592,120417,23.305670375583563,76.69432962441644,Healthcare
206364,48182,158182,23.348064584908222,76.65193541509177,Entertainment
31458,17973,13485,57.13332061796681,42.86667938203318,Food
184602,22489,162113,12.18242489247137,87.81757510752864,Entertainment
137519,40038,97481,29.114522356910683,70.88547764308932,Healthcare
46320,18356,27964,39.6286701208981,60.3713298791019,Food
27992,16644,11348,59.45984567019148,40.540154329808516,Housing
18640,3207,15433,17.204935622317596,82.79506437768241,Housing
77301,11077,66224,14.329698192778878,85.67030180722112,Transportation
10779,4631,6148,42.963169125150756,57.036830874849244,Housing
28674,13582,15092,47.36695264002232,52.63304735997768,Housing
145861,27451,118410,18.81997243951433,81.18002756048567,Healthcare
225761,1781,223980,0.788887363184961,99.21111263681503,Entertainment
62289,16295,45994,26.160317230971756,73.83968276902823,Transportation
86476,7767,78709,8.981682779036957,91.01831722096304,Transportation
112301,2864,109437,2.55028895557475,97.44971104442524,Transportation
155962,36592,119370,23.46212538951796,76.53787461048204,Healthcare
197727,63028,134699,31.87627385233175,68.12372614766825,Entertainment
14971,6318,8653,42.201589740164316,57.798410259835684,Housing
158018,39760,118258,25.161690440329583,74.8383095596704,Healthcare
19061,2757,16304,14.464088977493311,85.5359110225067,Housing
209039,14287,194752,6.834609809652744,93.16539019034725,Entertainment
140795,32676,108119,23.208210518839447,76.79178948116055,Healthcare
41880,18793,23087,44.87344794651385,55.12655205348616,Food
90840,3966,86874,4.365918097754293,95.63408190224571,Transportation
60822,4265,56557,7.012265298740587,92.98773470125941,Transportation
45471,19208,26263,42.24230828440105,57.75769171559896,Food
83598,28087,55511,33.597693724730256,66.40230627526974,Transportation
48106,621,47485,1.2908992641250572,98.70910073587494,Food
26630,14668,11962,55.080736012016516,44.91926398798348,Housing
80641,24683,55958,30.608499398568966,69.39150060143103,Transportation
192388,22447,169941,11.667567623760318,88.33243237623968,Entertainment
107943,61287,46656,56.77718796031239,43.22281203968761,Transportation
12920,5459,7461,42.25232198142415,57.747678018575854,Housing
121851,53153,68698,43.62130799090693,56.378692009093065,Healthcare
233760,25783,207977,11.029688569472963,88.97031143052703,Entertainment
86956,39361,47595,45.265421592529556,54.734578407470444,Transportation
242852,28691,214161,11.814191359346433,88.18580864065356,Entertainment
176618,64464,112154,36.49911107588128,63.50088892411871,Healthcare
17638,6566,11072,37.22644290735911,62.773557092640885,Housing
82853,42112,40741,50.82736895465463,49.17263104534537,Transportation
248306,64388,183918,25.930907831466016,74.06909216853398,Entertainment
104468,14328,90140,13.715204655971206,86.2847953440288,Transportation
229269,23447,205822,10.226851427798787,89.77314857220121,Entertainment
85504,2460,83044,2.877058383233533,97.12294161676647,Transportation
238872,14552,224320,6.0919655715194745,93.90803442848052,Entertainment
158501,47282,111219,29.830726620021323,70.16927337997868,Healthcare
229518,32213,197305,14.035064787946915,85.96493521205308,Entertainment
196560,62759,133801,31.92867317867318,68.07132682132682,Entertainment
113245,66471,46774,58.696631197845385,41.30336880215462,Transportation
183524,58155,125369,31.687953619145183,68.31204638085482,Entertainment
23083,4262,18821,18.46380453147338,81.53619546852661,Housing
41882,16896,24986,40.34191299364882,59.65808700635118,Food
216053,9345,206708,4.325327581658205,95.6746724183418,Entertainment
180727,33049,147678,18.28669761574087,81.71330238425914,Entertainment
15700,8779,6921,55.917197452229296,44.0828025477707,Housing
185487,29902,155585,16.120806309876166,83.87919369012383,Entertainment
29329,15763,13566,53.74543966722357,46.254560332776435,Housing
165611,3222,162389,1.9455229423166336,98.05447705768337,Healthcare
229737,38500,191237,16.758293178721757,83.24170682127826,Entertainment
41865,18913,22952,45.176161471396156,54.823838528603844,Food
23332,10355,12977,44.381107491856675,55.618892508143325,Housing
160780,27020,133760,16.805572832441847,83.19442716755815,Healthcare
196065,54207,141858,27.647463851273812,72.35253614872619,Entertainment
223361,42020,181341,18.812594857651963,81.18740514234804,Entertainment
48061,18984,29077,39.49980233453319,60.50019766546681,Food
68105,16263,51842,23.879304015857866,76.12069598414213,Transportation
123753,67639,56114,54.656452772862075,45.343547227137925,Healthcare
121705,22401,99304,18.405981677005876,81.59401832299412,Healthcare
25319,9047,16272,35.73205892807773,64.26794107192228,Housing
115082,58769,56313,51.067065223058336,48.932934776941664,Transportation
182444,24634,157810,13.502225340378418,86.49777465962158,Entertainment
184864,40758,144106,22.047559286827074,77.95244071317293,Entertainment
230298,15260,215038,6.626197361679216,93.37380263832078,Entertainment
10022,2858,7164,28.517262023548195,71.4827379764518,Housing
31876,14844,17032,46.567950809386375,53.432049190613625,Food
14788,7629,7159,51.58912631863674,48.41087368136327,Housing
51845,30982,20863,59.75889671135114,40.24110328864886,Food
12469,6452,6017,51.744325928302196,48.25567407169781,Housing
96696,12411,84285,12.835070737155622,87.16492926284438,Transportation
71747,8388,63359,11.691081160187883,88.30891883981212,Transportation
93850,49599,44251,52.84922749067661,47.15077250932339,Transportation
34718,13562,21156,39.06331009850798,60.936689901492024,Food
47085,27640,19445,58.70234681958161,41.29765318041839,Food
70341,8867,61474,12.60573491989025,87.39426508010976,Transportation
18116,3774,14342,20.832413336277327,79.16758666372267,Housing
236388,26386,210002,11.162157131495677,88.83784286850432,Entertainment
134972,66654,68318,49.38357585276946,50.61642414723053,Healthcare
108973,38591,70382,35.413359272480335,64.58664072751967,Transportation
233498,4618,228880,1.9777471327377536,98.02225286726225,Entertainment
32561,17328,15233,53.217038788734996,46.78296121126501,Food
163287,29052,134235,17.791985889874883,82.20801411012512,Healthcare
201413,35646,165767,17.697963885151406,82.3020361148486,Entertainment
186660,2011,184649,1.0773599057109182,98.92264009428908,Entertainment
189315,56436,132879,29.810633071864352,70.18936692813564,Entertainment
209598,63565,146033,30.327102357846925,69.67289764215307,Entertainment
19823,848,18975,4.277859052615648,95.72214094738435,Housing
59665,8587,51078,14.392022123523004,85.607977876477,Food
51286,3179,48107,6.198572709901338,93.80142729009866,Food
101515,12375,89140,12.190316701965227,87.80968329803477,Transportation
55861,28107,27754,50.31596283632588,49.68403716367412,Food
17087,5182,11905,30.32714929478551,69.6728507052145,Housing
152640,35595,117045,23.319575471698112,76.68042452830188,Healthcare
16395,953,15442,5.812747788960049,94.18725221103995,Housing
63222,12799,50423,20.244535130176207,79.7554648698238,Transportation
65248,3404,61844,5.217018146150074,94.78298185384992,Transportation
20745,7771,12974,37.45962882622319,62.54037117377681,Housing
57581,9006,48575,15.640575884406315,84.35942411559368,Food
19504,11678,7826,59.874897456931905,40.12510254306809,Housing
141805,37762,104043,26.629526462395543,73.37047353760445,Healthcare
102479,8228,94251,8.028962031245426,91.97103796875457,Transportation
57570,9875,47695,17.153031092582943,82.84696890741706,Food
219425,60185,159240,27.428506323345108,72.5714936766549,Entertainment
76447,13247,63200,17.328345127997174,82.67165487200283,Transportation
47528,4654,42874,9.792122538293217,90.20787746170679,Food
39648,9832,29816,24.79822437449556,75.20177562550444,Food
196412,37204,159208,18.941816182310653,81.05818381768934,Entertainment
206799,59531,147268,28.786889685153216,71.21311031484679,Entertainment
200869,49098,151771,24.44279605115772,75.55720394884227,Entertainment
100490,33212,67278,33.05005473181411,66.94994526818589,Transportation
145934,1482,144452,1.015527567256431,98.98447243274356,Healthcare
115123,46062,69061,40.01111854277599,59.98888145722401,Transportation
39591,8249,31342,20.83554343158799,79.164456568412,Food
133589,48376,85213,36.2125624115758,63.7874375884242,Healthcare
90158,40462,49696,44.87899021717429,55.1210097828257,Transportation
167085,43740,123345,26.17829248586049,73.82170751413952,Healthcare
86798,2591,84207,2.985091822392221,97.01490817760778,Transportation
65937,32177,33760,48.79961175061043,51.200388249389576,Transportation
174181,5199,168982,2.984826129141525,97.01517387085848,Healthcare
17205,1359,15846,7.898866608544028,92.10113339145597,Housing
170646,43792,126854,25.662482566248258,74.33751743375174,Healthcare
167305,68756,98549,41.09620154807089,58.90379845192911,Healthcare
61708,13383,48325,21.68762559149543,78.31237440850457,Transportation
21579,9754,11825,45.20135316743129,54.7986468325687,Housing
57876,31722,26154,54.810284055567074,45.189715944432926,Food
19956,1795,18161,8.994788534776509,91.0052114652235,Housing
214106,30639,183467,14.310201488982093,85.68979851101791,Entertainment
52240,6631,45609,12.69333843797856,87.30666156202143,Food
44199,26113,18086,59.08052218375981,40.91947781624018,Food
111601,62947,48654,56.403616455049686,43.596383544950314,Transportation
105387,50669,54718,48.07898507406036,51.92101492593964,Transportation
143620,59590,84030,41.491435733184794,58.50856426681521,Healthcare
190480,25517,164963,13.396157076858461,86.60384292314154,Entertainment
36972,2134,34838,5.771935518770962,94.22806448122904,Food
126514,3391,123123,2.6803357731160187,97.31966422688399,Healthcare
152034,66834,85200,43.95990370575003,56.04009629424998,Healthcare
146819,48306,98513,32.90173615131556,67.09826384868444,Healthcare
202258,41610,160648,20.57273383500282,79.42726616499718,Entertainment
53493,6180,47313,11.552913465313218,88.44708653468678,Food
27660,6119,21541,22.122198120028923,77.87780187997107,Housing
129929,64922,65007,49.967289827521185,50.032710172478815,Healthcare
53756,10784,42972,20.061016444675943,79.93898355532406,Food
12877,5954,6923,46.237477673371124,53.76252232662887,Housing
237168,11715,225453,4.939536531066586,95.0604634689334,Entertainment
134161,39302,94859,29.294653438778777,70.70534656122122,Healthcare
182063,50003,132060,27.46466882342925,72.53533117657075,Entertainment
199620,63680,135940,31.900611161206292,68.0993888387937,Entertainment
227580,34662,192918,15.23068810967572,84.76931189032429,Entertainment
92454,36311,56143,39.2746663205486,60.725333679451396,Transportation
205173,47791,157382,23.29302588547226,76.70697411452774,Entertainment
56802,25029,31773,44.06358931023556,55.93641068976445,Food
123521,48951,74570,39.62969859376139,60.37030140623861,Healthcare
95167,17197,77970,18.070339508443052,81.92966049155694,Transportation
191449,61154,130295,31.942710591332418,68.05728940866759,Entertainment
45215,12097,33118,26.754395665155368,73.24560433484463,Food
85418,36339,49079,42.542555433281045,57.45744456671896,Transportation
190948,66312,124636,34.727779290696944,65.27222070930306,Entertainment
41670,912,40758,2.1886249100071997,97.81137508999281,Food
150662,4377,146285,2.9051784789794373,97.09482152102056,Healthcare
19063,2463,16600,12.92031684414835,87.07968315585165,Housing
246704,67019,179685,27.165753291393735,72.83424670860626,Entertainment
158281,26569,131712,16.78596925720712,83.21403074279287,Healthcare
190462,57758,132704,30.32520922808749,69.67479077191251,Entertainment
73021,2408,70613,3.2976814888867585,96.70231851111323,Transportation
118564,53237,65327,44.90148780405519,55.09851219594481,Transportation
118771,45826,72945,38.58349260341329,61.41650739658671,Transportation
211119,68595,142524,32.49115427791909,67.5088457220809,Entertainment
70199,22208,47991,31.63577828743999,68.36422171256001,Transportation
156197,52631,103566,33.69526943539248,66.30473056460751,Healthcare
28634,5727,22907,20.000698470349935,79.99930152965007,Housing
44510,8067,36443,18.12401707481465,81.87598292518535,Food
82976,14474,68502,17.44359814886232,82.55640185113768,Transportation
52785,28536,24249,54.06081273088946,45.93918726911054,Food
17150,6842,10308,39.89504373177842,60.10495626822158,Housing
34927,19750,15177,56.546511294986686,43.453488705013314,Food
33174,18457,14717,55.636944595164884,44.36305540483511,Food
158367,13564,144803,8.56491567056268,91.43508432943732,Healthcare
122618,41571,81047,33.90285276223719,66.09714723776281,Healthcare
248209,23494,224715,9.465410198663223,90.53458980133678,Entertainment
130998,6913,124085,5.277179804271821,94.72282019572818,Healthcare
44671,6319,38352,14.14564258691321,85.85435741308679,Food
240424,31020,209404,12.902206102552158,87.09779389744784,Entertainment
76500,23608,52892,30.86013071895425,69.13986928104575,Transportation
148491,56911,91580,38.32622852563455,61.673771474365445,Healthcare
179788,55636,124152,30.94533561750506,69.05466438249493,Healthcare
71252,2609,68643,3.6616516027620274,96.33834839723797,Transportation
44952,15149,29803,33.70039152874177,66.29960847125822,Food
156138,16934,139204,10.845534078827704,89.1544659211723,Healthcare
231355,1143,230212,0.4940459467052798,99.50595405329472,Entertainment
211401,3163,208238,1.4962086272061155,98.50379137279388,Entertainment
13178,1832,11346,13.90195780846866,86.09804219153135,Housing
97683,32429,65254,33.19820234841273,66.80179765158728,Transportation
92585,24233,68352,26.173786250472535,73.82621374952745,Transportation
82433,31727,50706,38.488226802372836,61.511773197627164,Transportation
112970,38073,74897,33.70186775250066,66.29813224749932,Transportation
119906,22480,97426,18.74801928177072,81.25198071822928,Transportation
221879,26159,195720,11.789759283212922,88.21024071678708,Entertainment
84879,26322,58557,31.011204184780688,68.98879581521932,Transportation
19250,8392,10858,43.5948051948052,56.4051948051948,Housing
154251,32454,121797,21.039733940136532,78.96026605986347,Healthcare
81649,36473,45176,44.670479736432775,55.329520263567225,Transportation
100691,60173,40518,59.76005799922536,40.23994200077465,Transportation
22613,5529,17084,24.450537301552206,75.5494626984478,Housing
59329,20209,39120,34.06260007753375,65.93739992246624,Food
112570,61346,51224,54.49586923691925,45.50413076308075,Transportation
103999,13043,90956,12.541466744872547,87.45853325512746,Transportation
17950,8447,9503,47.05849582172702,52.94150417827298,Housing
77048,44369,32679,57.58618004360918,42.41381995639082,Transportation
112366,46119,66247,41.04355409999466,58.95644590000534,Transportation
52752,31600,21152,59.90294206854716,40.09705793145283,Food
13495,959,12536,7.106335679881437,92.89366432011856,Housing
33441,4067,29374,12.161717651984091,87.83828234801591,Food
10468,3560,6908,34.00840657241116,65.99159342758884,Housing
65665,20943,44722,31.893702885860048,68.10629711413996,Transportation
139306,43272,96034,31.062552941007564,68.93744705899243,Healthcare
79653,33412,46241,41.94694487338832,58.053055126611675,Transportation
133505,46498,87007,34.828658102692785,65.17134189730723,Healthcare
10108,4840,5268,47.88286505738029,52.1171349426197,Housing
147391,61910,85481,42.00392154202088,57.99607845797912,Healthcare
37242,4278,32964,11.48703077170936,88.51296922829064,Food
22752,6999,15753,30.762130801687764,69.23786919831224,Housing
18034,8726,9308,48.386381279804816,51.613618720195184,Housing
61682,33846,27836,54.87176161603061,45.128238383969396,Transportation
62850,19752,43098,31.427207637231504,68.5727923627685,Transportation
49051,9775,39276,19.928237956412715,80.07176204358728,Food
26440,6899,19541,26.09304084720121,73.90695915279879,Housing
174791,31945,142846,18.27611261449388,81.72388738550612,Healthcare
59418,26323,33095,44.30139015113265,55.69860984886734,Food
184436,30360,154076,16.46099459975276,83.53900540024723,Entertainment
222820,23712,199108,10.641773628938155,89.35822637106185,Entertainment
170449,23055,147394,13.526040047169536,86.47395995283047,Healthcare
52835,2328,50507,4.406170152361124,95.59382984763887,Food
77243,45943,31300,59.478528798726096,40.521471201273904,Transportation
184131,39536,144595,21.471669626515904,78.5283303734841,Entertainment
55164,6384,48780,11.572764846639112,88.42723515336088,Food
98052,57804,40248,58.95239260800391,41.04760739199608,Transportation
13451,4566,8885,33.94543156642629,66.0545684335737,Housing
27547,1968,25579,7.1441536283442835,92.85584637165572,Housing
39298,12664,26634,32.2255585525981,67.7744414474019,Food
85401,22996,62405,26.927085162937203,73.0729148370628,Transportation
59980,3253,56727,5.423474491497165,94.57652550850283,Food
18095,1737,16358,9.599336833379386,90.4006631666206,Housing
52583,6866,45717,13.05745202822205,86.94254797177796,Food
39378,12525,26853,31.807100411397226,68.19289958860277,Food
14119,7348,6771,52.043345846023094,47.95665415397691,Housing
60376,22580,37796,37.39896647674573,62.601033523254266,Transportation
146687,68495,78192,46.69466278538657,53.305337214613424,Healthcare
226073,26473,199600,11.7099344017198,88.2900655982802,Entertainment
24459,9848,14611,40.2632977636044,59.7367022363956,Housing
200605,1549,199056,0.7721642032850626,99.22783579671494,Entertainment
124441,58717,65724,47.184609574015,52.81539042598501,Healthcare
174745,45440,129305,26.003605253369194,73.9963947466308,Healthcare
29786,15095,14691,50.67817095279662,49.32182904720339,Housing
239641,67889,171752,28.329459483143538,71.67054051685646,Entertainment
57865,16719,41146,28.89311328091247,71.10688671908754,Food
78450,4916,73534,6.266411727214787,93.73358827278521,Transportation
117521,23856,93665,20.29935075433327,79.70064924566674,Transportation
12504,6715,5789,53.70281509916827,46.29718490083173,Housing
91785,21252,70533,23.15411014871711,76.84588985128289,Transportation
62550,15683,46867,25.072741806554756,74.92725819344524,Transportation
14001,7780,6221,55.56745946718091,44.43254053281909,Housing
153382,23859,129523,15.55528028060659,84.44471971939342,Healthcare
97899,51389,46510,52.49185384937538,47.508146150624626,Transportation
43207,12772,30435,29.56002499594973,70.43997500405027,Food
37650,7637,30013,20.284196547144752,79.71580345285525,Food
168012,26868,141144,15.99171487750875,84.00828512249126,Healthcare
212472,35327,177145,16.626661395383863,83.37333860461614,Entertainment
248920,69587,179333,27.95556805399325,72.04443194600675,Entertainment
96013,55800,40213,58.11712997198296,41.88287002801704,Transportation
187655,59081,128574,31.483840025578857,68.51615997442114,Entertainment
49564,2160,47404,4.358001775482205,95.6419982245178,Food
195443,6633,188810,3.3938283796298667,96.60617162037013,Entertainment
31917,9720,22197,30.45399003665758,69.54600996334241,Food
23118,6137,16981,26.546414049658274,73.45358595034173,Housing
34006,7215,26791,21.216844086337705,78.7831559136623,Food
181830,26769,155061,14.72199307045042,85.27800692954958,Entertainment
245571,53895,191676,21.946809680296127,78.05319031970387,Entertainment
153057,28041,125016,18.320625649267917,81.67937435073208,Healthcare
82095,4836,77259,5.890736342042755,94.10926365795724,Transportation
191865,39099,152766,20.3783910562114,79.6216089437886,Entertainment
98090,39735,58355,40.50871648486084,59.49128351513916,Transportation
231323,55739,175584,24.095744910795727,75.90425508920427,Entertainment
37404,8071,29333,21.57790610629879,78.4220938937012,Food
14647,810,13837,5.53014269133611,94.46985730866389,Housing
25962,9548,16414,36.77682767121177,63.22317232878822,Housing
66014,20656,45358,31.290332353743146,68.70966764625686,Transportation
19342,2191,17151,11.327680694860923,88.67231930513908,Housing
59712,5962,53750,9.984592711682744,90.01540728831725,Food
211326,24252,187074,11.476108003747765,88.52389199625223,Entertainment
191403,63603,127800,33.22988667889218,66.77011332110781,Entertainment
17120,8980,8140,52.453271028037385,47.546728971962615,Housing
20208,7097,13111,35.11975455265242,64.88024544734759,Housing
100766,12736,88030,12.639183851696009,87.36081614830398,Transportation
160551,32381,128170,20.168669145629735,79.83133085437026,Healthcare
234310,54104,180206,23.09077717553668,76.90922282446331,Entertainment
57794,30345,27449,52.505450392774335,47.494549607225665,Food
53537,11747,41790,21.94183461904851,78.0581653809515,Food
47252,16582,30670,35.09269448912215,64.90730551087785,Food
236313,15130,221183,6.402525464109042,93.59747453589095,Entertainment
209185,25308,183877,12.098381815139708,87.90161818486028,Entertainment
31565,14689,16876,46.535719942974815,53.464280057025185,Food
22568,8327,14241,36.89737681673165,63.10262318326835,Housing
45456,16284,29172,35.82365364308342,64.17634635691658,Food
199673,64424,135249,32.264752870943994,67.735247129056,Entertainment
22697,12718,9979,56.03383707097854,43.96616292902146,Housing
224724,44606,180118,19.84923728662715,80.15076271337284,Entertainment
17483,7836,9647,44.8206829491506,55.1793170508494,Housing
15201,8432,6769,55.47003486612723,44.52996513387277,Housing
62526,4647,57879,7.432108242970924,92.56789175702907,Transportation
102212,2114,100098,2.0682503032911987,97.9317496967088,Transportation
195835,55163,140672,28.168100697015348,71.83189930298465,Entertainment
247773,7710,240063,3.1117191945853664,96.88828080541462,Entertainment
11930,6233,5697,52.24643755238893,47.75356244761107,Housing
162492,68692,93800,42.27408118553529,57.72591881446472,Healthcare
31384,2420,28964,7.710935508539383,92.28906449146062,Food
195709,35267,160442,18.020121711316293,81.97987828868371,Entertainment
53647,16903,36744,31.50781963576714,68.49218036423285,Food
193880,43214,150666,22.2890447699608,77.7109552300392,Entertainment
57912,9934,47978,17.153612377400194,82.8463876225998,Food
29642,9800,19842,33.061196950273256,66.93880304972673,Housing
14015,1497,12518,10.681412772029967,89.31858722797004,Housing
13693,2842,10851,20.755130358577375,79.24486964142262,Housing
211624,50902,160722,24.05303746266964,75.94696253733036,Entertainment
123336,8464,114872,6.862554323149769,93.13744567685023,Healthcare
42059,12660,29399,30.100573004588792,69.8994269954112,Food
104202,61789,42413,59.297326346903134,40.70267365309687,Transportation
14488,7940,6548,54.803975704030925,45.19602429596908,Housing
68479,38441,30038,56.135457585537175,43.864542414462825,Transportation
31548,18605,12943,58.97362748827184,41.02637251172816,Food
21565,3505,18060,16.253188036169718,83.74681196383028,Housing
61635,13254,48381,21.504015575565834,78.49598442443417,Transportation
60059,35108,24951,58.45585174578331,41.54414825421669,Transportation
66622,39069,27553,58.642790669748734,41.35720933025127,Transportation
29228,14791,14437,50.6055836868756,49.3944163131244,Housing
37995,6754,31241,17.776023160942227,82.22397683905777,Food
123677,47480,76197,38.390323180542865,61.609676819457135,Healthcare
125812,24712,101100,19.642005532063713,80.3579944679363,Healthcare
36383,15543,20840,42.720501333040154,57.27949866695985,Food
140510,17887,122623,12.73005480037008,87.26994519962992,Healthcare
97500,4510,92990,4.625641025641026,95.37435897435897,Transportation
12293,1784,10509,14.512324086878712,85.48767591312128,Housing
195523,53496,142027,27.36046398633409,72.6395360136659,Entertainment
15109,2994,12115,19.81600370640016,80.18399629359985,Housing
144515,45566,98949,31.53029097325537,68.46970902674462,Healthcare
165584,20547,145037,12.408807614262248,87.59119238573774,Healthcare
95731,18299,77432,19.115020212888197,80.8849797871118,Transportation
245539,22177,223362,9.031966408594968,90.96803359140503,Entertainment
75289,6830,68459,9.071710342812363,90.92828965718763,Transportation
184818,168,184650,0.09090023698990357,99.9090997630101,Entertainment
131172,58653,72519,44.714573232092214,55.285426767907786,Healthcare
108490,64829,43661,59.75573785602359,40.24426214397641,Transportation
25129,8880,16249,35.33765768633849,64.6623423136615,Housing
18473,687,17786,3.718941157364802,96.28105884263519,Housing
113260,30153,83107,26.62281476249338,73.37718523750662,Transportation
81014,9625,71389,11.880662601525662,88.11933739847434,Transportation
11524,93,11431,0.8070114543561263,99.19298854564389,Housing
170647,33053,137594,19.36922418794353,80.63077581205647,Healthcare
174045,22648,151397,13.012726593697032,86.98727340630296,Healthcare
40739,5549,35190,13.620854709246668,86.37914529075333,Food
21862,3853,18009,17.624188088921418,82.37581191107859,Housing
110354,1630,108724,1.4770647189952335,98.52293528100476,Transportation
188419,9388,179031,4.9825123793248025,95.0174876206752,Entertainment
161339,61940,99399,38.39121353175612,61.60878646824388,Healthcare
122070,18058,104012,14.793151470467764,85.20684852953224,Healthcare
12278,6188,6090,50.39908779931584,49.60091220068415,Housing
39990,12110,27880,30.282570642660666,69.71742935733933,Food
14216,6355,7861,44.703151378728194,55.29684862127181,Housing
186514,51089,135425,27.391509484542713,72.60849051545728,Entertainment
29545,17410,12135,58.92706041631409,41.0729395836859,Housing
26994,12979,14015,48.08105504927021,51.918944950729795,Housing
199553,4444,195109,2.2269772942526544,97.77302270574735,Entertainment
19199,7239,11960,37.70508880670868,62.29491119329131,Housing
139675,40777,98898,29.194200823339894,70.8057991766601,Healthcare
28456,15323,13133,53.84804610626933,46.15195389373067,Housing
68201,2546,65655,3.7330830926232754,96.26691690737673,Transportation
229484,39916,189568,17.39380523260881,82.6061947673912,Entertainment
58885,1398,57487,2.3741190455973507,97.62588095440265,Food
132220,20958,111262,15.850854636212372,84.14914536378762,Healthcare
189607,41046,148561,21.647934939110897,78.3520650608891,Entertainment
132654,62628,70026,47.21154281062011,52.78845718937989,Healthcare
222860,26143,196717,11.730682939962309,88.2693170600377,Entertainment
59495,16312,43183,27.417430036137493,72.58256996386251,Food
88807,23324,65483,26.263695429414348,73.73630457058566,Transportation
140349,30320,110029,21.603288943989625,78.39671105601037,Healthcare
202378,30958,171420,15.297117275593198,84.7028827244068,Entertainment
128107,24584,103523,19.19020818534506,80.80979181465494,Healthcare
192179,61461,130718,31.981121766686265,68.01887823331373,Entertainment
37519,9996,27523,26.6425011327594,73.3574988672406,Food
133365,55276,78089,41.447156300378666,58.552843699621334,Healthcare
191799,65092,126707,33.93761177065574,66.06238822934426,Entertainment
30895,108,30787,0.3495711280142418,99.65042887198577,Food
34625,14830,19795,42.83032490974729,57.1696750902527,Food
17543,4992,12551,28.455794333922363,71.54420566607764,Housing
75977,5362,70615,7.057398949682141,92.94260105031786,Transportation
40972,4908,36064,11.978912427999608,88.02108757200038,Food
116715,69130,47585,59.22974767596282,40.77025232403719,Transportation
20202,11847,8355,58.64270864270864,41.35729135729136,Housing
204893,31993,172900,15.614491466277519,84.38550853372247,Entertainment
135612,69524,66088,51.26684954133852,48.73315045866147,Healthcare
48829,28084,20745,57.515001331176144,42.484998668823856,Food
36145,3840,32305,10.62387605477936,89.37612394522064,Food
53020,24717,28303,46.61825726141079,53.38174273858921,Food
127416,33572,93844,26.348339298047343,73.65166070195266,Healthcare
78108,32852,45256,42.05971219337328,57.94028780662672,Transportation
222978,9549,213429,4.2824852676048755,95.71751473239513,Entertainment
213176,45015,168161,21.116354561489096,78.8836454385109,Entertainment
161067,47623,113444,29.567198743380086,70.43280125661991,Healthcare
138471,675,137796,0.4874666897761986,99.5125333102238,Healthcare
136378,29647,106731,21.738843508483775,78.26115649151623,Healthcare
204481,60165,144316,29.423271599806338,70.57672840019366,Entertainment
221796,18085,203711,8.153889159407743,91.84611084059226,Entertainment
78574,33235,45339,42.2977066205106,57.7022933794894,Transportation
113968,38954,75014,34.17976975993261,65.82023024006739,Transportation
53459,1685,51774,3.151948222001908,96.8480517779981,Food
161955,30969,130986,19.121978327313144,80.87802167268686,Healthcare
57042,15413,41629,27.02044107850356,72.97955892149645,Food
61823,21601,40222,34.94007084741925,65.05992915258075,Transportation
195232,47157,148075,24.15433945254876,75.84566054745123,Entertainment
30587,6962,23625,22.761303821885114,77.23869617811488,Food
142370,43542,98828,30.583690384210154,69.41630961578984,Healthcare
73730,22719,51011,30.813780008137797,69.1862199918622,Transportation
136075,36969,99106,27.16810582399412,72.83189417600587,Healthcare
75566,37279,38287,49.33303337479819,50.666966625201816,Transportation
95327,14653,80674,15.371300890618608,84.62869910938139,Transportation
97395,40914,56481,42.008316648698596,57.991683351301404,Transportation
41779,24749,17030,59.237894636061185,40.76210536393882,Food
112556,41559,70997,36.922953907388326,63.077046092611674,Transportation
17947,7322,10625,40.79790494233019,59.2020950576698,Housing
45095,3054,42041,6.772369442288502,93.22763055771149,Food
19789,3109,16680,15.7107483955733,84.28925160442671,Housing
95126,28357,66769,29.80993629501924,70.19006370498076,Transportation
236367,728,235639,0.3079956169854506,99.69200438301455,Entertainment
191810,60269,131541,31.421198060580785,68.57880193941922,Entertainment
241230,60757,180473,25.186336691124655,74.81366330887535,Entertainment
104587,34534,70053,33.019400116649294,66.9805998833507,Transportation
62849,20858,41991,33.18748110550685,66.81251889449314,Transportation
200232,15638,184594,7.809940469055896,92.1900595309441,Entertainment
23465,9512,13953,40.5369699552525,59.4630300447475,Housing
116811,48446,68365,41.47383379989898,58.52616620010102,Transportation
44644,16335,28309,36.58946330973927,63.410536690260734,Food
115389,65428,49961,56.70211198641118,43.29788801358882,Transportation
200688,44550,156138,22.198636689787133,77.80136331021286,Entertainment
31953,13976,17977,43.73924201170469,56.26075798829531,Food
157097,20080,137017,12.781911812447087,87.21808818755291,Healthcare
96053,12236,83817,12.738800453916067,87.26119954608393,Transportation
50829,30457,20372,59.92051781463338,40.07948218536662,Food
138102,44249,93853,32.04081041549,67.95918958451,Healthcare
147595,8206,139389,5.559808936617094,94.44019106338291,Healthcare
30833,1085,29748,3.518956961696883,96.48104303830311,Food
229704,35444,194260,15.430292898687007,84.569707101313,Entertainment
57551,30343,27208,52.7236711786068,47.2763288213932,Food
10526,5011,5515,47.605928177845335,52.394071822154665,Housing
98380,50830,47550,51.667005488920516,48.332994511079484,Transportation
39743,5341,34402,13.438844576403392,86.5611554235966,Food
218320,14600,203720,6.687431293514108,93.31256870648589,Entertainment
216649,5144,211505,2.3743474467918153,97.62565255320818,Entertainment
59323,17178,42145,28.95672841899432,71.04327158100568,Food
172742,29055,143687,16.819881673246808,83.18011832675319,Healthcare
50805,26300,24505,51.76655840960536,48.23344159039465,Food
125337,58817,66520,46.927084579972394,53.07291542002761,Healthcare
110112,26124,83988,23.724934612031387,76.27506538796861,Transportation
249305,59228,190077,23.757245141493353,76.24275485850664,Entertainment
14630,5514,9116,37.68967874231032,62.31032125768968,Housing
210884,59266,151618,28.10360198023558,71.89639801976442,Entertainment
33060,15168,17892,45.88021778584392,54.119782214156075,Food
153536,51140,102396,33.30814922884535,66.69185077115465,Healthcare
13337,3743,9594,28.06478218489915,71.93521781510086,Housing
117517,39919,77598,33.96870240050376,66.03129759949624,Transportation
29958,15890,14068,53.04092396021096,46.95907603978904,Housing
40302,13767,26535,34.159595057317254,65.84040494268274,Food
45193,26035,19158,57.60847918925497,42.39152081074503,Food
181982,18548,163434,10.192216812651802,89.8077831873482,Entertainment
12951,161,12790,1.2431472473168095,98.75685275268319,Housing
140010,47683,92327,34.056853081922725,65.94314691807728,Healthcare
29849,11909,17940,39.89748400281417,60.10251599718583,Housing
20486,4956,15530,24.192131211559115,75.80786878844089,Housing
118049,7574,110475,6.41597980499623,93.58402019500377,Transportation
225310,17801,207509,7.9006701877413335,92.09932981225867,Entertainment
33646,2276,31370,6.7645485347441,93.2354514652559,Food
66802,11800,55002,17.66414179216191,82.33585820783809,Transportation
18450,8335,10115,45.176151761517616,54.823848238482384,Housing
45770,8815,36955,19.259340179156652,80.74065982084335,Food
96998,29287,67711,30.193406049609273,69.80659395039072,Transportation
126990,60371,66619,47.53996377667533,52.46003622332467,Healthcare
26202,8274,17928,31.577742157087247,68.42225784291276,Housing
46975,14912,32063,31.74454497072911,68.25545502927088,Food
40731,12080,28651,29.65800004910265,70.34199995089735,Food
110345,12938,97407,11.72504417961847,88.27495582038154,Transportation
55174,5700,49474,10.330952985101678,89.66904701489831,Food
114106,16981,97125,14.881776593693582,85.11822340630641,Transportation
116372,29546,86826,25.389268896298077,74.61073110370192,Transportation
90908,37919,52989,41.711400536806444,58.288599463193556,Transportation
97953,56685,41268,57.86959051790145,42.13040948209856,Transportation
48905,9860,39045,20.161537675084347,79.83846232491565,Food
142164,20662,121502,14.533918572915788,85.46608142708422,Healthcare
135010,3568,131442,2.6427672024294497,97.35723279757055,Healthcare
17638,1136,16502,6.4406395282911895,93.55936047170881,Housing
52039,7593,44446,14.590979842041547,85.40902015795847,Food
19821,9658,10163,48.726098582311685,51.27390141768831,Housing
40946,20132,20814,49.16719581888341,50.8328041811166,Food
15403,8897,6506,57.76147503733039,42.23852496266961,Housing
26680,6638,20042,24.880059970014994,75.11994002998502,Housing
238152,4096,234056,1.7199099734623267,98.28009002653766,Entertainment
161097,21266,139831,13.200742409852447,86.79925759014755,Healthcare
117356,24863,92493,21.185964075121852,78.81403592487814,Transportation
69477,29356,40121,42.25283187241821,57.747168127581794,Transportation
113202,34659,78543,30.616950230561297,69.3830497694387,Transportation
176432,42572,133860,24.129409630905958,75.87059036909403,Healthcare
21911,7007,14904,31.9793710921455,68.0206289078545,Housing
19351,8486,10865,43.85303085111881,56.1469691488812,Housing
141960,52128,89832,36.72020287404903,63.27979712595098,Healthcare
239472,13999,225473,5.845777376895837,94.15422262310416,Entertainment
32240,17806,14434,55.229528535980144,44.77047146401985,Food
15736,8913,6823,56.640823589222165,43.359176410777835,Housing
29283,13793,15490,47.10241437011235,52.897585629887644,Housing
107783,41846,65937,38.824304389374944,61.17569561062505,Transportation
173024,5313,167711,3.07067227667838,96.92932772332162,Healthcare
140257,21852,118405,15.579971053138166,84.42002894686183,Healthcare
20536,2404,18132,11.706271912738606,88.29372808726139,Housing
47955,75,47880,0.15639662183296843,99.84360337816703,Food
59625,29292,30333,49.12704402515723,50.87295597484277,Food
12391,5726,6665,46.21095956742797,53.78904043257203,Housing
47132,22877,24255,48.53814817958075,51.46185182041925,Food
91958,45909,46049,49.92387829226386,50.07612170773614,Transportation
241766,18288,223478,7.564339071664336,92.43566092833566,Entertainment
12709,348,12361,2.7382170115666065,97.2617829884334,Housing
11005,1485,9520,13.493866424352566,86.50613357564744,Housing
27771,6942,20829,24.997299341039213,75.00270065896079,Housing
40619,11215,29404,27.61023166498437,72.38976833501563,Food
112511,25665,86846,22.811102914381706,77.1888970856183,Transportation
246781,55636,191145,22.544685368808782,77.45531463119121,Entertainment
217226,17749,199477,8.170753040612082,91.82924695938792,Entertainment
73792,42903,30889,58.14044882914137,41.85955117085863,Transportation
23608,6443,17165,27.29159606912911,72.70840393087089,Housing
28378,5118,23260,18.035097610825286,81.96490238917471,Housing
32323,8632,23691,26.705441945363983,73.29455805463601,Food
147724,20520,127204,13.890769272426958,86.10923072757303,Healthcare
240937,18206,222731,7.5563321532184755,92.44366784678152,Entertainment
86694,49759,36935,57.39612891318892,42.60387108681108,Transportation
96901,37607,59294,38.80971300605773,61.190286993942266,Transportation
231218,11531,219687,4.987068480827618,95.01293151917238,Entertainment
15106,1487,13619,9.84377068714418,90.15622931285581,Housing
30681,14333,16348,46.716208728529054,53.283791271470946,Food
202639,10800,191839,5.3296749391775515,94.67032506082245,Entertainment
16944,5705,11239,33.669735599622285,66.33026440037771,Housing
14128,6733,7395,47.657134767836915,52.342865232163085,Housing
58500,30462,28038,52.07179487179487,47.92820512820513,Food
50913,18049,32864,35.45067075206725,64.54932924793275,Food
120959,30526,90433,25.236650435271457,74.76334956472854,Healthcare
57057,2582,54475,4.525299262141368,95.47470073785863,Food
23984,8252,15732,34.40627084723149,65.5937291527685,Housing
15073,2080,12993,13.799509055927818,86.20049094407219,Housing
155890,17335,138555,11.120020527294887,88.87997947270512,Healthcare
13217,342,12875,2.5875766058863587,97.41242339411365,Housing
109565,60658,48907,55.362570163829695,44.63742983617031,Transportation
19937,6472,13465,32.46225610673622,67.53774389326378,Housing
157938,30074,127864,19.04164925477086,80.95835074522914,Healthcare
202599,62338,140261,30.769154832945866,69.23084516705413,Entertainment
24034,7913,16121,32.92419072979945,67.07580927020055,Housing
132981,62908,70073,47.3060061211752,52.6939938788248,Healthcare
10078,223,9855,2.2127406231395117,97.78725937686049,Housing
30503,4736,25767,15.52634167131102,84.47365832868898,Food
129032,29051,99981,22.514570029140057,77.48542997085994,Healthcare
34682,18498,16184,53.33602445072372,46.66397554927628,Food
84478,21707,62771,25.695447335400935,74.30455266459907,Transportation
157325,42413,114912,26.958843159065626,73.04115684093438,Healthcare
16260,6560,9700,40.34440344403444,59.65559655596556,Housing
22287,6970,15317,31.27383676582761,68.72616323417239,Housing
48963,28812,20151,58.84443355186569,41.15556644813431,Food
17409,7315,10094,42.01849618013671,57.98150381986329,Housing
89105,3825,85280,4.2926884013242805,95.70731159867572,Transportation
201613,9708,191905,4.8151656887204695,95.18483431127953,Entertainment
81669,36229,45440,44.36077336565894,55.63922663434106,Transportation
235729,7291,228438,3.0929584395640757,96.90704156043593,Entertainment
44206,25359,18847,57.36551599330407,42.63448400669592,Food
56015,15297,40718,27.30875658305811,72.69124341694189,Food
244618,4198,240420,1.7161451732906001,98.2838548267094,Entertainment
206517,56623,149894,27.41808180440351,72.58191819559649,Entertainment
204941,64479,140462,31.462225713742004,68.53777428625799,Entertainment
176202,11097,165105,6.297885381550721,93.70211461844929,Healthcare
59609,22081,37528,37.04306396685064,62.95693603314936,Food
102219,38708,63511,37.86771539537659,62.13228460462341,Transportation
46981,19041,27940,40.529150081948025,59.47084991805198,Food
38625,531,38094,1.374757281553398,98.6252427184466,Food
143363,18045,125318,12.58692968199605,87.41307031800395,Healthcare
32686,13672,19014,41.828305696628526,58.17169430337148,Food
212175,36460,175715,17.18392836102274,82.81607163897726,Entertainment
119920,2772,117148,2.3115410273515677,97.68845897264843,Transportation
36821,15131,21690,41.093397789305016,58.90660221069498,Food
162940,16912,146028,10.37928071682828,89.62071928317172,Healthcare
46791,4044,42747,8.642687696351862,91.35731230364814,Food
95801,36612,59189,38.21672007599086,61.78327992400915,Transportation
14269,7960,6309,55.78526876445441,44.21473123554559,Housing
122770,46238,76532,37.662295349026635,62.33770465097337,Healthcare
127582,11077,116505,8.682259252872662,91.31774074712735,Healthcare
246896,9804,237092,3.970902728274253,96.02909727172575,Entertainment
238837,57562,181275,24.100955882045078,75.89904411795493,Entertainment
80296,46431,33865,57.824798246487994,42.175201753512006,Transportation
74492,39401,35091,52.89292809966171,47.10707190033829,Transportation
133906,9947,123959,7.428345257120666,92.57165474287933,Healthcare
29071,17326,11745,59.59891300608854,40.401086993911456,Housing
173153,57384,115769,33.14063285071584,66.85936714928415,Healthcare
117132,1840,115292,1.570877300823003,98.429122699177,Transportation
19743,6262,13481,31.717570784581877,68.28242921541813,Housing
202512,64462,138050,31.831200126412263,68.16879987358774,Entertainment
26838,1891,24947,7.045979581190849,92.95402041880915,Housing
66591,2180,64411,3.2737156672823655,96.72628433271764,Transportation
158563,28711,129852,18.106998480099392,81.89300151990061,Healthcare
31159,4462,26697,14.32010013158317,85.67989986841683,Food
112045,12112,99933,10.809942433843545,89.19005756615645,Transportation
77754,16086,61668,20.6883247164133,79.3116752835867,Transportation
79487,45657,33830,57.43958131518362,42.56041868481638,Transportation
53525,16456,37069,30.74451191032228,69.25548808967773,Food
233455,41293,192162,17.687777087661434,82.31222291233856,Entertainment
51095,6823,44272,13.353557099520502,86.6464429004795,Food
37135,3865,33270,10.407970916924734,89.59202908307526,Food
89174,21522,67652,24.13483750869087,75.86516249130912,Transportation
110914,29231,81683,26.354653154696432,73.64534684530358,Transportation
121236,64036,57200,52.81929459896401,47.18070540103599,Healthcare
14389,6001,8388,41.70546945583432,58.29453054416568,Housing
18626,9839,8787,52.824009449157096,47.175990550842904,Housing
216091,12552,203539,5.808663942505703,94.1913360574943,Entertainment
228970,52028,176942,22.7226274184391,77.2773725815609,Entertainment
238149,7082,231067,2.9737685230674913,97.02623147693251,Entertainment
39588,18575,21013,46.92078407598262,53.079215924017376,Food
113387,45531,67856,40.155397003183786,59.84460299681621,Transportation
123751,5280,118471,4.266632188830798,95.7333678111692,Healthcare
221753,45242,176511,20.40197877819015,79.59802122180986,Entertainment
169487,34465,135022,20.33489294164154,79.66510705835846,Healthcare
25898,7838,18060,30.264885319329675,69.73511468067032,Housing
13572,5137,8435,37.84998526377837,62.150014736221635,Housing
55834,26653,29181,47.73614643407243,52.263853565927576,Food
19648,9447,10201,48.08122964169381,51.91877035830619,Housing
116881,36605,80276,31.318178318118427,68.68182168188157,Transportation
156453,43075,113378,27.532230126619496,72.4677698733805,Healthcare
20791,2623,18168,12.61603578471454,87.38396421528546,Housing
29623,9564,20059,32.285723930729496,67.7142760692705,Housing
44157,5193,38964,11.760309803655138,88.23969019634485,Food
30400,5853,24547,19.25328947368421,80.7467105263158,Food
35211,18370,16841,52.171196501093405,47.828803498906595,Food
197114,8846,188268,4.487758353034285,95.5122416469657,Entertainment
169775,43312,126463,25.51141216315712,74.48858783684288,Healthcare
163874,54849,109025,33.47022712571854,66.52977287428146,Healthcare
226551,37520,189031,16.5613923575707,83.4386076424293,Entertainment
155133,19803,135330,12.765175687958074,87.23482431204192,Healthcare
191832,2179,189653,1.1358897368530798,98.86411026314693,Entertainment
13342,259,13083,1.9412381951731374,98.05876180482687,Housing
223584,37374,186210,16.715865178188064,83.28413482181193,Entertainment
50016,8240,41776,16.474728087012156,83.52527191298785,Food
52814,24009,28805,45.4595372439126,54.54046275608741,Food
127819,42699,85120,33.405831683865465,66.59416831613454,Healthcare
231537,7182,224355,3.1018800450899855,96.89811995491002,Entertainment
36758,21534,15224,58.58316556939985,41.41683443060014,Food
75593,30283,45310,40.060587620546876,59.93941237945313,Transportation
11282,2871,8411,25.447615670980323,74.55238432901967,Housing
40941,16287,24654,39.781636989814615,60.21836301018539,Food
37623,19466,18157,51.73962735560694,48.26037264439306,Food
76092,23111,52981,30.372443883719708,69.62755611628029,Transportation
199614,67661,131953,33.895919123909145,66.10408087609085,Entertainment
15477,7819,7658,50.52012663952963,49.47987336047038,Housing
244952,21911,223041,8.945017799405598,91.05498220059441,Entertainment
19473,4983,14490,25.589277461099986,74.41072253890002,Housing
36021,9201,26820,25.543432997418176,74.45656700258183,Food
17908,7454,10454,41.623855260218896,58.3761447397811,Housing
103938,26197,77741,25.204448806018974,74.79555119398103,Transportation
146267,44474,101793,30.406038272474312,69.5939617275257,Healthcare
13823,1666,12157,12.05237647399262,87.94762352600738,Housing
135450,4406,131044,3.2528608342561833,96.74713916574382,Healthcare
65290,26408,38882,40.44723541124215,59.552764588757846,Transportation
28046,6888,21158,24.559652000285244,75.44034799971475,Housing
144999,8070,136929,5.565555624521548,94.43444437547845,Healthcare
230397,60202,170195,26.129680507992724,73.87031949200727,Entertainment
120899,28640,92259,23.68919511327637,76.31080488672363,Healthcare
192592,68957,123635,35.804706322173296,64.1952936778267,Entertainment
216694,7629,209065,3.520632781710615,96.47936721828938,Entertainment
12557,5616,6941,44.72405829417855,55.27594170582145,Housing
159626,22786,136840,14.27461691704359,85.72538308295641,Healthcare
178890,10230,168660,5.718598021130304,94.2814019788697,Healthcare
219932,53125,166807,24.155193423421785,75.84480657657822,Entertainment
17595,6957,10638,39.53964194373402,60.46035805626598,Housing
13199,3052,10147,23.12296386089855,76.87703613910145,Housing
120527,66982,53545,55.574269665718056,44.425730334281944,Healthcare
188727,53970,134757,28.596862134193834,71.40313786580617,Entertainment
85142,5813,79329,6.827417725681801,93.17258227431819,Transportation
157388,69123,88265,43.91885023000483,56.08114976999518,Healthcare
43039,17770,25269,41.288134017983694,58.711865982016306,Food
152996,27203,125793,17.78020340401056,82.21979659598944,Healthcare
53059,14085,38974,26.545920578978116,73.45407942102187,Food
72314,41384,30930,57.22819924219377,42.77180075780623,Transportation
55594,33043,22551,59.43627010109005,40.563729898909955,Food
179440,6363,173077,3.5460320998662502,96.45396790013375,Healthcare
146577,27257,119320,18.595686908587293,81.4043130914127,Healthcare
61298,13295,48003,21.689125256941498,78.3108747430585,Transportation
41672,24842,16830,59.613169514302164,40.386830485697836,Food
36708,14815,21893,40.35904979840906,59.64095020159094,Food
33575,8875,24700,26.433358153387935,73.56664184661206,Food
72141,27856,44285,38.613271232724806,61.3867287672752,Transportation
22151,1994,20157,9.001850932237822,90.99814906776218,Housing
153691,13341,140350,8.680404187623218,91.31959581237679,Healthcare
17969,10361,7608,57.66041515944126,42.33958484055874,Housing
28073,8871,19202,31.599757774373955,68.40024222562604,Housing
58271,32839,25432,56.35564860736901,43.64435139263098,Food
31857,2674,29183,8.39375961327181,91.60624038672819,Food
36664,21005,15659,57.290530220379665,42.709469779620335,Food
16296,2345,13951,14.390034364261167,85.60996563573883,Housing
168801,1700,167101,1.0071030384891084,98.9928969615109,Healthcare
34559,12861,21698,37.21461847854394,62.78538152145606,Food
156880,29254,127626,18.647373788883222,81.35262621111677,Healthcare
162204,61146,101058,37.69697418066139,62.30302581933861,Healthcare
29540,3375,26165,11.425186188219364,88.57481381178064,Housing
23333,874,22459,3.74576779668281,96.25423220331719,Housing
59362,20453,38909,34.454701660995255,65.54529833900476,Food
11942,1645,10297,13.774912075029308,86.2250879249707,Housing
38994,4592,34402,11.776170692927117,88.22382930707289,Food
175128,7829,167299,4.47044447489836,95.52955552510164,Healthcare
19174,10186,8988,53.1240221132784,46.87597788672161,Housing
181183,22007,159176,12.14628303979954,87.85371696020046,Entertainment
74300,30506,43794,41.0578734858681,58.9421265141319,Transportation
238169,59242,178927,24.87393405522969,75.12606594477032,Entertainment
86723,44051,42672,50.795060133989836,49.20493986601017,Transportation
52738,24515,28223,46.48450832416853,53.51549167583147,Food
228326,25073,203253,10.981228594203026,89.01877140579697,Entertainment
53435,2016,51419,3.7728080845887524,96.22719191541125,Food
18435,6936,11499,37.62408462164361,62.37591537835638,Housing
87565,21972,65593,25.092217210072516,74.90778278992748,Transportation
58004,33390,24614,57.56499551755051,42.435004482449486,Food
51098,6876,44222,13.456495361853694,86.5435046381463,Food
224444,65948,158496,29.382830461050418,70.61716953894958,Entertainment
168149,10823,157326,6.436553294994321,93.56344670500569,Healthcare
100921,60473,40448,59.921126425620045,40.078873574379955,Transportation
11444,4092,7352,35.75672841663754,64.24327158336246,Housing
29885,17340,12545,58.022419273883216,41.977580726116784,Housing
89746,34352,55394,38.27691484857264,61.72308515142736,Transportation
114387,24314,90073,21.25591194803605,78.74408805196394,Transportation
32228,7473,24755,23.18791113317612,76.81208886682388,Food
215034,64379,150655,29.938986392849504,70.0610136071505,Entertainment
227428,66527,160901,29.251895105264087,70.74810489473592,Entertainment
158632,11951,146681,7.533788895052701,92.4662111049473,Healthcare
197024,5707,191317,2.8966014292675,97.10339857073251,Entertainment
33171,9790,23381,29.51373187422749,70.48626812577251,Food
15370,9221,6149,59.993493819128176,40.006506180871824,Housing
94408,12945,81463,13.711761715108889,86.28823828489111,Transportation
77302,17318,59984,22.40304261209283,77.59695738790717,Transportation
54994,5622,49372,10.222933410917555,89.77706658908244,Food
63202,33284,29918,52.662890414860286,47.33710958513971,Transportation
115025,2182,112843,1.896978917626603,98.1030210823734,Transportation
248576,9418,239158,3.788780895983522,96.21121910401648,Entertainment
229729,35350,194379,15.387695937387095,84.6123040626129,Entertainment
156781,33831,122950,21.57850759977293,78.42149240022707,Healthcare
64456,35726,28730,55.4269579247859,44.5730420752141,Transportation
112536,6611,105925,5.8745645837776355,94.12543541622237,Transportation
42374,16535,25839,39.02156983055647,60.978430169443534,Food
222616,45536,177080,20.454953821827722,79.54504617817227,Entertainment
40606,1201,39405,2.9576909816283306,97.04230901837167,Food
43801,22461,21340,51.279651149517136,48.720348850482864,Food
18144,8920,9224,49.16225749559083,50.837742504409164,Housing
236082,20559,215523,8.708414872798434,91.29158512720157,Entertainment
57919,30446,27473,52.56651530585819,47.43348469414182,Food
34317,19257,15060,56.115045021417956,43.884954978582044,Food
14868,3037,11831,20.426419155232715,79.57358084476729,Housing
117162,41752,75410,35.63612775473277,64.36387224526725,Transportation
14297,7872,6425,55.06050220325942,44.939497796740575,Housing
102462,48803,53659,47.63034100446995,52.36965899553005,Transportation
201493,15162,186331,7.524827165211695,92.47517283478831,Entertainment
49646,8986,40660,18.100149055311608,81.8998509446884,Food
173884,44703,129181,25.70851832255987,74.29148167744013,Healthcare
175953,27255,148698,15.489931970469387,84.51006802953061,Healthcare
17333,9213,8120,53.15294524894709,46.8470547510529,Housing
90951,10543,80408,11.591956108234104,88.4080438917659,Transportation
26722,12813,13909,47.94925529526233,52.050744704737674,Housing
97951,31042,66909,31.69135588202264,68.30864411797735,Transportation
72025,42722,29303,59.31551544602569,40.684484553974315,Transportation
21264,4321,16943,20.32072987208427,79.67927012791573,Housing
194722,51161,143561,26.273867359620382,73.72613264037962,Entertainment
12110,3943,8167,32.55986787778695,67.44013212221304,Housing
15996,4203,11793,26.275318829707427,73.72468117029257,Housing
249850,37801,212049,15.129477686611967,84.87052231338804,Entertainment
240782,43213,197569,17.94693955528237,82.05306044471763,Entertainment
80191,41088,39103,51.237670062725236,48.76232993727476,Transportation
239240,27002,212238,11.286574151479686,88.71342584852032,Entertainment
246415,67815,178600,27.520646064565874,72.47935393543412,Entertainment
235434,64276,171158,27.301069514173825,72.69893048582617,Entertainment
152813,39940,112873,26.136519798708225,73.86348020129178,Healthcare
214967,33264,181703,15.474002986504907,84.52599701349509,Entertainment
70532,23042,47490,32.66885952475472,67.33114047524528,Transportation
155596,42035,113561,27.01547597624618,72.98452402375382,Healthcare
128319,66917,61402,52.14894131032817,47.85105868967183,Healthcare
49189,5041,44148,10.248226229441542,89.75177377055846,Food
179235,39061,140174,21.79317655591821,78.20682344408179,Healthcare
101294,13038,88256,12.871443520840325,87.12855647915967,Transportation
143629,56902,86727,39.617347471610884,60.382652528389116,Healthcare
17000,399,16601,2.347058823529412,97.65294117647059,Housing
184732,33270,151462,18.009873763072992,81.99012623692701,Entertainment
24789,1082,23707,4.364839243212716,95.63516075678729,Housing
83800,46852,36948,55.90930787589499,44.09069212410501,Transportation
216850,9279,207571,4.27899469679502,95.72100530320498,Entertainment
220592,23400,197192,10.607818959889752,89.39218104011026,Entertainment
156082,4481,151601,2.8709268205174205,97.12907317948259,Healthcare
124799,61333,63466,49.14542584475837,50.85457415524163,Healthcare
73868,13442,60426,18.19732495803325,81.80267504196675,Transportation
37764,14167,23597,37.514564135155176,62.48543586484483,Food
12620,2379,10241,18.851030110935024,81.14896988906499,Housing
95732,1035,94697,1.081143191409351,98.91885680859065,Transportation
17585,6333,11252,36.01364799545067,63.98635200454933,Housing
10181,1070,9111,10.50977310676751,89.49022689323249,Housing
124798,34274,90524,27.46358114713377,72.53641885286623,Healthcare
48635,14910,33725,30.656934306569344,69.34306569343066,Food
46033,18873,27160,40.99884865205396,59.001151347946035,Food
162733,30819,131914,18.938383732863034,81.06161626713697,Healthcare
60171,4730,55441,7.86092968373469,92.13907031626532,Transportation
28864,4851,24013,16.80640243902439,83.1935975609756,Housing
183960,40497,143463,22.014024787997393,77.98597521200261,Entertainment
21911,9190,12721,41.942403359043404,58.057596640956596,Housing
164843,29653,135190,17.98863160704428,82.01136839295572,Healthcare
116898,55229,61669,47.24546185563483,52.75453814436517,Transportation
42643,2317,40326,5.433482634899046,94.56651736510095,Food
13316,4455,8861,33.45599279062782,66.54400720937218,Housing
81971,33385,48586,40.727818374791084,59.27218162520892,Transportation
209499,51961,157538,24.80250502389033,75.19749497610967,Entertainment
39399,4587,34812,11.642427472778497,88.3575725272215,Food
210667,60203,150464,28.577328200430063,71.42267179956994,Entertainment
95131,56601,38530,59.49795545090454,40.50204454909546,Transportation
102282,7079,95203,6.92106137932383,93.07893862067617,Transportation
158126,1428,156698,0.9030772927918241,99.09692270720818,Healthcare
57693,33632,24061,58.294767129461114,41.705232870538886,Food
78774,8791,69983,11.159773529337091,88.84022647066291,Transportation
55365,16173,39192,29.21159577350312,70.78840422649688,Food
144156,13532,130624,9.38705291489775,90.61294708510225,Healthcare
20028,9878,10150,49.320950669063315,50.679049330936685,Housing
57956,32479,25477,56.0407895644972,43.9592104355028,Food
37186,20080,17106,53.99881675899532,46.001183241004675,Food
49386,11399,37987,23.081440084234398,76.9185599157656,Food
226511,24976,201535,11.026396069065077,88.97360393093491,Entertainment
61257,14940,46317,24.389049414760763,75.61095058523924,Transportation
129492,52560,76932,40.58938003892133,59.41061996107868,Healthcare
24748,13891,10857,56.12978826571844,43.870211734281554,Housing
18753,3595,15158,19.170266090758812,80.82973390924118,Housing
249739,20148,229591,8.067622597992303,91.93237740200769,Entertainment
132503,7226,125277,5.453461431061938,94.54653856893806,Healthcare
66686,23749,42937,35.61317218006778,64.38682781993222,Transportation
226146,63403,162743,28.036312824458538,71.96368717554147,Entertainment
71144,33198,37946,46.66310581356123,53.336894186438776,Transportation
82410,33543,48867,40.70258463778668,59.29741536221332,Transportation
19479,2117,17362,10.868114379588274,89.13188562041172,Housing
12212,1149,11063,9.408778250900754,90.59122174909925,Housing
194967,489,194478,0.2508116758220622,99.74918832417794,Entertainment
68585,38549,30036,56.206167529343155,43.79383247065685,Transportation
209148,45774,163374,21.885937231051695,78.1140627689483,Entertainment
46412,18312,28100,39.45531328104801,60.54468671895199,Food
28885,10858,18027,37.59044486757833,62.409555132421666,Housing
34752,16493,18259,47.45913904235727,52.54086095764272,Food
25010,10710,14300,42.82287085165933,57.17712914834067,Housing
23772,3755,20017,15.795894329463234,84.20410567053676,Housing
182119,55814,126305,30.64699454752113,69.35300545247888,Entertainment
60360,12829,47531,21.254141815772034,78.74585818422797,Transportation
240330,50244,190086,20.90625390088628,79.09374609911372,Entertainment
29569,15210,14359,51.43900706821333,48.560992931786664,Housing
43103,5468,37635,12.685891933276105,87.31410806672389,Food
55206,4026,51180,7.292685577654602,92.7073144223454,Food
88063,22300,65763,25.322780282297902,74.6772197177021,Transportation
52531,5254,47277,10.001713274066741,89.99828672593327,Food
168295,19414,148881,11.535696247660358,88.46430375233965,Healthcare
21044,10029,11015,47.65728948869036,52.34271051130964,Housing
15682,1645,14037,10.489733452365769,89.51026654763423,Housing
28612,11039,17573,38.58171396616804,61.41828603383196,Housing
234610,37267,197343,15.884659647926346,84.11534035207366,Entertainment
53155,1075,52080,2.0223873577274007,97.97761264227259,Food
159465,31995,127470,20.063963879221145,79.93603612077885,Healthcare
72310,23482,48828,32.474069976490114,67.52593002350989,Transportation
25295,6202,19093,24.518679580944852,75.48132041905515,Housing
11460,2522,8938,22.006980802792324,77.99301919720769,Housing
90625,9672,80953,10.67255172413793,89.32744827586207,Transportation
16880,4125,12755,24.437203791469194,75.5627962085308,Housing
58326,30051,28275,51.52247711140829,48.47752288859171,Food
60905,1872,59033,3.073639274279616,96.92636072572039,Transportation
222697,54888,167809,24.646941808825446,75.35305819117455,Entertainment
116981,55313,61668,47.28374693326266,52.71625306673733,Transportation
167083,39291,127792,23.515857388244164,76.48414261175583,Healthcare
171098,15454,155644,9.03225052309203,90.96774947690797,Healthcare
29331,6701,22630,22.846135488050187,77.1538645119498,Housing
191571,62382,129189,32.56338381070204,67.43661618929796,Entertainment
28822,17218,11604,59.739088196516555,40.26091180348345,Housing
33871,710,33161,2.0961884798204955,97.9038115201795,Food
48961,26161,22800,53.432323686199226,46.56767631380078,Food
66382,8839,57543,13.315356572564852,86.68464342743515,Transportation
17088,5260,11828,30.781835205992508,69.21816479400749,Housing
98774,48813,49961,49.41887541255796,50.58112458744204,Transportation
13093,4521,8572,34.529901474070115,65.47009852592988,Housing
83065,19354,63711,23.299825437910073,76.70017456208993,Transportation
106760,64017,42743,59.96346946421881,40.03653053578119,Transportation
50454,14043,36411,27.83327387323106,72.16672612676895,Food
33072,8408,24664,25.423318819545234,74.57668118045476,Food
231189,37982,193207,16.42898234777606,83.57101765222393,Entertainment
10308,4803,5505,46.59487776484284,53.40512223515715,Housing
141110,45258,95852,32.07285096733045,67.92714903266955,Healthcare
56962,2586,54376,4.539868684386082,95.46013131561392,Food
29697,15293,14404,51.49678418695491,48.50321581304509,Housing
50829,5051,45778,9.937240551653584,90.06275944834641,Food
204084,2977,201107,1.4587130789282845,98.54128692107172,Entertainment
23250,10356,12894,44.54193548387097,55.458064516129035,Housing
190647,33270,157377,17.451100725424475,82.54889927457553,Entertainment
121427,46861,74566,38.59191118943892,61.40808881056108,Healthcare
26254,1023,25231,3.896549097280414,96.10345090271959,Housing
36059,8999,27060,24.95632158407055,75.04367841592945,Food
225459,23227,202232,10.302094837642322,89.69790516235769,Entertainment
97295,57725,39570,59.329873066447405,40.670126933552595,Transportation
205331,57481,147850,27.99431162367105,72.00568837632895,Entertainment
55416,25590,29826,46.177999133824166,53.822000866175834,Food
112222,35174,77048,31.343230382634417,68.65676961736557,Transportation
48743,3181,45562,6.526065281168577,93.47393471883142,Food
21233,1156,20077,5.44435548438751,94.55564451561249,Housing
72489,15889,56600,21.91918773882934,78.08081226117066,Transportation
234934,27887,207047,11.870142252717784,88.12985774728222,Entertainment
121040,33220,87820,27.445472571050892,72.55452742894911,Healthcare
27305,3609,23696,13.21735945797473,86.78264054202526,Housing
28916,13771,15145,47.62415271821829,52.375847281781716,Housing
34519,4817,29702,13.954633680002319,86.04536631999768,Food
27651,1862,25789,6.733933673284873,93.26606632671512,Housing
66516,16051,50465,24.131036141680198,75.8689638583198,Transportation
118357,59157,59200,49.98183461899169,50.01816538100831,Transportation
79825,28875,50950,36.17287817099906,63.827121829000944,Transportation
58471,32029,26442,54.77758204922098,45.22241795077902,Food
212151,43002,169149,20.269525008131,79.73047499186899,Entertainment
232511,69193,163318,29.75902215379057,70.24097784620943,Entertainment
70189,31714,38475,45.183718246448876,54.816281753551124,Transportation
164364,30399,133965,18.49492589618165,81.50507410381836,Healthcare
33503,15083,18420,45.019848968749066,54.980151031250934,Food
133034,12911,120123,9.705037809883187,90.2949621901168,Healthcare
24683,2520,22163,10.209455900822428,89.79054409917757,Housing
39403,16284,23119,41.326802527726315,58.673197472273685,Food
227250,35540,191710,15.639163916391638,84.36083608360836,Entertainment
114353,57539,56814,50.31700086574029,49.6829991342597,Transportation
102550,20904,81646,20.384202827888835,79.61579717211117,Transportation
29387,3871,25516,13.172491237622078,86.82750876237793,Housing
121499,21788,99711,17.932657881957876,82.06734211804212,Healthcare
244218,21490,222728,8.799515187250735,91.20048481274927,Entertainment
40624,15209,25415,37.43846002363135,62.56153997636865,Food
27913,16525,11388,59.201805610289114,40.79819438971089,Housing
188141,21254,166887,11.296846514050632,88.70315348594937,Entertainment
63753,8426,55327,13.216632942763479,86.78336705723653,Transportation
188352,46721,141631,24.80515205572545,75.19484794427454,Entertainment
203347,38297,165050,18.83332431754587,81.16667568245413,Entertainment
191955,16144,175811,8.410304498450158,91.58969550154984,Entertainment
25878,10888,14990,42.07434886776412,57.92565113223588,Housing
36138,2672,33466,7.3938790193148485,92.60612098068515,Food
17460,9376,8084,53.69988545246277,46.30011454753723,Housing
140539,64929,75610,46.1999871921673,53.8000128078327,Healthcare
55835,24986,30849,44.74970896391153,55.25029103608847,Food
165857,9516,156341,5.737472642095299,94.2625273579047,Healthcare
89976,44565,45411,49.52987463323553,50.47012536676447,Transportation
160431,45199,115232,28.173482681027977,71.82651731897202,Healthcare
56121,1576,54545,2.8082179576272694,97.19178204237274,Food
16244,5055,11189,31.119182467372568,68.88081753262743,Housing
15966,4293,11673,26.88838782412627,73.11161217587373,Housing
170179,41981,128198,24.668731159543775,75.33126884045622,Healthcare
209942,52538,157404,25.02500690666946,74.97499309333054,Entertainment
110888,22658,88230,20.43322992569079,79.56677007430922,Transportation
33130,12511,20619,37.763356474494415,62.236643525505585,Food
36639,9960,26679,27.184148038974865,72.81585196102513,Food
15463,3558,11905,23.009765246071268,76.99023475392873,Housing
90291,50932,39359,56.408722907045,43.591277092954996,Transportation
193573,26262,167311,13.566974733046447,86.43302526695355,Entertainment
13565,7806,5759,57.54515296719499,42.45484703280501,Housing
45555,17775,27780,39.01876852156734,60.98123147843266,Food
13486,5751,7735,42.644223639329674,57.35577636067033,Housing
207143,54395,152748,26.259637062319268,73.74036293768074,Entertainment
238632,392,238240,0.1642696704549264,99.83573032954507,Entertainment
16803,2240,14563,13.33095280604654,86.66904719395346,Housing
56807,28109,28698,49.481577974545395,50.51842202545461,Food
207280,18258,189022,8.808375144731764,91.19162485526824,Entertainment
180830,30850,149980,17.06022230824531,82.93977769175468,Entertainment
47695,22084,25611,46.302547436838246,53.697452563161754,Food
168033,30924,137109,18.403527878452447,81.59647212154756,Healthcare
175468,20844,154624,11.879089064672762,88.12091093532723,Healthcare
18858,1157,17701,6.135327182097783,93.86467281790222,Housing
42228,20518,21710,48.588614189637205,51.411385810362795,Food
105543,37058,68485,35.111755398273694,64.88824460172631,Transportation
25976,13231,12745,50.935478903603325,49.064521096396675,Housing
43421,285,43136,0.6563644319568872,99.34363556804311,Food
176120,2496,173624,1.4172155348625937,98.58278446513741,Healthcare
237459,50360,187099,21.207871674689105,78.7921283253109,Entertainment
158725,51846,106879,32.66404158135139,67.33595841864862,Healthcare
164503,10538,153965,6.405962201297241,93.59403779870276,Healthcare
225462,61215,164247,27.150916784203105,72.8490832157969,Entertainment
155635,32706,122929,21.01455328171684,78.98544671828316,Healthcare
191824,51812,140012,27.010175994661772,72.98982400533822,Entertainment
60123,5569,54554,9.262678176405037,90.73732182359497,Transportation
76549,28999,47550,37.882924662634395,62.11707533736561,Transportation
203147,22363,180784,11.008284641171171,88.99171535882883,Entertainment
52854,1365,51489,2.5825859915995006,97.4174140084005,Food
220915,12675,208240,5.737500848742729,94.26249915125727,Entertainment
20861,1177,19684,5.642107281530128,94.35789271846987,Housing
17897,932,16965,5.20757668883053,94.79242331116947,Housing
56360,3926,52434,6.965933286018452,93.03406671398155,Food
11337,3068,8269,27.06183293640293,72.93816706359706,Housing
99494,6494,93000,6.527026755382234,93.47297324461776,Transportation
163996,22590,141406,13.774726212834459,86.22527378716555,Healthcare
182882,63583,119299,34.767226955085796,65.23277304491421,Entertainment
170854,7807,163047,4.569398433750454,95.43060156624955,Healthcare
17082,8523,8559,49.89462592202318,50.10537407797682,Housing
198982,60953,138029,30.632419012775024,69.36758098722497,Entertainment
217504,24588,192916,11.304619685155215,88.69538031484478,Entertainment
120748,40543,80205,33.57653957001358,66.42346042998642,Healthcare
185430,28017,157413,15.109205630156932,84.89079436984306,Entertainment
52441,1411,51030,2.690642817642684,97.30935718235732,Food
182508,38729,143779,21.22043965196046,78.77956034803954,Entertainment
44854,21341,23513,47.5788112542917,52.4211887457083,Food
180472,26971,153501,14.944700562968215,85.05529943703178,Entertainment
11536,1332,10204,11.546463245492372,88.45353675450764,Housing
25320,4365,20955,17.239336492890995,82.760663507109,Housing
246838,68938,177900,27.928438895145803,72.0715611048542,Entertainment
100958,40280,60678,39.89777927454981,60.10222072545018,Transportation
229052,21569,207483,9.416639016467876,90.58336098353212,Entertainment
245120,66125,178995,26.976582898172325,73.02341710182768,Entertainment
217791,40251,177540,18.48147995096216,81.51852004903783,Entertainment
19676,7325,12351,37.22809514128888,62.771904858711125,Housing
45832,25400,20432,55.4197940303718,44.5802059696282,Food
43275,4953,38322,11.445407279029462,88.55459272097053,Food
44665,15871,28794,35.533415425948725,64.46658457405127,Food
18534,2709,15825,14.616380705730009,85.38361929426999,Housing
27334,8747,18587,32.000439013682595,67.9995609863174,Housing
187983,10024,177959,5.3323970784592225,94.66760292154078,Entertainment
248488,31386,217102,12.63079102411384,87.36920897588615,Entertainment
38300,5946,32354,15.524804177545693,84.47519582245431,Food
223026,7672,215354,3.4399576730964103,96.5600423269036,Entertainment
110397,49991,60406,45.28293341304565,54.71706658695435,Transportation
21358,2459,18899,11.513250304335612,88.48674969566439,Housing
135732,65687,70045,48.39463059558542,51.60536940441458,Healthcare
37961,3278,34683,8.63517820921472,91.36482179078527,Food
183679,33695,149984,18.34450318218196,81.65549681781805,Entertainment
41997,5285,36712,12.58423220706241,87.41576779293759,Food
83681,3232,80449,3.8622865405528137,96.13771345944718,Transportation
194081,31999,162082,16.48744596328337,83.51255403671662,Entertainment
81751,6353,75398,7.771158762583943,92.22884123741606,Transportation
31696,10058,21638,31.732710752145383,68.26728924785462,Food
230212,62764,167448,27.263565756780707,72.73643424321929,Entertainment
159914,20066,139848,12.547994547069049,87.45200545293095,Healthcare
18124,1527,16597,8.425292429927168,91.57470757007283,Housing
118662,361,118301,0.30422544706814314,99.69577455293187,Transportation
29516,7699,21817,26.08415774495189,73.91584225504812,Housing
202696,51448,151248,25.38185262659352,74.61814737340649,Entertainment
161692,3574,158118,2.2103752813992035,97.7896247186008,Healthcare
18361,9416,8945,51.28260987963619,48.71739012036381,Housing
64069,30418,33651,47.47693892522125,52.52306107477875,Transportation
35357,2133,33224,6.032751647481404,93.9672483525186,Food
175251,27245,148006,15.546273630392978,84.45372636960701,Healthcare
99002,7113,91889,7.184703339326479,92.81529666067352,Transportation
42664,12359,30305,28.968216763547723,71.03178323645227,Food
172070,25478,146592,14.806764688789444,85.19323531121056,Healthcare
75785,37094,38691,48.94636141716698,51.05363858283302,Transportation
166793,58269,108524,34.93491933114699,65.06508066885301,Healthcare
88669,38220,50449,43.10412883871477,56.89587116128523,Transportation
29667,5416,24251,18.255974651970202,81.74402534802981,Housing
15672,1081,14591,6.897651863195509,93.1023481368045,Housing
183821,54554,129267,29.67778436631288,70.32221563368712,Entertainment
18096,4275,13821,23.624005305039788,76.37599469496021,Housing
17802,3992,13810,22.42444669138299,77.575553308617,Housing
44519,26578,17941,59.70035265841551,40.299647341584496,Food
22505,4602,17903,20.448789157964896,79.5512108420351,Housing
11557,4254,7303,36.80886043090767,63.19113956909233,Housing
54005,21648,32357,40.08517729839829,59.9148227016017,Food
121873,53306,68567,43.73897417803779,56.26102582196221,Healthcare
30048,4574,25474,15.222310969116082,84.77768903088392,Food
208856,4365,204491,2.0899567165894206,97.91004328341057,Entertainment
106669,30824,75845,28.896867881015105,71.1031321189849,Transportation
247114,14810,232304,5.9931853314664485,94.00681466853355,Entertainment
13306,5423,7883,40.756049902299715,59.243950097700285,Housing
22875,850,22025,3.715846994535519,96.28415300546447,Housing
28501,6922,21579,24.28686712746921,75.71313287253079,Housing
236505,66157,170348,27.97277013170969,72.0272298682903,Entertainment
92705,32090,60615,34.61517717490966,65.38482282509034,Transportation
21997,9738,12259,44.26967313724599,55.73032686275401,Housing
104161,15595,88566,14.972014477587582,85.02798552241242,Transportation
235939,45715,190224,19.375770856026346,80.62422914397366,Entertainment
181653,59278,122375,32.632546668648466,67.36745333135154,Entertainment
28304,6428,21876,22.710570944036178,77.28942905596382,Housing
34401,8670,25731,25.202755733844945,74.79724426615505,Food
243011,13378,229633,5.505100592154265,94.49489940784574,Entertainment
49517,2890,46627,5.836379425247895,94.1636205747521,Food
133235,61731,71504,46.3324201598679,53.6675798401321,Healthcare
163008,37061,125947,22.735693953670985,77.26430604632901,Healthcare
205652,69993,135659,34.03467994476105,65.96532005523895,Entertainment
136066,35481,100585,26.076315905516438,73.92368409448355,Healthcare
185023,66545,118478,35.96579884662987,64.03420115337012,Entertainment
59353,34885,24468,58.77546206594444,41.22453793405557,Food
50738,7689,43049,15.154322204265046,84.84567779573496,Food
75332,23625,51707,31.361174534062553,68.63882546593744,Transportation
149972,388,149584,0.2587149601258902,99.7412850398741,Healthcare
211173,59005,152168,27.94154555743395,72.05845444256605,Entertainment
249825,67637,182188,27.073751626138296,72.9262483738617,Entertainment
227633,48140,179493,21.14807606981413,78.85192393018588,Entertainment
162005,6611,155394,4.080738248819481,95.91926175118051,Healthcare
51467,7882,43585,15.314667651116249,84.68533234888375,Food
136773,31905,104868,23.326972428768837,76.67302757123117,Healthcare
50328,2941,47387,5.843665553965984,94.15633444603402,Food
116244,20049,96195,17.247341798286364,82.75265820171363,Transportation
112692,41691,71001,36.99552763283995,63.00447236716005,Transportation
44923,20509,24414,45.65367406451038,54.34632593548962,Food
13424,456,12968,3.396901072705602,96.6030989272944,Housing
95525,17406,78119,18.22140800837477,81.77859199162523,Transportation
161254,30131,131123,18.685427958376227,81.31457204162378,Healthcare
20095,9662,10433,48.08161234137845,51.91838765862155,Housing
17833,10177,7656,57.06835641787696,42.93164358212303,Housing
11914,453,11461,3.8022494544233676,96.19775054557664,Housing
23070,302,22768,1.3090593844820113,98.69094061551799,Housing
65350,20673,44677,31.634276970160673,68.36572302983933,Transportation
111549,58964,52585,52.8592815713274,47.1407184286726,Transportation
237489,60947,176542,25.663083342807457,74.33691665719255,Entertainment
35212,91,35121,0.25843462455980915,99.74156537544019,Food
33392,1989,31403,5.956516530905606,94.0434834690944,Food
172303,1129,171174,0.655241057903809,99.34475894209619,Healthcare
176692,30265,146427,17.12867588798587,82.87132411201412,Healthcare
28114,11148,16966,39.65284200042684,60.34715799957316,Housing
120638,30822,89816,25.54916361345513,74.45083638654488,Healthcare
238135,18732,219403,7.866126356898398,92.13387364310161,Entertainment
15134,7075,8059,46.74904189242765,53.25095810757235,Housing
150263,55160,95103,36.708970272122876,63.291029727877124,Healthcare
14738,7286,7452,49.436829963360026,50.56317003663998,Housing
188888,36831,152057,19.498856465206895,80.5011435347931,Entertainment
21196,11782,9414,55.58595961502171,44.4140403849783,Housing
48220,27140,21080,56.283699709664035,43.71630029033596,Food
190341,6356,183985,3.3392700469157988,96.6607299530842,Entertainment
18731,10693,8038,57.08718167743313,42.91281832256687,Housing
29638,3654,25984,12.32876712328767,87.67123287671232,Housing
148367,39677,108690,26.74246968665539,73.2575303133446,Healthcare
13459,2856,10603,21.2200014859945,78.7799985140055,Housing
44891,13836,31055,30.82132275957319,69.17867724042681,Food
148064,50141,97923,33.86440998487141,66.1355900151286,Healthcare
10531,2275,8256,21.602886715411643,78.39711328458836,Housing
200146,51009,149137,25.485895296433604,74.5141047035664,Entertainment
25418,747,24671,2.9388622236210558,97.06113777637894,Housing
203598,6987,196611,3.4317625909881238,96.56823740901189,Entertainment
167380,63598,103782,37.996176365157126,62.00382363484287,Healthcare
97961,15606,82355,15.93082961586754,84.06917038413246,Transportation
138867,63096,75771,45.436280757847435,54.563719242152565,Healthcare
14557,1030,13527,7.0756337157381335,92.92436628426188,Housing
172775,21903,150872,12.677181305165677,87.32281869483433,Healthcare
72454,7246,65208,10.000828111629447,89.99917188837055,Transportation
29260,3185,26075,10.885167464114833,89.11483253588517,Housing
219627,39646,179981,18.051514613412742,81.94848538658725,Entertainment
144444,16886,127558,11.690343662595886,88.30965633740412,Healthcare
53347,11600,41747,21.744427990327477,78.25557200967252,Food
180727,36402,144325,20.141982105606797,79.8580178943932,Entertainment
221348,5989,215359,2.705694200986682,97.29430579901332,Entertainment
20127,5221,14906,25.94027922690913,74.05972077309087,Housing
29308,2927,26381,9.987034256858196,90.0129657431418,Housing
30455,15489,14966,50.85864390083729,49.1413560991627,Food
13318,5722,7596,42.964409070430996,57.035590929569004,Housing
58946,30582,28364,51.88138296067587,48.11861703932413,Food
231312,29773,201539,12.871359894860621,87.12864010513938,Entertainment
44857,6688,38169,14.909601622935103,85.09039837706489,Food
60810,27721,33089,45.586252261141254,54.413747738858746,Transportation
112532,6060,106472,5.38513489496321,94.6148651050368,Transportation
38542,17996,20546,46.69192050230917,53.30807949769083,Food
173711,59742,113969,34.39160444646568,65.60839555353432,Healthcare
218995,34403,184592,15.70949108427133,84.29050891572867,Entertainment
21629,8759,12870,40.496555550418414,59.50344444958158,Housing
198615,12989,185626,6.539788032122448,93.46021196787756,Entertainment
28891,13573,15318,46.98002838254128,53.01997161745873,Housing
13821,7300,6521,52.81817524057594,47.18182475942406,Housing
10459,2714,7745,25.948943493641842,74.05105650635817,Housing
50740,5541,45199,10.920378399684667,89.07962160031533,Food
64130,34934,29196,54.473725245594885,45.526274754405115,Transportation
12110,3431,8679,28.33195706028076,71.66804293971924,Housing
92513,42832,49681,46.29835806859576,53.70164193140423,Transportation
27243,5044,22199,18.514847850824065,81.48515214917593,Housing
10280,6167,4113,59.990272373540854,40.009727626459146,Housing
57288,20985,36303,36.63070800167574,63.36929199832425,Food
96593,35996,60597,37.265640367314404,62.734359632685596,Transportation
240364,5247,235117,2.1829392088665522,97.81706079113344,Entertainment
11197,1141,10056,10.19022952576583,89.80977047423417,Housing
26255,13490,12765,51.38068939249667,48.61931060750334,Housing
48225,16578,31647,34.37636080870918,65.62363919129083,Food
175808,25771,150037,14.658604841645431,85.34139515835457,Healthcare
166997,4506,162491,2.6982520644083428,97.30174793559165,Healthcare
67002,12391,54611,18.493477806632637,81.50652219336736,Transportation
214090,8843,205247,4.130505862020645,95.86949413797934,Entertainment
70540,14579,55961,20.6677062659484,79.3322937340516,Transportation
23986,1107,22879,4.615192195447344,95.38480780455265,Housing
45709,2496,43213,5.460631385503949,94.53936861449606,Food
131397,31608,99789,24.05534372930889,75.94465627069111,Healthcare
38919,13676,25243,35.139649014620105,64.8603509853799,Food
230516,8224,222292,3.56764823266064,96.43235176733937,Entertainment
197211,66618,130593,33.78006297823144,66.21993702176856,Entertainment
150933,26764,124169,17.732371317074463,82.26762868292553,Healthcare
86787,36736,50051,42.32892022998836,57.67107977001164,Transportation
110020,36500,73520,33.17578622068715,66.82421377931286,Transportation
63671,14786,48885,23.222503180411806,76.7774968195882,Transportation
78065,32646,45419,41.81899698968808,58.18100301031192,Transportation
154140,6883,147257,4.465421045802517,95.53457895419749,Healthcare
96299,16249,80050,16.873487782843018,83.12651221715697,Transportation
49099,5135,43964,10.458461475793804,89.5415385242062,Food
29110,3704,25406,12.724149776709034,87.27585022329096,Housing
138356,20842,117514,15.064037699846772,84.93596230015322,Healthcare
134928,42767,92161,31.69616387999526,68.30383612000475,Healthcare
161771,56907,104864,35.17750400257154,64.82249599742846,Healthcare
49527,5138,44389,10.3741393583298,89.6258606416702,Food
86263,39389,46874,45.66152348051888,54.33847651948113,Transportation
135334,26080,109254,19.270841030339753,80.72915896966025,Healthcare
219805,37105,182700,16.880871681717885,83.11912831828211,Entertainment
11729,4991,6738,42.55264728450848,57.44735271549152,Housing
106934,25516,81418,23.861447247835113,76.13855275216488,Transportation
50927,20989,29938,41.21389439786361,58.786105602136395,Food
13866,4479,9387,32.30203375162267,67.69796624837733,Housing
242738,53785,188953,22.157634980925938,77.84236501907407,Entertainment
29507,12320,17187,41.75280441929034,58.247195580709665,Housing
26206,2159,24047,8.238571319545143,91.76142868045486,Housing
89999,53645,36354,59.606217846864965,40.393782153135035,Transportation
17310,5921,11389,34.20566146735991,65.7943385326401,Housing
74650,27336,47314,36.61888814467515,63.381111855324846,Transportation
161572,64227,97345,39.75131829772485,60.24868170227514,Healthcare
58751,30972,27779,52.71740055488417,47.28259944511583,Food
172160,22285,149875,12.944354089219331,87.05564591078067,Healthcare
70400,10208,60192,14.499999999999998,85.5,Transportation
39271,10532,28739,26.81877212192203,73.18122787807798,Food
80063,47564,32499,59.40821602987647,40.59178397012353,Transportation
239552,30023,209529,12.532978226021907,87.46702177397809,Entertainment
128615,61047,67568,47.46491466780702,52.53508533219298,Healthcare
228482,54102,174380,23.678889365464237,76.32111063453576,Entertainment
92502,46230,46272,49.97729778815593,50.02270221184407,Transportation
165595,24590,141005,14.849482170355385,85.15051782964461,Healthcare
215246,23772,191474,11.044107672151863,88.95589232784815,Entertainment
100153,55426,44727,55.34132776851417,44.65867223148582,Transportation
204498,30523,173975,14.92581834541169,85.07418165458832,Entertainment
187821,62675,125146,33.36953801758057,66.63046198241943,Entertainment
188676,1388,187288,0.7356526532256354,99.26434734677436,Entertainment
115997,34345,81652,29.60852435838858,70.39147564161142,Transportation
210240,57298,152942,27.25361491628615,72.74638508371385,Entertainment
97104,54713,42391,56.34474377986489,43.655256220135115,Transportation
19739,5810,13929,29.434115203404428,70.56588479659557,Housing
19427,11039,8388,56.82297832912956,43.17702167087044,Housing
31529,16845,14684,53.42700371086936,46.57299628913064,Food
226600,47279,179321,20.86451897616946,79.13548102383054,Entertainment
33209,5051,28158,15.209732301484538,84.79026769851546,Food
48428,2935,45493,6.060543487238788,93.93945651276121,Food
14279,2118,12161,14.832971496603403,85.1670285033966,Housing
18263,3469,14794,18.994688714888024,81.00531128511199,Housing
33922,1463,32459,4.312835328105654,95.68716467189434,Food
58678,11618,47060,19.799584171239648,80.20041582876036,Food
161600,67700,93900,41.89356435643564,58.10643564356436,Healthcare
71330,24923,46407,34.94041777653161,65.05958222346838,Transportation
45525,9545,35980,20.966501922020868,79.03349807797913,Food
154608,67842,86766,43.88000620925179,56.11999379074821,Healthcare
224339,3688,220651,1.643940643401281,98.35605935659872,Entertainment
82386,23084,59302,28.019323671497588,71.98067632850241,Transportation
28733,3970,24763,13.81686562489124,86.18313437510876,Housing
125643,58301,67342,46.40210755871795,53.59789244128205,Healthcare
72114,27550,44564,38.20340017194997,61.796599828050034,Transportation
169582,57679,111903,34.01245415197368,65.98754584802631,Healthcare
24884,5359,19525,21.53592669988748,78.46407330011253,Housing
142793,35831,106962,25.09296674206719,74.90703325793281,Healthcare
93377,25154,68223,26.938111098022,73.061888901978,Transportation
115588,45885,69703,39.697027373083706,60.30297262691629,Transportation
104615,8296,96319,7.93002915451895,92.06997084548105,Transportation
227211,2213,224998,0.9739845341994886,99.02601546580051,Entertainment
168956,7716,161240,4.566869480811572,95.43313051918842,Healthcare
52720,30678,22042,58.19044006069802,41.80955993930197,Food
55550,10636,44914,19.146714671467148,80.85328532853285,Food
26422,9267,17155,35.07304518961472,64.92695481038528,Housing
191055,53215,137840,27.8532359791683,72.1467640208317,Entertainment
206340,56038,150302,27.15808859164486,72.84191140835514,Entertainment
139974,18472,121502,13.196736536785403,86.80326346321459,Healthcare
234314,38935,195379,16.616591411524706,83.38340858847529,Entertainment
155578,6406,149172,4.117548753679826,95.88245124632017,Healthcare
222952,43039,179913,19.30415515447271,80.69584484552729,Entertainment
29355,14870,14485,50.65576562766139,49.34423437233861,Housing
242182,17895,224287,7.389071029225954,92.61092897077404,Entertainment
21765,3786,17979,17.394900068917988,82.60509993108201,Housing
17177,230,16947,1.3389998253478488,98.66100017465214,Housing
117064,15405,101659,13.159468325018794,86.84053167498121,Transportation
215651,1154,214497,0.5351238807146732,99.46487611928532,Entertainment
241066,11214,229852,4.651838085835414,95.34816191416459,Entertainment
31401,7754,23647,24.693481099328046,75.30651890067195,Food
24604,4435,20169,18.02552430499106,81.97447569500895,Housing
34177,8172,26005,23.910817216256547,76.08918278374345,Food
240697,63291,177406,26.29488527069303,73.70511472930697,Entertainment
112475,29042,83433,25.820849077572795,74.17915092242721,Transportation
126114,37801,88313,29.973674611859114,70.02632538814089,Healthcare
150011,18686,131325,12.456419862543413,87.54358013745659,Healthcare
62763,29956,32807,47.728757388907475,52.271242611092525,Transportation
162378,54597,107781,33.62339725824927,66.37660274175073,Healthcare
33361,12463,20898,37.35799286592128,62.64200713407872,Food
169715,32527,137188,19.165660077188225,80.83433992281176,Healthcare
37489,11285,26204,30.10216330123503,69.89783669876498,Food
36350,20669,15681,56.86107290233837,43.13892709766162,Food
44974,24996,19978,55.57877885000222,44.42122114999778,Food
90052,18046,72006,20.03953271443166,79.96046728556834,Transportation
23350,7918,15432,33.91006423982869,66.0899357601713,Housing
122907,32695,90212,26.601414077310487,73.39858592268952,Healthcare
123299,10814,112485,8.770549639494238,91.22945036050577,Healthcare
136586,27319,109267,20.001317851024265,79.99868214897575,Healthcare
28705,2404,26301,8.374847587528306,91.6251524124717,Housing
241341,58390,182951,24.193982787839612,75.8060172121604,Entertainment
52039,17742,34297,34.09366052383789,65.90633947616212,Food
92534,54347,38187,58.731925562495945,41.268074437504055,Transportation
155498,54684,100814,35.167011794363916,64.83298820563608,Healthcare
176714,58734,117980,33.23675543533619,66.76324456466381,Healthcare
107685,22198,85487,20.613827366857038,79.38617263314296,Transportation
219326,61909,157417,28.226931599536766,71.77306840046323,Entertainment
133483,59042,74441,44.23184974865713,55.76815025134286,Healthcare
93057,39892,53165,42.86834950621662,57.13165049378338,Transportation
72763,15758,57005,21.656611189753033,78.34338881024696,Transportation
83467,29378,54089,35.19714378137467,64.80285621862532,Transportation
51611,6199,45412,12.01100540582434,87.98899459417567,Food
172130,47936,124194,27.848718991459943,72.15128100854005,Healthcare
96340,48433,47907,50.272991488478304,49.72700851152169,Transportation
13092,6582,6510,50.2749770852429,49.725022914757105,Housing
84698,34173,50525,40.34687950128693,59.65312049871307,Transportation
104676,3757,100919,3.5891703924490805,96.41082960755092,Transportation
47507,22613,24894,47.59930115561917,52.400698844380834,Food
12105,8,12097,0.06608839322593969,99.93391160677406,Housing
25820,8398,17422,32.525174283501165,67.47482571649884,Housing
16547,2958,13589,17.87635220885961,82.12364779114039,Housing
184647,43292,141355,23.445818236960253,76.55418176303974,Entertainment
223327,56723,166604,25.39907848133007,74.60092151866992,Entertainment
13707,690,13017,5.033924272269643,94.96607572773036,Housing
16224,3946,12278,24.32199211045365,75.67800788954635,Housing
127268,6594,120674,5.1811924442907875,94.81880755570921,Healthcare
39861,10202,29659,25.593938937808886,74.40606106219111,Food
156220,22984,133236,14.712584816284727,85.28741518371528,Healthcare
52988,14955,38033,28.223371329357587,71.77662867064241,Food
41899,7575,34324,18.07919043413924,81.92080956586076,Food
39422,14754,24668,37.42580285119983,62.57419714880016,Food
181919,11131,170788,6.11865720458006,93.88134279541994,Entertainment
249381,46919,202462,18.814183919384394,81.18581608061561,Entertainment
163908,26243,137665,16.010810942723968,83.98918905727604,Healthcare
58246,33312,24934,57.19191017408921,42.80808982591079,Food
99502,8068,91434,8.108379731060682,91.89162026893932,Transportation
52649,11521,41128,21.882656840585764,78.11734315941423,Food
15514,107,15407,0.6896996261441279,99.31030037385588,Housing
75853,26872,48981,35.42641688529129,64.57358311470871,Transportation
21293,22,21271,0.10332034001784624,99.89667965998215,Housing
12578,6151,6427,48.90284623946574,51.09715376053426,Housing
115671,30304,85367,26.198442133291838,73.80155786670817,Transportation
185657,18371,167286,9.895129189850099,90.10487081014989,Entertainment
101590,37423,64167,36.83728713456048,63.16271286543951,Transportation
15191,6661,8530,43.84833124876572,56.15166875123428,Housing
203988,33191,170797,16.271055160107455,83.72894483989253,Entertainment
36850,19272,17578,52.29850746268657,47.701492537313435,Food
145559,48785,96774,33.51561909603666,66.48438090396334,Healthcare
187892,17196,170696,9.152066080514338,90.84793391948565,Entertainment
149963,5013,144950,3.3428245633923033,96.6571754366077,Healthcare
90793,27973,62820,30.80964391527981,69.19035608472018,Transportation
175837,65214,110623,37.08775741169379,62.91224258830621,Healthcare
191607,34678,156929,18.098503708110872,81.90149629188913,Entertainment
20338,4466,15872,21.95889467990953,78.04110532009048,Housing
120043,35089,84954,29.230359121314862,70.76964087868514,Healthcare
27766,11894,15872,42.836562702585894,57.1634372974141,Housing
13358,6583,6775,49.28132954035035,50.71867045964965,Housing
37479,7626,29853,20.34739454094293,79.65260545905707,Food
28023,1594,26429,5.688184705420547,94.31181529457945,Housing
19826,2210,17616,11.146978714818925,88.85302128518107,Housing
159870,18799,141071,11.758929129918059,88.24107087008194,Healthcare
124649,8033,116616,6.444496145175653,93.55550385482435,Healthcare
118409,14727,103682,12.437399184183635,87.56260081581637,Transportation
118625,58343,60282,49.18271865121181,50.8172813487882,Transportation
168971,13318,155653,7.881825875446083,92.11817412455392,Healthcare
18679,9457,9222,50.62904866427539,49.37095133572461,Housing
57266,4338,52928,7.575175496804388,92.42482450319561,Food
95657,6849,88808,7.159956929445832,92.84004307055417,Transportation
199186,58100,141086,29.16871667687488,70.83128332312512,Entertainment
29253,13358,15895,45.66369261272348,54.33630738727652,Housing
175850,46619,129231,26.510662496445836,73.48933750355417,Healthcare
133900,22558,111342,16.84690067214339,83.15309932785661,Healthcare
24956,7640,17316,30.61388042955602,69.38611957044398,Housing
58279,28243,30036,48.46171004993222,51.53828995006777,Food
49016,24866,24150,50.73037375550841,49.26962624449159,Food
223510,63866,159644,28.574113015077625,71.42588698492237,Entertainment
20050,6644,13406,33.13715710723192,66.86284289276809,Housing
99247,7525,91722,7.582093161506141,92.41790683849386,Transportation
222104,51316,170788,23.104491589525626,76.89550841047436,Entertainment
245642,2221,243421,0.904161340487376,99.09583865951262,Entertainment
132399,39976,92423,30.193581522519054,69.80641847748095,Healthcare
103093,10315,92778,10.005528988389125,89.99447101161088,Transportation
205123,37662,167461,18.36069090253165,81.63930909746836,Entertainment
120833,18489,102344,15.301283589747833,84.69871641025216,Healthcare
57008,14673,42335,25.73849284310974,74.26150715689026,Food
27681,2994,24687,10.81608323398721,89.1839167660128,Housing
149502,54310,95192,36.32727321373627,63.67272678626373,Healthcare
14557,8083,6474,55.52655080030225,44.47344919969774,Housing
125448,50906,74542,40.579363560997386,59.420636439002614,Healthcare
66001,34318,31683,51.996181876032175,48.00381812396782,Transportation
19702,10507,9195,53.32961120698406,46.67038879301594,Housing
78356,26051,52305,33.24697534330492,66.75302465669508,Transportation
10158,4749,5409,46.751329001772,53.248670998228,Housing
113445,50997,62448,44.953060954647626,55.046939045352374,Transportation
124976,6382,118594,5.106580463448982,94.89341953655102,Healthcare
12535,3186,9349,25.416832867969685,74.58316713203031,Housing
44812,3892,40920,8.68517361421048,91.31482638578952,Food
54750,15573,39177,28.443835616438356,71.55616438356165,Food
224870,38796,186074,17.252634855694403,82.74736514430559,Entertainment
22221,1902,20319,8.5594707708924,91.4405292291076,Housing
58551,28316,30235,48.36125770695633,51.63874229304367,Food
94664,54352,40312,57.41570185075636,42.584298149243644,Transportation
189756,31403,158353,16.549147326039755,83.45085267396024,Entertainment
114293,59560,54733,52.11167788053511,47.88832211946488,Transportation
45523,8535,36988,18.748764360872524,81.25123563912747,Food
40387,21113,19274,52.276722707802016,47.723277292197984,Food
22597,11857,10740,52.47156702217109,47.52843297782891,Housing
17301,5235,12066,30.25836656840645,69.74163343159356,Housing
198009,46444,151565,23.45549949749759,76.54450050250242,Entertainment
73345,441,72904,0.601267980094076,99.39873201990592,Transportation
34600,3687,30913,10.65606936416185,89.34393063583815,Food
79611,11420,68191,14.34475135345618,85.65524864654382,Transportation
90060,42838,47222,47.56606706640017,52.43393293359983,Transportation
79948,5481,74467,6.855706209035874,93.14429379096413,Transportation
84271,40517,43754,48.079410473353825,51.920589526646175,Transportation
133139,68951,64188,51.78873207700223,48.21126792299777,Healthcare
51382,1095,50287,2.131096492935269,97.86890350706473,Food
182952,19180,163772,10.483624119987757,89.51637588001225,Entertainment
40980,13832,27148,33.75305026842362,66.24694973157638,Food
198147,62935,135212,31.761772825225716,68.23822717477428,Entertainment
28529,8870,19659,31.091170388026217,68.90882961197377,Housing
50454,5777,44677,11.450033694057954,88.54996630594205,Food
28078,8653,19425,30.817722059975782,69.18227794002422,Housing
183344,34218,149126,18.663277772929575,81.33672222707042,Entertainment
161721,31633,130088,19.560230273124702,80.4397697268753,Healthcare
219546,47172,172374,21.486157798365717,78.51384220163428,Entertainment
47163,5095,42068,10.802959947416408,89.1970400525836,Food
104987,49831,55156,47.46397172983322,52.53602827016678,Transportation
173862,46884,126978,26.966214583980396,73.0337854160196,Healthcare
207833,30143,177690,14.503471537243845,85.49652846275616,Entertainment
133706,13523,120183,10.113981421925718,89.88601857807427,Healthcare
96916,4112,92804,4.242849477898386,95.75715052210161,Transportation
84122,15953,68169,18.96412353486603,81.03587646513397,Transportation
70743,40465,30278,57.20000565426968,42.79999434573032,Transportation
175298,31706,143592,18.086914853563645,81.91308514643636,Healthcare
31106,9371,21735,30.126020703401274,69.87397929659873,Food
23171,7127,16044,30.758275430495015,69.24172456950498,Housing
214620,21762,192858,10.13978194017333,89.86021805982666,Entertainment
37530,12654,24876,33.71702637889688,66.28297362110311,Food
74281,16848,57433,22.681439399038787,77.31856060096122,Transportation
27243,4436,22807,16.283081892596265,83.71691810740374,Housing
70681,11895,58786,16.829133713444914,83.1708662865551,Transportation
170401,15324,155077,8.992904971214957,91.00709502878505,Healthcare
23400,13038,10362,55.717948717948715,44.282051282051285,Housing
45636,8929,36707,19.565693750547812,80.43430624945219,Food
61064,28178,32886,46.145028167168874,53.85497183283113,Transportation
27713,7915,19798,28.560603326958468,71.43939667304153,Housing
63310,30843,32467,48.71742220818196,51.28257779181804,Transportation
220091,3187,216904,1.448037402710697,98.5519625972893,Entertainment
196484,49376,147108,25.129781559821662,74.87021844017833,Entertainment
201460,58892,142568,29.232602005360864,70.76739799463914,Entertainment
166291,68516,97775,41.202470368209944,58.797529631790056,Healthcare
11319,5662,5657,50.02208675678064,49.97791324321936,Housing
26103,3561,22542,13.642110102287095,86.35788989771291,Housing
11468,4478,6990,39.04778514126264,60.95221485873735,Housing
35238,16764,18474,47.57364209092457,52.42635790907543,Food
21398,12011,9387,56.13141415085522,43.86858584914478,Housing
59558,19841,39717,33.313744585110314,66.68625541488969,Food
81414,37081,44333,45.54622055174786,54.45377944825215,Transportation
106961,60788,46173,56.831929394826155,43.168070605173845,Transportation
17539,2548,14991,14.527624151890073,85.47237584810993,Housing
53106,12914,40192,24.31740292998908,75.68259707001093,Food
28678,2386,26292,8.319966524862265,91.68003347513773,Housing
46772,17097,29675,36.553921149405625,63.44607885059437,Food
131324,384,130940,0.29240656696414974,99.70759343303584,Healthcare
110186,54622,55564,49.57254097616757,50.427459023832434,Transportation
19395,11034,8361,56.890951276102086,43.109048723897914,Housing
244388,19342,225046,7.91446388529715,92.08553611470285,Entertainment
177940,39351,138589,22.114757783522535,77.88524221647747,Healthcare
195131,6439,188692,3.299834470176446,96.70016552982355,Entertainment
168155,31689,136466,18.84511313966281,81.1548868603372,Healthcare
247755,13188,234567,5.32300054489314,94.67699945510685,Entertainment
217396,54687,162709,25.15547664170454,74.84452335829546,Entertainment
137566,22943,114623,16.677812831658986,83.32218716834102,Healthcare
19704,7206,12498,36.571254567600484,63.428745432399516,Housing
52858,14162,38696,26.792538499375684,73.20746150062432,Food
209593,30141,179452,14.38072836401979,85.61927163598021,Entertainment
35733,5355,30378,14.986147258836368,85.01385274116363,Food
50805,27356,23449,53.84509398681232,46.15490601318768,Food
125603,69714,55889,55.503451350684294,44.496548649315706,Healthcare
66286,28896,37390,43.592915547777814,56.407084452222186,Transportation
231756,18281,213475,7.8880374186644575,92.11196258133553,Entertainment
48094,2345,45749,4.875868091653845,95.12413190834616,Food
13054,3668,9386,28.098667075225986,71.90133292477402,Housing
176184,63743,112441,36.17978931117468,63.82021068882532,Healthcare
96457,33114,63343,34.33032335652156,65.66967664347844,Transportation
176272,31531,144741,17.887696287555595,82.1123037124444,Healthcare
180195,44741,135454,24.829212797247425,75.17078720275258,Entertainment
38244,6158,32086,16.101872189101556,83.89812781089844,Food
21092,8713,12379,41.30950123269486,58.690498767305144,Housing
45189,3603,41586,7.973179313549758,92.02682068645024,Food
206982,58128,148854,28.08360147259182,71.91639852740818,Entertainment
144786,27154,117632,18.75457571864683,81.24542428135317,Healthcare
167784,42361,125423,25.2473418204358,74.75265817956421,Healthcare
241419,44750,196669,18.53623782718013,81.46376217281987,Entertainment
57161,8230,48931,14.397928657651196,85.60207134234881,Food
73876,31943,41933,43.23867020412583,56.76132979587417,Transportation
127494,43958,83536,34.47848526205155,65.52151473794845,Healthcare
39491,12183,27308,30.85006710389709,69.14993289610291,Food
171835,21454,150381,12.485232926935723,87.51476707306428,Healthcare
17264,1608,15656,9.314179796107506,90.6858202038925,Housing
102722,31487,71235,30.652635268004907,69.3473647319951,Transportation
28970,14248,14722,49.18191232309285,50.81808767690714,Housing
18929,2938,15991,15.52115801151672,84.47884198848328,Housing
218666,12819,205847,5.8623654340409574,94.13763456595903,Entertainment
18442,10893,7549,59.0662617937317,40.9337382062683,Housing
119286,53563,65723,44.90300622034438,55.09699377965562,Transportation
218702,454,218248,0.20758840797066327,99.79241159202934,Entertainment
158126,28813,129313,18.22154484398518,81.77845515601483,Healthcare
33093,19624,13469,59.29954975372436,40.70045024627565,Food
134384,68944,65440,51.303726634123116,48.69627336587689,Healthcare
111007,29352,81655,26.441575756483825,73.55842424351617,Transportation
14600,1721,12879,11.787671232876711,88.21232876712328,Housing
29490,8328,21162,28.24008138351984,71.75991861648016,Housing
215113,11175,203938,5.194944052660695,94.8050559473393,Entertainment
228355,43115,185240,18.880690153489084,81.11930984651092,Entertainment
217083,37316,179767,17.189738487122437,82.81026151287756,Entertainment
64507,7108,57399,11.018959182724355,88.98104081727564,Transportation
122648,458,122190,0.37342639097253927,99.62657360902746,Healthcare
42437,3163,39274,7.4534015128307844,92.54659848716922,Food
12341,3355,8986,27.18580341949599,72.814196580504,Housing
64931,4539,60392,6.9904976051500824,93.00950239484992,Transportation
34278,3888,30390,11.342552074216698,88.6574479257833,Food
33425,19340,14085,57.86088257292445,42.13911742707554,Food
179492,62941,116551,35.066186793840394,64.93381320615961,Healthcare
193059,31330,161729,16.228199669531076,83.77180033046892,Entertainment
26024,4317,21707,16.588533661235783,83.41146633876421,Housing
28204,7119,21085,25.241100553113032,74.75889944688696,Housing
45858,6597,39261,14.385712416590342,85.61428758340965,Food
20719,1787,18932,8.624933635793234,91.37506636420677,Housing
217355,23391,193964,10.761657196751857,89.23834280324814,Entertainment
68335,39930,28405,58.43272115314261,41.56727884685739,Transportation
42570,3442,39128,8.085506225041108,91.9144937749589,Food
28494,13188,15306,46.28342809012423,53.71657190987577,Housing
246654,40757,205897,16.523956635611018,83.47604336438899,Entertainment
19456,7502,11954,38.55879934210527,61.44120065789473,Housing
54437,28392,26045,52.15570292264452,47.84429707735548,Food
124984,19470,105514,15.577993983229854,84.42200601677014,Healthcare
49151,8167,40984,16.616142092734634,83.38385790726537,Food
225191,17539,207652,7.788499540390157,92.21150045960984,Entertainment
142411,40286,102125,28.28854512642984,71.71145487357016,Healthcare
26899,14116,12783,52.47778727833749,47.52221272166251,Housing
112019,51673,60346,46.12878172452887,53.87121827547112,Transportation
39781,8188,31593,20.582690229003795,79.4173097709962,Food
153872,17563,136309,11.41403244254965,88.58596755745035,Healthcare
118173,3797,114376,3.2130858994863463,96.78691410051366,Transportation
50021,19713,30308,39.409448031826635,60.590551968173365,Food
26722,7949,18773,29.747024923284187,70.25297507671581,Housing
11505,6054,5451,52.620599739243815,47.37940026075619,Housing
61050,9036,52014,14.800982800982801,85.1990171990172,Transportation
56014,9128,46886,16.295926018495376,83.70407398150462,Food
146496,6094,140402,4.159840541721276,95.84015945827873,Healthcare
190678,52932,137746,27.75988839824206,72.24011160175795,Entertainment
71971,19200,52771,26.677411735282263,73.32258826471774,Transportation
20092,8313,11779,41.374676488154485,58.62532351184551,Housing
43733,25258,18475,57.75501337662634,42.244986623373656,Food
155261,52811,102450,34.014337148414604,65.98566285158539,Healthcare
74714,7466,67248,9.992772438900339,90.00722756109965,Transportation
220556,3659,216897,1.6589891002738535,98.34101089972614,Entertainment
13892,6370,7522,45.853728764756696,54.146271235243304,Housing
165027,30793,134234,18.659370890823926,81.34062910917608,Healthcare
161774,42200,119574,26.08577398098582,73.91422601901418,Healthcare
21307,7459,13848,35.00727460459004,64.99272539540996,Housing
58378,8737,49641,14.96625441090822,85.03374558909178,Food
101057,46869,54188,46.37877633414805,53.62122366585195,Transportation
226851,46013,180838,20.283357798731323,79.71664220126867,Entertainment
170111,66799,103312,39.26788978960796,60.732110210392044,Healthcare
41621,24182,17439,58.10047812402394,41.89952187597607,Food
28478,16730,11748,58.74710302689795,41.25289697310205,Housing
141246,40745,100501,28.846834600625858,71.15316539937415,Healthcare
116195,21496,94699,18.49993545333276,81.50006454666723,Transportation
183514,1690,181824,0.9209106662162014,99.0790893337838,Entertainment
35039,15709,19330,44.8329004823197,55.1670995176803,Food
119624,47841,71783,39.99281080719588,60.00718919280412,Transportation
174718,22057,152661,12.624343227372108,87.37565677262789,Healthcare
129370,22566,106804,17.442992965911728,82.55700703408827,Healthcare
163893,24035,139858,14.665055859615725,85.33494414038427,Healthcare
156647,69351,87296,44.27215331286268,55.727846687137315,Healthcare
178275,50030,128245,28.06338521946431,71.93661478053569,Healthcare
129694,9258,120436,7.138341018088731,92.86165898191126,Healthcare
18465,6154,12311,33.32791768210127,66.67208231789873,Housing
219866,50638,169228,23.031300883265263,76.96869911673474,Entertainment
129546,16548,112998,12.773840952248621,87.22615904775137,Healthcare
60958,16084,44874,26.385380097772238,73.61461990222776,Transportation
65274,38845,26429,59.51067806477312,40.48932193522689,Transportation
108472,37325,71147,34.40980160778819,65.59019839221182,Transportation
20921,4001,16920,19.12432484106878,80.87567515893122,Housing
159293,67159,92134,42.160672471483366,57.839327528516634,Healthcare
12915,7101,5814,54.98257839721254,45.01742160278746,Housing
215016,32813,182203,15.260724783271943,84.73927521672806,Entertainment
24337,10020,14317,41.17187821013272,58.82812178986728,Housing
205745,26717,179028,12.985491749495734,87.01450825050426,Entertainment
226597,64121,162476,28.29737375163837,71.70262624836164,Entertainment
141301,30003,111298,21.233395375828902,78.7666046241711,Healthcare
37177,19726,17451,53.05968744115985,46.94031255884014,Food
190351,32077,158274,16.851500648801423,83.14849935119858,Entertainment
110504,17441,93063,15.7831390718888,84.2168609281112,Transportation
70878,13855,57023,19.547673467084287,80.45232653291572,Transportation
56707,689,56018,1.2150175463346675,98.78498245366534,Food
220511,64989,155522,29.471999129295135,70.52800087070487,Entertainment
23237,5821,17416,25.05056590781943,74.94943409218058,Housing
39498,16191,23307,40.99194895944098,59.00805104055902,Food
90699,47190,43509,52.0292395726524,47.9707604273476,Transportation
12397,329,12068,2.6538678712591754,97.34613212874082,Housing
59863,15237,44626,25.453117952658573,74.54688204734143,Food
118531,68015,50516,57.381613248854734,42.61838675114527,Transportation
137410,6310,131100,4.5920966450767775,95.40790335492322,Healthcare
97796,57119,40677,58.40627428524684,41.59372571475316,Transportation
175943,20873,155070,11.86350124756313,88.13649875243686,Healthcare
51968,25603,26365,49.266856527093594,50.733143472906406,Food
65460,6022,59438,9.199511151848457,90.80048884815155,Transportation
19343,9428,9915,48.74114666804529,51.25885333195471,Housing
113732,5773,107959,5.075968065276264,94.92403193472374,Transportation
73053,24159,48894,33.07051045131617,66.92948954868383,Transportation
157107,37856,119251,24.0956800142578,75.90431998574219,Healthcare
172070,61861,110209,35.95106642645435,64.04893357354565,Healthcare
199422,23305,176117,11.686273329923479,88.31372667007652,Entertainment
140532,43044,97488,30.629322858850657,69.37067714114934,Healthcare
131759,9851,121908,7.476529117555537,92.52347088244446,Healthcare
42648,19061,23587,44.69377227537048,55.30622772462953,Food
154965,52326,102639,33.766334333559186,66.23366566644081,Healthcare
26529,12948,13581,48.80696596177768,51.193034038222315,Housing
62631,8836,53795,14.108029570021236,85.89197042997876,Transportation
19135,7338,11797,38.34857590802195,61.65142409197804,Housing
69331,13050,56281,18.822748842509125,81.17725115749089,Transportation
121472,51214,70258,42.161156480505795,57.83884351949421,Healthcare
61243,32871,28372,53.673072840977746,46.326927159022254,Transportation
63945,13370,50575,20.908593322386427,79.09140667761358,Transportation
47828,20750,27078,43.384628251233586,56.61537174876641,Food
157550,5152,152398,3.2700729927007304,96.72992700729927,Healthcare
169218,65746,103472,38.85284071434481,61.14715928565519,Healthcare
208078,8301,199777,3.9893693711012217,96.01063062889878,Entertainment
214899,35311,179588,16.431439885713754,83.56856011428626,Entertainment
22677,2329,20348,10.270317943290559,89.72968205670944,Housing
14647,8470,6177,57.82754147607019,42.17245852392982,Housing
166543,66730,99813,40.067730255849845,59.932269744150155,Healthcare
169842,20280,149562,11.940509414632423,88.05949058536757,Healthcare
174921,13994,160927,8.000182939727077,91.99981706027293,Healthcare
56098,14311,41787,25.51071339441691,74.48928660558309,Food
189750,1055,188695,0.5559947299077734,99.44400527009223,Entertainment
206079,2102,203977,1.0199971855453491,98.98000281445465,Entertainment
116078,18220,97858,15.696342114784887,84.30365788521512,Transportation
34543,1014,33529,2.935471730886142,97.06452826911386,Food
112000,3940,108060,3.517857142857143,96.48214285714286,Transportation
13235,7432,5803,56.15413675859463,43.84586324140536,Housing
71789,4442,67347,6.187577484015657,93.81242251598434,Transportation
179911,66641,113270,37.04109254020043,62.95890745979956,Healthcare
165109,6179,158930,3.7423762484177123,96.25762375158229,Healthcare
113319,22142,91177,19.539529999382275,80.46047000061772,Transportation
170320,9519,160801,5.588891498356036,94.41110850164395,Healthcare
226357,718,225639,0.3171980544007917,99.68280194559921,Entertainment
45039,12680,32359,28.153378183352206,71.8466218166478,Food
20169,2000,18169,9.916208042044723,90.08379195795527,Housing
46098,3738,42360,8.108811662111155,91.89118833788883,Food
53412,6634,46778,12.420429865947726,87.57957013405228,Food
17495,6909,10586,39.491283223778225,60.50871677622178,Housing
174621,42888,131733,24.56061985671826,75.43938014328174,Healthcare
24501,9056,15445,36.961756662993345,63.03824333700665,Housing
131121,49105,82016,37.45014147238047,62.54985852761953,Healthcare
136535,66309,70226,48.56556926795327,51.434430732046735,Healthcare
178957,3477,175480,1.942924836692613,98.05707516330739,Healthcare
113313,10826,102487,9.554067053206605,90.44593294679339,Transportation
115074,4633,110441,4.026104941168292,95.9738950588317,Transportation
87092,12356,74736,14.187296192532035,85.81270380746795,Transportation
34938,1198,33740,3.4289312496422233,96.57106875035778,Food
17990,3439,14551,19.116175653140633,80.88382434685937,Housing
237075,3286,233789,1.3860592639460088,98.61394073605399,Entertainment
52561,2697,49864,5.131180913605145,94.86881908639485,Food
31863,18215,13648,57.166619590120206,42.833380409879794,Food
173258,6666,166592,3.8474413879878564,96.15255861201214,Healthcare
110806,18126,92680,16.358319946573292,83.64168005342671,Transportation
202416,58053,144363,28.680045055726822,71.31995494427318,Entertainment
156703,65223,91480,41.6220493545114,58.377950645488596,Healthcare
162217,36875,125342,22.731896163780615,77.26810383621938,Healthcare
94260,1312,92948,1.3918947591767452,98.60810524082325,Transportation
93421,18305,75116,19.594095545969324,80.40590445403068,Transportation
29958,9528,20430,31.804526336871618,68.19547366312838,Housing
78095,17552,60543,22.475190473141687,77.52480952685832,Transportation
122867,7376,115491,6.003239274988402,93.9967607250116,Healthcare
181303,4775,176528,2.63371262472215,97.36628737527785,Entertainment
217772,2134,215638,0.9799239571662106,99.0200760428338,Entertainment
43642,3421,40221,7.838779157692131,92.16122084230787,Food
53473,9378,44095,17.537822826473175,82.46217717352683,Food
166655,43097,123558,25.86001020071405,74.13998979928596,Healthcare
22788,7250,15538,31.814990345796033,68.18500965420397,Housing
124537,19382,105155,15.563246264162458,84.43675373583754,Healthcare
218891,30646,188245,14.000575628966013,85.99942437103398,Entertainment
42706,7109,35597,16.646372875005856,83.35362712499415,Food
178683,61095,117588,34.191836940279714,65.80816305972029,Healthcare
30546,16702,13844,54.67819027041184,45.32180972958816,Food
176138,4066,172072,2.3084172637363882,97.69158273626361,Healthcare
171542,60165,111377,35.073043336325796,64.9269566636742,Healthcare
140845,57123,83722,40.557350278675145,59.442649721324855,Healthcare
102378,10663,91715,10.415323604680694,89.5846763953193,Transportation
10282,4713,5569,45.83738572262206,54.16261427737794,Housing
246774,9801,236973,3.9716501738432735,96.02834982615673,Entertainment
116321,10956,105365,9.418763593848059,90.58123640615194,Transportation
95410,46601,48809,48.842888586102085,51.157111413897915,Transportation
208425,8798,199627,4.221182679620967,95.77881732037903,Entertainment
235476,62614,172862,26.590395624182506,73.4096043758175,Entertainment
14879,5940,8939,39.9220377713556,60.0779622286444,Housing
24442,13778,10664,56.37018247279273,43.629817527207265,Housing
143758,56725,87033,39.45867360425159,60.541326395748406,Healthcare
17780,6353,11427,35.73115860517435,64.26884139482564,Housing
122009,63426,58583,51.984689654041915,48.015310345958085,Healthcare
116332,5672,110660,4.875700581095485,95.12429941890451,Transportation
100202,39438,60764,39.35849583840642,60.64150416159359,Transportation
45958,1353,44605,2.9439923408329345,97.05600765916707,Food
102848,4180,98668,4.064250155569384,95.93574984443062,Transportation
146346,69387,76959,47.41298019761388,52.58701980238612,Healthcare
200083,42447,157636,21.214695901201004,78.785304098799,Entertainment
14472,4556,9916,31.48148148148148,68.51851851851852,Housing
153851,46100,107751,29.964056132231836,70.03594386776817,Healthcare
243856,6744,237112,2.7655665638737617,97.23443343612624,Entertainment
158996,45893,113103,28.864248157186346,71.13575184281366,Healthcare
11506,5147,6359,44.733182687293585,55.266817312706415,Housing
236234,15852,220382,6.710295723731555,93.28970427626845,Entertainment
119612,22444,97168,18.764003611677758,81.23599638832223,Transportation
150740,3521,147219,2.3358100039803635,97.66418999601963,Healthcare
15143,7760,7383,51.24479957736248,48.75520042263752,Housing
23535,7096,16439,30.150839175695772,69.84916082430422,Housing
67951,14933,53018,21.97612985828023,78.02387014171977,Transportation
45430,7368,38062,16.218357913273167,83.78164208672683,Food
245693,11767,233926,4.789310236758882,95.21068976324112,Entertainment
25866,14672,11194,56.72311142039743,43.27688857960257,Housing
217592,57840,159752,26.581859627192177,73.41814037280783,Entertainment
42208,14580,27628,34.543214556482184,65.45678544351782,Food
29966,15767,14199,52.616298471601155,47.38370152839885,Housing
35525,11196,24329,31.515833919774806,68.4841660802252,Food
16139,4636,11503,28.72544767333788,71.27455232666212,Housing
138287,39886,98401,28.842913650596223,71.15708634940377,Healthcare
89915,29634,60281,32.95779347161208,67.04220652838792,Transportation
219258,51282,167976,23.388884328051883,76.61111567194811,Entertainment
181141,24317,156824,13.424348987805079,86.57565101219492,Entertainment
174066,1439,172627,0.8266979191800812,99.17330208081991,Healthcare
139526,66932,72594,47.970987486203285,52.029012513796715,Healthcare
78785,1815,76970,2.3037380211969283,97.69626197880307,Transportation
186486,25037,161449,13.425672704653433,86.57432729534656,Entertainment
52713,21738,30975,41.238404188720054,58.76159581127995,Food
206344,36988,169356,17.925406117938973,82.07459388206102,Entertainment
135003,6494,128509,4.810263475626467,95.18973652437353,Healthcare
25355,4592,20763,18.110826267008477,81.88917373299151,Housing
140612,32695,107917,23.2519272892783,76.7480727107217,Healthcare
248984,13591,235393,5.458583684092151,94.54141631590784,Entertainment
206270,38582,167688,18.704610462015804,81.29538953798419,Entertainment
24676,12357,12319,50.076997892689256,49.92300210731075,Housing
47509,26007,21502,54.74120692921341,45.25879307078659,Food
176964,22167,154797,12.526276530819827,87.47372346918017,Healthcare
101404,18130,83274,17.878979132973058,82.12102086702694,Transportation
201295,51739,149556,25.70307260488338,74.29692739511663,Entertainment
155078,61876,93202,39.8999213299114,60.1000786700886,Healthcare
56737,19670,37067,34.668734688122385,65.3312653118776,Food
139308,4473,134835,3.2108708760444484,96.78912912395555,Healthcare
210327,43630,166697,20.743889277173164,79.25611072282683,Entertainment
146922,5879,141043,4.001442942513714,95.9985570574863,Healthcare
144212,29272,114940,20.297894766038887,79.70210523396112,Healthcare
156358,40280,116078,25.761393724657516,74.23860627534248,Healthcare
16934,2961,13973,17.485532065666707,82.5144679343333,Housing
87765,28940,58825,32.97442032700963,67.02557967299038,Transportation
154052,53955,100097,35.02388803780542,64.97611196219458,Healthcare
78067,30263,47804,38.76541944739775,61.234580552602246,Transportation
10389,3891,6498,37.45307536817788,62.54692463182212,Housing
45952,22023,23929,47.92609679665738,52.07390320334262,Food
64611,20319,44292,31.4482054139388,68.55179458606119,Transportation
215460,60413,155047,28.039079179430054,71.96092082056994,Entertainment
96779,23750,73029,24.54044782442472,75.45955217557528,Transportation
199055,36414,162641,18.29343648740298,81.70656351259701,Entertainment
15857,3560,12297,22.45065270858296,77.54934729141704,Housing
212565,14159,198406,6.661021334650577,93.33897866534943,Entertainment
162911,44185,118726,27.12217100134429,72.8778289986557,Healthcare
159935,31152,128783,19.477912902116483,80.52208709788351,Healthcare
163207,31225,131982,19.132145067307164,80.86785493269284,Healthcare
88297,18184,70113,20.59413117093446,79.40586882906554,Transportation
148625,45092,103533,30.339444911690492,69.66055508830951,Healthcare
123778,58161,65617,46.9881562151594,53.01184378484061,Healthcare
144771,55000,89771,37.991034115948636,62.00896588405136,Healthcare
93556,38077,55479,40.699687887468464,59.30031211253153,Transportation
102965,52706,50259,51.18826785801001,48.81173214198999,Transportation
167691,29613,138078,17.659266150240622,82.34073384975939,Healthcare
75969,2193,73776,2.8867037870710424,97.11329621292896,Transportation
249686,4454,245232,1.7838405036726128,98.21615949632738,Entertainment
94606,17091,77515,18.06545039426675,81.93454960573325,Transportation
165203,25917,139286,15.687971768067166,84.31202823193283,Healthcare
42484,4697,37787,11.055926937199887,88.94407306280011,Food
202117,3439,198678,1.701489731195298,98.2985102688047,Entertainment
40670,10068,30602,24.755347922301453,75.24465207769855,Food
18110,1496,16614,8.260629486471563,91.73937051352844,Housing
14470,886,13584,6.123013130615066,93.87698686938494,Housing
37045,13758,23287,37.13861519773249,62.861384802267516,Food
88640,47226,41414,53.27842960288809,46.72157039711191,Transportation
91057,6703,84354,7.361323127271928,92.63867687272807,Transportation
37770,14449,23321,38.25522901773895,61.74477098226105,Food
212722,6754,205968,3.1750359624298383,96.82496403757015,Entertainment
147234,68260,78974,46.36157409294049,53.638425907059506,Healthcare
42642,4965,37677,11.643450119600395,88.3565498803996,Food
30165,1574,28591,5.2179678435272665,94.78203215647272,Food
25692,6808,18884,26.498520940370547,73.50147905962946,Housing
20497,816,19681,3.9810704005464217,96.01892959945359,Housing
132987,15598,117389,11.728965989156835,88.27103401084317,Healthcare
155017,67726,87291,43.68940180754369,56.310598192456304,Healthcare
36629,14088,22541,38.46132845559529,61.53867154440471,Food
20258,6980,13278,34.45552374370619,65.5444762562938,Housing
16535,1197,15338,7.2391895978228,92.7608104021772,Housing
193001,25569,167432,13.248117885399557,86.75188211460045,Entertainment
77617,27531,50086,35.470322223224294,64.52967777677571,Transportation
35185,9820,25365,27.909620576950406,72.0903794230496,Food
235750,25625,210125,10.869565217391305,89.13043478260869,Entertainment
132549,51692,80857,38.998408135859194,61.001591864140806,Healthcare
80889,4487,76402,5.547107764961861,94.45289223503815,Transportation
166229,54582,111647,32.83542582822492,67.16457417177509,Healthcare
144820,52552,92268,36.28780555171937,63.71219444828063,Healthcare
10094,2831,7263,28.04636417673866,71.95363582326134,Housing
89076,45899,43177,51.527908752076875,48.472091247923125,Transportation
47886,18732,29154,39.11790502443303,60.88209497556697,Food
73795,43721,30074,59.246561420150414,40.75343857984958,Transportation
219687,46914,172773,21.35492769258081,78.6450723074192,Entertainment
85051,44076,40975,51.82302383275916,48.17697616724083,Transportation
24929,12693,12236,50.91660315295439,49.083396847045606,Housing
244265,55541,188724,22.73800994821198,77.26199005178802,Entertainment
246455,30154,216301,12.235093627639934,87.76490637236006,Entertainment
113289,37843,75446,33.40394919188977,66.59605080811023,Transportation
39604,1297,38307,3.2749217250782747,96.72507827492173,Food
28802,1663,27139,5.773904589959031,94.22609541004097,Housing
19958,11551,8407,57.876540735544644,42.123459264455356,Housing
18108,3834,14274,21.17296222664016,78.82703777335985,Housing
199581,59275,140306,29.69972091531759,70.3002790846824,Entertainment
16916,3370,13546,19.921967368172144,80.07803263182785,Housing
30117,15605,14512,51.814589766577015,48.185410233422985,Food
13118,4036,9082,30.76688519591401,69.233114804086,Housing
14134,6781,7353,47.97651054195557,52.02348945804444,Housing
44704,3772,40932,8.437723693629206,91.56227630637079,Food
241631,23345,218286,9.66142589320079,90.33857410679921,Entertainment
24247,10039,14208,41.40306017239246,58.59693982760754,Housing
225512,3491,222021,1.5480329206428038,98.45196707935719,Entertainment
176886,49420,127466,27.938898499598615,72.06110150040139,Healthcare
236284,68623,167661,29.042592812039747,70.95740718796026,Entertainment
24480,6322,18158,25.825163398692812,74.17483660130719,Housing
245100,67553,177547,27.56140350877193,72.43859649122807,Entertainment
43076,7756,35320,18.005385829696348,81.99461417030365,Food
175749,26923,148826,15.319006082538165,84.68099391746183,Healthcare
72387,23673,48714,32.70338596709354,67.29661403290646,Transportation
27278,1669,25609,6.118483759806438,93.88151624019356,Housing
20281,11662,8619,57.50209555741827,42.49790444258173,Housing
14973,7245,7728,48.38709677419355,51.61290322580645,Housing
94908,41582,53326,43.812955704471705,56.187044295528295,Transportation
78287,7012,71275,8.956787206049535,91.04321279395047,Transportation
55007,668,54339,1.2143908957041831,98.78560910429582,Food
126983,33168,93815,26.120031815282363,73.87996818471764,Healthcare
242321,23578,218743,9.73006879304724,90.26993120695276,Entertainment
43895,8575,35320,19.535254584804647,80.46474541519535,Food
116716,14176,102540,12.145721237876556,87.85427876212346,Transportation
121012,25587,95425,21.14418404786302,78.85581595213698,Healthcare
17501,9281,8220,53.03125535683675,46.96874464316325,Housing
27576,3358,24218,12.17725558456629,87.8227444154337,Housing
51285,16504,34781,32.18094959539827,67.81905040460174,Food
172614,13291,159323,7.699838947014727,92.30016105298527,Healthcare
15571,2741,12830,17.603236786333568,82.39676321366643,Housing
30125,3361,26764,11.156846473029045,88.84315352697095,Food
104048,9303,94745,8.941065662002153,91.05893433799784,Transportation
80815,27228,53587,33.69176514260966,66.30823485739033,Transportation
46326,513,45813,1.1073695117212796,98.89263048827873,Food
172379,59852,112527,34.72116673144641,65.2788332685536,Healthcare
46488,22297,24191,47.96291516090174,52.037084839098256,Food
30555,18186,12369,59.51890034364261,40.48109965635739,Food
192541,57793,134748,30.01594465594341,69.9840553440566,Entertainment
110774,40411,70363,36.480582086049075,63.519417913950925,Transportation
169485,45510,123975,26.851933799451277,73.14806620054873,Healthcare
57254,8043,49211,14.047926782408215,85.95207321759179,Food
16428,3166,13262,19.271974677380083,80.72802532261991,Housing
59084,31701,27383,53.65411955859455,46.345880441405455,Food
16563,7243,9320,43.73000060375536,56.26999939624464,Housing
27041,9575,17466,35.409193446987906,64.59080655301209,Housing
224134,26601,197533,11.868346614079078,88.13165338592093,Entertainment
96044,34213,61831,35.62221481820832,64.37778518179168,Transportation
155772,64737,91035,41.55881673214699,58.44118326785301,Healthcare
33823,15145,18678,44.77722260000591,55.22277739999409,Food
100538,24289,76249,24.159024448467246,75.84097555153275,Transportation
208973,23891,185082,11.432577414307111,88.5674225856929,Entertainment
38468,16402,22066,42.63803680981595,57.36196319018405,Food
15879,1230,14649,7.746079727942566,92.25392027205743,Housing
105695,41018,64677,38.80789062869577,61.19210937130423,Transportation
249904,54005,195899,21.610298354568155,78.38970164543184,Entertainment
156819,7626,149193,4.862931149924435,95.13706885007556,Healthcare
245714,59169,186545,24.080434977249972,75.91956502275002,Entertainment
24257,4642,19615,19.13674403265037,80.86325596734963,Housing
122861,11248,111613,9.155061410862682,90.84493858913731,Healthcare
221411,60018,161393,27.10705430172846,72.89294569827153,Entertainment
96903,20661,76242,21.32132132132132,78.67867867867868,Transportation
29597,3598,25999,12.156637497043619,87.84336250295638,Housing
88529,34739,53790,39.240248957968575,60.75975104203143,Transportation
174999,5129,169870,2.9308738907079466,97.06912610929204,Healthcare
14872,3931,10941,26.43222162452932,73.56777837547068,Housing
49158,20540,28618,41.78363643760934,58.21636356239066,Food
29218,10285,18933,35.20090355260456,64.79909644739544,Housing
53294,8432,44862,15.821668480504373,84.17833151949563,Food
117446,53418,64028,45.483030499123004,54.516969500876996,Transportation
18081,341,17740,1.8859576350865548,98.11404236491344,Housing
210727,22147,188580,10.509806526928205,89.4901934730718,Entertainment
14401,2329,12072,16.172488021665163,83.82751197833484,Housing
214065,67691,146374,31.621703688132108,68.3782963118679,Entertainment
133615,25982,107633,19.445421546982,80.554578453018,Healthcare
28545,282,28263,0.9879138202837624,99.01208617971623,Housing
242556,7761,234795,3.1996734774649975,96.800326522535,Entertainment
162088,49490,112598,30.53279699916095,69.46720300083905,Healthcare
105370,57925,47445,54.972952453259936,45.02704754674006,Transportation
59831,9726,50105,16.25578713376009,83.7442128662399,Food
22255,7790,14465,35.00337002920692,64.99662997079308,Housing
52954,19184,33770,36.227669297881185,63.772330702118815,Food
19888,7248,12640,36.44408688656476,63.55591311343524,Housing
227388,45582,181806,20.04591271307193,79.95408728692807,Entertainment
239960,368,239592,0.15335889314885814,99.84664110685114,Entertainment
168032,17529,150503,10.431941534945723,89.56805846505428,Healthcare
10851,5851,5000,53.92129757626025,46.07870242373975,Housing
125910,21259,104651,16.884282423953618,83.11571757604638,Healthcare
47291,6616,40675,13.989976951216935,86.01002304878307,Food
10109,2466,7643,24.39410426352755,75.60589573647245,Housing
19846,4162,15684,20.97148039907286,79.02851960092714,Housing
228770,64248,164522,28.084101936442718,71.91589806355728,Entertainment
76810,16140,60670,21.012888946751726,78.98711105324827,Transportation
56087,3694,52393,6.586196444808958,93.41380355519104,Food
45712,8601,37111,18.81562828141407,81.18437171858594,Food
218234,56854,161380,26.051852598586837,73.94814740141317,Entertainment
124727,14752,109975,11.827431109543243,88.17256889045676,Healthcare
87156,42985,44171,49.319610812795446,50.680389187204554,Transportation
29076,5214,23862,17.932315311597193,82.0676846884028,Housing
102800,7356,95444,7.155642023346304,92.8443579766537,Transportation
216812,14644,202168,6.754238695275169,93.24576130472482,Entertainment
118817,34584,84233,29.106945975744214,70.89305402425579,Transportation
50999,23592,27407,46.259730582952606,53.740269417047394,Food
243315,27458,215857,11.284959825740296,88.71504017425971,Entertainment
148009,54921,93088,37.10652730577195,62.89347269422806,Healthcare
143790,23569,120221,16.391265039293415,83.60873496070658,Healthcare
23082,7686,15396,33.298674291655836,66.70132570834416,Housing
187671,6774,180897,3.6095081285867288,96.39049187141327,Entertainment
41388,12305,29083,29.73083985696337,70.26916014303663,Food
68740,35682,33058,51.908641256910094,48.0913587430899,Transportation
82644,45784,36860,55.39906103286385,44.60093896713615,Transportation
192349,7810,184539,4.060327841579628,95.93967215842038,Entertainment
67349,8090,59259,12.012056600691919,87.98794339930808,Transportation
203315,61790,141525,30.39126478616925,69.60873521383076,Entertainment
234573,56524,178049,24.09654990131004,75.90345009868996,Entertainment
43849,18992,24857,43.31227622066638,56.68772377933362,Food
125344,21012,104332,16.763466938983917,83.23653306101608,Healthcare
36920,6612,30308,17.908992416034668,82.09100758396532,Food
213656,27449,186207,12.847287228067547,87.15271277193246,Entertainment
19920,6551,13369,32.886546184738954,67.11345381526105,Housing
70221,35922,34299,51.155637202546245,48.844362797453755,Transportation
150550,15078,135472,10.015277316506143,89.98472268349386,Healthcare
182191,65443,116748,35.919996048103364,64.08000395189663,Entertainment
141031,41728,99303,29.587821117342994,70.412178882657,Healthcare
180644,16808,163836,9.304488385996768,90.69551161400324,Entertainment
64870,5699,59171,8.785262833359026,91.21473716664097,Transportation
66754,21048,45706,31.530694789825333,68.46930521017467,Transportation
223966,14935,209031,6.668422885616566,93.33157711438344,Entertainment
57958,9126,48832,15.745884951171538,84.25411504882845,Food
29699,15232,14467,51.287922152261025,48.71207784773898,Housing
248767,45639,203128,18.34608288076795,81.65391711923206,Entertainment
237825,10666,227159,4.484810259644697,95.5151897403553,Entertainment
129221,68683,60538,53.151577529968044,46.848422470031956,Healthcare
52511,26943,25568,51.30924949058292,48.69075050941707,Food
147099,55228,91871,37.54478276534851,62.45521723465149,Healthcare
57646,18090,39556,31.38118863407695,68.61881136592305,Food
184239,53527,130712,29.053023518364736,70.94697648163528,Entertainment
72189,3885,68304,5.38170635415368,94.61829364584632,Transportation
21590,4773,16817,22.10745715609078,77.89254284390921,Housing
13188,4583,8605,34.751289050652105,65.24871094934788,Housing
135884,11827,124057,8.703747313885373,91.29625268611463,Healthcare
113996,7434,106562,6.521281448471876,93.47871855152813,Transportation
110138,61195,48943,55.56211298552724,44.43788701447276,Transportation
28651,7075,21576,24.693727967610204,75.3062720323898,Housing
24397,1158,23239,4.746485223593065,95.25351477640693,Housing
21711,8942,12769,41.186495324950485,58.81350467504951,Housing
27484,16170,11314,58.83423082520739,41.16576917479261,Housing
13393,2567,10826,19.166728888225194,80.8332711117748,Housing
85263,935,84328,1.0966069690252513,98.90339303097475,Transportation
29337,16856,12481,57.456454306848,42.54354569315199,Housing
74978,20333,54645,27.118621462295607,72.88137853770439,Transportation
71491,27400,44091,38.32650263669553,61.67349736330448,Transportation
239575,23266,216309,9.711363873526036,90.28863612647396,Entertainment
48010,26476,21534,55.14684440741512,44.853155592584876,Food
127803,20258,107545,15.850958115224213,84.14904188477578,Healthcare
136157,69764,66393,51.23790917837496,48.76209082162504,Healthcare
128172,29956,98216,23.37171925225478,76.62828074774521,Healthcare
63312,8735,54577,13.796752590346223,86.20324740965378,Transportation
139809,5323,134486,3.8073371528299322,96.19266284717007,Healthcare
32811,14798,18013,45.100728414251314,54.89927158574868,Food
107968,18189,89779,16.846658269116777,83.15334173088323,Transportation
39739,23516,16223,59.17612421047333,40.82387578952666,Food
18978,3968,15010,20.90842027610918,79.09157972389083,Housing
33276,16895,16381,50.772328404856346,49.22767159514365,Food
46532,27430,19102,58.94868047795065,41.05131952204934,Food
24551,5805,18746,23.64465805873488,76.35534194126512,Housing
173252,9650,163602,5.569921270750122,94.43007872924987,Healthcare
177398,4412,172986,2.4870629883087747,97.51293701169122,Healthcare
243506,9202,234304,3.778962325363646,96.22103767463635,Entertainment
42224,17296,24928,40.962485790071995,59.037514209928,Food
145415,32950,112465,22.659285493243473,77.34071450675653,Healthcare
79494,23148,56346,29.11917880594762,70.88082119405237,Transportation
45235,15390,29845,34.02232784348403,65.97767215651598,Food
28578,12542,16036,43.88690601161733,56.113093988382666,Housing
50475,12453,38022,24.671619613670135,75.32838038632987,Food
114876,66180,48696,57.60994463595529,42.39005536404471,Transportation
122418,37765,84653,30.849221519711158,69.15077848028885,Healthcare
245271,23708,221563,9.666042866869708,90.3339571331303,Entertainment
156694,11405,145289,7.278517365055459,92.72148263494454,Healthcare
177556,25679,151877,14.462479443105275,85.53752055689473,Healthcare
99066,54228,44838,54.73926473260251,45.26073526739749,Transportation
173934,17495,156439,10.05841296123817,89.94158703876182,Healthcare
220409,38288,182121,17.37134146064816,82.62865853935185,Entertainment
31231,18465,12766,59.12394735999488,40.87605264000512,Food
142727,15790,126937,11.063078464481142,88.93692153551885,Healthcare
131240,24875,106365,18.953825053337397,81.0461749466626,Healthcare
22154,7772,14382,35.08170082152207,64.91829917847792,Housing
233881,50517,183364,21.59944587204604,78.40055412795395,Entertainment
14864,8120,6744,54.628632938643705,45.3713670613563,Housing
94599,16755,77844,17.71160371674119,82.28839628325882,Transportation
80496,43293,37203,53.78279666070364,46.21720333929636,Transportation
21490,458,21032,2.1312238250349,97.8687761749651,Housing
67801,36827,30974,54.31630801905577,45.68369198094423,Transportation
41932,19746,22186,47.09052752074788,52.909472479252116,Food
231805,26069,205736,11.246090463967558,88.75390953603244,Entertainment
84530,3307,81223,3.9122205134271857,96.08777948657281,Transportation
69564,26225,43339,37.6990972342016,62.300902765798405,Transportation
85727,2918,82809,3.4038284321159025,96.5961715678841,Transportation
49422,862,48560,1.744162518716361,98.25583748128363,Food
38453,15544,22909,40.42337398902556,59.57662601097443,Food
180512,15891,164621,8.803292855876618,91.19670714412338,Entertainment
135556,57108,78448,42.12871433208416,57.87128566791584,Healthcare
77079,13863,63216,17.98544350601331,82.01455649398669,Transportation
39417,11089,28328,28.132531648780983,71.86746835121902,Food
20843,10124,10719,48.572662284699895,51.427337715300105,Housing
244626,42846,201780,17.514900296779572,82.48509970322043,Entertainment
26563,4650,21913,17.505552836652484,82.49444716334752,Housing
200116,46777,153339,23.374942533330668,76.62505746666933,Entertainment
117499,17034,100465,14.497144656550267,85.50285534344974,Transportation
217802,64925,152877,29.809184488664016,70.19081551133598,Entertainment
45837,3148,42689,6.867814211226738,93.13218578877326,Food
38055,3886,34169,10.211535934831167,89.78846406516884,Food
238050,68186,169864,28.643562276832597,71.3564377231674,Entertainment
142777,25841,116936,18.09885345678926,81.90114654321074,Healthcare
20369,5981,14388,29.36324807305219,70.63675192694781,Housing
222872,18738,204134,8.407516421982123,91.59248357801788,Entertainment
221582,13840,207742,6.245994710761704,93.7540052892383,Entertainment
60529,28560,31969,47.18399444894183,52.81600555105817,Transportation
93786,4946,88840,5.273708229373255,94.72629177062674,Transportation
175785,36103,139682,20.538157408197513,79.4618425918025,Healthcare
98117,52171,45946,53.17223315021862,46.82776684978138,Transportation
213630,67916,145714,31.79141506342742,68.20858493657258,Entertainment
31760,15433,16327,48.59256926952141,51.40743073047859,Food
47597,25571,22026,53.72397420005463,46.27602579994537,Food
104581,2134,102447,2.040523613275834,97.95947638672416,Transportation
45732,23646,22086,51.705589084229864,48.29441091577014,Food
196060,40345,155715,20.577884321126184,79.42211567887382,Entertainment
163808,1251,162557,0.7636989646415315,99.23630103535847,Healthcare
175276,9276,166000,5.292224833976129,94.70777516602386,Healthcare
166865,11581,155284,6.940340994216881,93.05965900578312,Healthcare
96790,53638,43152,55.41688190928815,44.58311809071185,Transportation
232652,51284,181368,22.0432233550539,77.9567766449461,Entertainment
171472,6335,165137,3.6944807315480075,96.30551926845199,Healthcare
18106,1080,17026,5.964873522589197,94.0351264774108,Housing
243455,54577,188878,22.417695261958063,77.58230473804194,Entertainment
110474,10280,100194,9.305356916559553,90.69464308344045,Transportation
76543,1591,74952,2.078570215434462,97.92142978456553,Transportation
40712,8935,31777,21.946846138730596,78.05315386126941,Food
11902,3599,8303,30.238615358763234,69.76138464123677,Housing
17832,6787,11045,38.06078959174518,61.939210408254816,Housing
67150,25304,41846,37.68279970215935,62.31720029784066,Transportation
176737,67702,109035,38.306636414559485,61.69336358544051,Healthcare
123967,52322,71645,42.206393637016305,57.793606362983695,Healthcare
152776,34325,118451,22.467534167670316,77.53246583232969,Healthcare
222803,46544,176259,20.890203453274868,79.10979654672514,Entertainment
32068,71,31997,0.22140451540476488,99.77859548459523,Food
188834,39115,149719,20.713960409671987,79.28603959032802,Entertainment
35172,9226,25946,26.231092914818603,73.7689070851814,Food
106165,7833,98332,7.378137804361136,92.62186219563885,Transportation
155882,43816,112066,28.108441000243772,71.89155899975623,Healthcare
56267,2044,54223,3.6326799011854196,96.36732009881457,Food
68869,32339,36530,46.95726669473929,53.04273330526071,Transportation
38288,17210,21078,44.948809026326785,55.051190973673215,Food
134303,7691,126612,5.726603277663194,94.27339672233681,Healthcare
78380,37033,41347,47.24802245470784,52.75197754529216,Transportation
10717,560,10157,5.225342913128674,94.77465708687133,Housing
31586,17286,14300,54.726777686316716,45.27322231368328,Food
134160,61427,72733,45.78637447823494,54.21362552176505,Healthcare
160652,1564,159088,0.9735328536214924,99.02646714637851,Healthcare
14727,4234,10493,28.74991512188497,71.25008487811503,Housing
38024,14907,23117,39.204186829370926,60.795813170629074,Food
37760,3433,34327,9.091631355932202,90.90836864406779,Food
178972,21199,157773,11.84486958853899,88.15513041146102,Healthcare
42291,13633,28658,32.23617318105507,67.76382681894492,Food
37039,19562,17477,52.81460082615621,47.185399173843784,Food
68287,10343,57944,15.1463675370129,84.8536324629871,Transportation
85076,39509,45567,46.43965395646246,53.56034604353754,Transportation
18020,584,17436,3.240843507214206,96.75915649278579,Housing
135267,27379,107888,20.240709116044563,79.75929088395543,Healthcare
30199,4737,25462,15.685949865889597,84.3140501341104,Food
85501,9119,76382,10.665372334826493,89.3346276651735,Transportation
51836,21869,29967,42.18882629832549,57.81117370167451,Food
242558,43088,199470,17.76399871370971,82.23600128629029,Entertainment
171160,26949,144211,15.744917036690817,84.25508296330918,Healthcare
82589,35091,47498,42.48870915012895,57.511290849871045,Transportation
17447,5146,12301,29.49504212758641,70.5049578724136,Housing
82761,10152,72609,12.266647333889152,87.73335266611085,Transportation
26104,11844,14260,45.3723567269384,54.6276432730616,Housing
51285,17593,33692,34.304377498293846,65.69562250170615,Food
18936,6962,11974,36.76594845796367,63.234051542036326,Housing
17524,1481,16043,8.451266834056153,91.54873316594386,Housing
48503,4876,43627,10.052986413211555,89.94701358678844,Food
232905,14603,218302,6.269938386895944,93.73006161310406,Entertainment
27056,4050,23006,14.96895328208161,85.03104671791839,Housing
70530,1469,69061,2.082801644690203,97.9171983553098,Transportation
81648,34140,47508,41.81363903586126,58.18636096413874,Transportation
15873,6270,9603,39.5010395010395,60.4989604989605,Housing
77842,14628,63214,18.791911821381774,81.20808817861823,Transportation
107188,63420,43768,59.16707094077695,40.83292905922305,Transportation
35375,7363,28012,20.814134275618372,79.18586572438161,Food
42101,10863,31238,25.802237476544498,74.1977625234555,Food
67039,8451,58588,12.606094959650353,87.39390504034965,Transportation
51411,8724,42687,16.969131119799265,83.03086888020074,Food
178364,50674,127690,28.410441568926466,71.58955843107353,Healthcare
82397,26979,55418,32.74269694284986,67.25730305715014,Transportation
141256,5712,135544,4.043722036586057,95.95627796341394,Healthcare
111416,55225,56191,49.566489552667484,50.433510447332516,Transportation
117235,69851,47384,59.58203608137501,40.417963918624984,Transportation
219988,4775,215213,2.1705729403422005,97.8294270596578,Entertainment
38862,11978,26884,30.821882558797796,69.1781174412022,Food
18367,1403,16964,7.638699842108129,92.36130015789186,Housing
219756,57890,161866,26.34285298239866,73.65714701760135,Entertainment
14635,7452,7183,50.91902972326614,49.08097027673386,Housing
10855,4712,6143,43.40856748042376,56.59143251957624,Housing
43908,4994,38914,11.373781543226746,88.62621845677326,Food
53446,11418,42028,21.363619354114434,78.63638064588557,Food
123085,23125,99960,18.787829548685867,81.21217045131414,Healthcare
74337,32762,41575,44.07226549363036,55.92773450636964,Transportation
232466,1469,230997,0.6319203668493457,99.36807963315066,Entertainment
115220,43861,71359,38.067175837528204,61.93282416247179,Transportation
96283,51234,45049,53.21188579500016,46.78811420499984,Transportation
167848,21633,146215,12.888446689862256,87.11155331013775,Healthcare
227142,61508,165634,27.079095895959355,72.92090410404064,Entertainment
103842,10123,93719,9.74846401263458,90.25153598736541,Transportation
217269,28773,188496,13.243030528975602,86.7569694710244,Entertainment
124083,27236,96847,21.949823908190485,78.05017609180952,Healthcare
31236,4226,27010,13.529261108976822,86.47073889102317,Food
82693,2456,80237,2.970021646330403,97.0299783536696,Transportation
212712,64503,148209,30.324100191808647,69.67589980819136,Entertainment
156763,16910,139853,10.786984173561363,89.21301582643864,Healthcare
25322,6297,19025,24.86770397282995,75.13229602717006,Housing
149639,33395,116244,22.317043016860577,77.68295698313942,Healthcare
185951,27190,158761,14.622131636829058,85.37786836317093,Entertainment
196985,30625,166360,15.546869050942966,84.45313094905703,Entertainment
26589,4398,22191,16.540674715107752,83.45932528489224,Housing
234152,33065,201087,14.121169155078753,85.87883084492125,Entertainment
16649,7861,8788,47.21604901195267,52.78395098804734,Housing
173046,31331,141715,18.105590421044116,81.89440957895589,Healthcare
172522,44744,127778,25.935243041467178,74.06475695853283,Healthcare
218188,26301,191887,12.054283461968577,87.94571653803143,Entertainment
60860,24641,36219,40.488005257969114,59.51199474203089,Transportation
12654,2213,10441,17.4885411727517,82.51145882724829,Housing
23805,8986,14819,37.74837219071623,62.25162780928376,Housing
128760,25864,102896,20.0869835352594,79.91301646474061,Healthcare
92656,5941,86715,6.41188913831808,93.58811086168191,Transportation
114213,56674,57539,49.62132156584627,50.378678434153734,Transportation
50646,3106,47540,6.132764680330135,93.86723531966986,Food
132984,4691,128293,3.5274920291162846,96.47250797088371,Healthcare
40069,17992,22077,44.90254311312985,55.09745688687014,Food
27224,11834,15390,43.46899794299148,56.531002057008514,Housing
241919,3312,238607,1.3690532781633522,98.63094672183664,Entertainment
40202,1993,38209,4.957464802746132,95.04253519725387,Food
180217,18870,161347,10.47071031034808,89.52928968965192,Entertainment
206083,59046,147037,28.651562719875002,71.348437280125,Entertainment
133394,58500,74894,43.85504595409089,56.14495404590911,Healthcare
138846,20244,118602,14.580182360312865,85.41981763968714,Healthcare
98918,46914,52004,47.42716189166784,52.57283810833216,Transportation
109046,10507,98539,9.635383232764154,90.36461676723584,Transportation
47069,19202,27867,40.79542798869745,59.20457201130256,Food
114045,34723,79322,30.446753474505677,69.55324652549433,Transportation
205123,67029,138094,32.677466690717274,67.32253330928273,Entertainment
75686,33445,42241,44.18914990883386,55.81085009116613,Transportation
115984,37588,78396,32.40791833356325,67.59208166643675,Transportation
89004,50693,38311,56.95586715203811,43.04413284796189,Transportation
39928,13500,26428,33.81085954718493,66.18914045281507,Food
82617,32362,50255,39.171114903712315,60.828885096287685,Transportation
88220,16338,71882,18.51961006574473,81.48038993425527,Transportation
114579,30002,84577,26.184553888583423,73.81544611141658,Transportation
20094,3412,16682,16.980193092465413,83.01980690753459,Housing
210249,60595,149654,28.820588920755863,71.17941107924413,Entertainment
189106,36149,152957,19.115734032764692,80.88426596723531,Entertainment
56393,5084,51309,9.01530331778767,90.98469668221233,Food
43246,18631,24615,43.08144105813254,56.91855894186746,Food
58486,28152,30334,48.13459631364771,51.86540368635229,Food
216127,25967,190160,12.014695063550597,87.98530493644941,Entertainment
61709,24636,37073,39.92286376379459,60.07713623620542,Transportation
52878,10946,41932,20.700480350996635,79.29951964900337,Food
15094,4716,10378,31.244202994567377,68.75579700543261,Housing
31056,1844,29212,5.937660999484802,94.0623390005152,Food
82182,29298,52884,35.650142366941665,64.34985763305833,Transportation
224968,14750,210218,6.556488033853704,93.4435119661463,Entertainment
229201,54621,174580,23.83104785755734,76.16895214244266,Entertainment
177429,56847,120582,32.039294591075866,67.96070540892414,Healthcare
25735,2185,23550,8.490382747231397,91.5096172527686,Housing
249907,13306,236601,5.324380669609095,94.6756193303909,Entertainment
54826,2733,52093,4.984861197242185,95.01513880275782,Food
27363,12125,15238,44.311661732997116,55.68833826700289,Housing
50141,18155,31986,36.207893739654175,63.792106260345825,Food
153863,30553,123310,19.8572756283187,80.1427243716813,Healthcare
25859,12710,13149,49.15116593835801,50.84883406164198,Housing
228670,39535,189135,17.289106572790484,82.71089342720953,Entertainment
188163,14738,173425,7.832570696683194,92.16742930331681,Entertainment
10881,2328,8553,21.395092362834298,78.6049076371657,Housing
195929,4482,191447,2.2875633520305825,97.71243664796941,Entertainment
79617,9450,70167,11.869324390519614,88.13067560948039,Transportation
28568,9253,19315,32.389386726407174,67.61061327359283,Housing
86062,39749,46313,46.18647021914434,53.81352978085566,Transportation
177509,21751,155758,12.25346320468258,87.74653679531743,Healthcare
122881,28585,94296,23.26234324264939,76.7376567573506,Healthcare
13434,6708,6726,49.933005806163465,50.066994193836535,Housing
41987,11448,30539,27.265582204015526,72.73441779598447,Food
157748,69344,88404,43.95871896949565,56.04128103050435,Healthcare
128163,24350,103813,18.999243151299517,81.00075684870049,Healthcare
46953,28023,18930,59.683087342661814,40.316912657338186,Food
119273,39763,79510,33.33780486782423,66.66219513217577,Transportation
232988,49113,183875,21.079626418527994,78.920373581472,Entertainment
11649,3656,7993,31.38466821186368,68.61533178813633,Housing
127889,22361,105528,17.48469375786815,82.51530624213184,Healthcare
23422,2068,21354,8.829305780889761,91.17069421911023,Housing
32512,5256,27256,16.166338582677163,83.83366141732283,Food
96511,20249,76262,20.981028069339246,79.01897193066075,Transportation
40529,18554,21975,45.779565249574375,54.22043475042562,Food
49194,13963,35231,28.38354270846038,71.61645729153962,Food
21046,7569,13477,35.964078684785704,64.0359213152143,Housing
240658,55132,185526,22.90885821373069,77.09114178626932,Entertainment
240555,28891,211664,12.010143210492403,87.9898567895076,Entertainment
52863,2031,50832,3.842006696555247,96.15799330344475,Food
36537,290,36247,0.7937159591646824,99.20628404083531,Food
239494,45889,193605,19.160814049621287,80.8391859503787,Entertainment
26739,11489,15250,42.96720146602341,57.03279853397659,Housing
88092,10039,78053,11.396040503110385,88.60395949688962,Transportation
200743,67611,133132,33.68037739796655,66.31962260203345,Entertainment
33251,1531,31720,4.6043728008180205,95.39562719918197,Food
26671,5824,20847,21.8364515766188,78.1635484233812,Housing
193510,26563,166947,13.726939176269958,86.27306082373003,Entertainment
64281,12621,51660,19.634106501143417,80.36589349885658,Transportation
26759,13685,13074,51.14167196083561,48.8583280391644,Housing
95745,39209,56536,40.95148571726983,59.04851428273017,Transportation
87453,30095,57358,34.412770288040434,65.58722971195957,Transportation
147851,39970,107881,27.033973392131266,72.96602660786873,Healthcare
12127,3582,8545,29.53739589346087,70.46260410653913,Housing
10651,1209,9442,11.351046850061026,88.64895314993898,Housing
218244,26296,191948,12.048899397005188,87.95110060299481,Entertainment
130517,66494,64023,50.946619980538934,49.053380019461066,Healthcare
15745,9139,6606,58.04382343601143,41.95617656398857,Housing
130297,63720,66577,48.90365856466381,51.09634143533619,Healthcare
51959,5197,46762,10.002117053830906,89.9978829461691,Food
32143,9018,23125,28.055875307220855,71.94412469277914,Food
47589,21935,25654,46.092584420769505,53.9074155792305,Food
120791,19053,101738,15.773526173307614,84.22647382669238,Healthcare
44994,15328,29666,34.06676445748322,65.93323554251678,Food
156459,3985,152474,2.5469931419732963,97.4530068580267,Healthcare
70874,17103,53771,24.131557411744787,75.86844258825522,Transportation
17763,9785,7978,55.08641558295333,44.91358441704667,Housing
59229,17544,41685,29.62062503165679,70.37937496834321,Food
145292,53492,91800,36.81689287779093,63.18310712220907,Healthcare
17065,5746,11319,33.67125695868737,66.32874304131263,Housing
207416,54271,153145,26.16529100937247,73.83470899062753,Entertainment
146196,45461,100735,31.095926017127688,68.9040739828723,Healthcare
10907,205,10702,1.8795269093242872,98.1204730906757,Housing
186986,39113,147873,20.917608804937267,79.08239119506273,Entertainment
190785,14951,175834,7.836569960950808,92.16343003904919,Entertainment
162153,43336,118817,26.72537665044742,73.27462334955258,Healthcare
225959,8310,217649,3.677658336246841,96.32234166375316,Entertainment
46944,18299,28645,38.98048738922972,61.01951261077028,Food
243204,64150,179054,26.37703327247907,73.62296672752093,Entertainment
28949,1452,27497,5.0157172959342295,94.98428270406578,Housing
45309,4764,40545,10.51446732437264,89.48553267562735,Food
32713,1235,31478,3.775257542872864,96.22474245712714,Food
117862,16959,100903,14.388861549948246,85.61113845005175,Transportation
138548,21388,117160,15.437249184398185,84.56275081560182,Healthcare
44264,21156,23108,47.79504789445148,52.20495210554853,Food
173037,17539,155498,10.135982477735975,89.86401752226402,Healthcare
177777,52759,125018,29.6770673371696,70.3229326628304,Healthcare
143142,56503,86639,39.47339006021992,60.52660993978007,Healthcare
136572,47083,89489,34.474855753741615,65.52514424625838,Healthcare
129128,58019,71109,44.93138591165356,55.06861408834644,Healthcare
140036,29740,110296,21.237396098146192,78.76260390185381,Healthcare
226466,16834,209632,7.433345402841927,92.56665459715808,Entertainment
24224,3816,20408,15.752972258916778,84.24702774108323,Housing
30565,14675,15890,48.01243252085719,51.98756747914282,Food
133693,43154,90539,32.27842893793991,67.7215710620601,Healthcare
210351,7324,203027,3.4817994685073996,96.51820053149261,Entertainment
127673,45237,82436,35.43192374268639,64.5680762573136,Healthcare
244927,57965,186962,23.666235245603794,76.3337647543962,Entertainment
69383,37950,31433,54.69639537062393,45.30360462937607,Transportation
195896,65338,130558,33.35341201453833,66.64658798546166,Entertainment
174480,4378,170102,2.5091701054562128,97.49082989454378,Healthcare
74402,6157,68245,8.27531517969947,91.72468482030052,Transportation
84778,28253,56525,33.32586284177499,66.67413715822501,Transportation
113417,57098,56319,50.34342294365042,49.656577056349576,Transportation
56175,7860,48315,13.991989319092124,86.00801068090787,Food
235959,40501,195458,17.16442263274552,82.83557736725447,Entertainment
92251,14925,77326,16.178686409903413,83.82131359009658,Transportation
59103,22786,36317,38.553034532934035,61.44696546706597,Food
92975,7488,85487,8.053777897284215,91.94622210271578,Transportation
238645,10156,228489,4.255693603469589,95.7443063965304,Entertainment
151535,37669,113866,24.858283564853004,75.141716435147,Healthcare
220754,63155,157599,28.608768131041796,71.3912318689582,Entertainment
10458,1334,9124,12.755785044941673,87.24421495505833,Housing
202426,14888,187538,7.354786440477014,92.64521355952299,Entertainment
121430,21236,100194,17.488264843943014,82.51173515605699,Healthcare
184427,44507,139920,24.13258362387286,75.86741637612714,Entertainment
226339,34375,191964,15.187395897304487,84.81260410269552,Entertainment
27059,3318,23741,12.26209394286559,87.73790605713441,Housing
190078,30842,159236,16.2259703911026,83.77402960889741,Entertainment
228634,11661,216973,5.1002912952579225,94.89970870474208,Entertainment
37638,18847,18791,50.07439290079175,49.92560709920825,Food
180468,27715,152753,15.357293259746879,84.64270674025312,Entertainment
22315,349,21966,1.5639704234819627,98.43602957651804,Housing
14501,4692,9809,32.35638921453693,67.64361078546307,Housing
214057,65643,148414,30.66613098380338,69.33386901619663,Entertainment
142135,57808,84327,40.67119288000845,59.32880711999155,Healthcare
245791,38371,207420,15.611230679723832,84.38876932027617,Entertainment
16085,2917,13168,18.13490829965807,81.86509170034194,Housing
16597,1274,15323,7.6760860396457185,92.32391396035428,Housing
191145,43564,147581,22.79107483847341,77.2089251615266,Entertainment
107967,41277,66690,38.23112617744311,61.76887382255689,Transportation
120288,14555,105733,12.10012636339452,87.89987363660549,Healthcare
117444,43743,73701,37.24583631347706,62.754163686522936,Transportation
107856,23838,84018,22.101691143747217,77.89830885625278,Transportation
244358,33802,210556,13.832982754810565,86.16701724518944,Entertainment
73144,32125,41019,43.92021218418462,56.07978781581537,Transportation
101003,60526,40477,59.92495272417651,40.075047275823486,Transportation
65363,33974,31389,51.97741841714731,48.02258158285269,Transportation
51099,17237,33862,33.73255836709133,66.26744163290866,Food
114001,51233,62768,44.94083385233463,55.05916614766537,Transportation
68914,13656,55258,19.81600255390777,80.18399744609222,Transportation
103168,35400,67768,34.31296526054591,65.68703473945409,Transportation
93041,19993,73048,21.4883760922604,78.5116239077396,Transportation
157595,59785,97810,37.93584821853485,62.06415178146515,Healthcare
57375,3377,53998,5.885838779956427,94.11416122004357,Food
144374,33149,111225,22.96050535414964,77.03949464585035,Healthcare
11258,180,11078,1.5988630307337004,98.4011369692663,Housing
95585,15308,80277,16.015065125281165,83.98493487471885,Transportation
181336,66361,114975,36.59560153527154,63.40439846472846,Entertainment
56342,11541,44801,20.48383088992226,79.51616911007774,Food
88553,28516,60037,32.202184002800585,67.79781599719942,Transportation
236307,66405,169902,28.10115654635707,71.89884345364294,Entertainment
60498,10512,49986,17.3757810175543,82.6242189824457,Transportation
14932,8726,6206,58.43825341548352,41.56174658451647,Housing
219328,18513,200815,8.440782754595856,91.55921724540414,Entertainment
123661,25160,98501,20.345945771100023,79.65405422889998,Healthcare
72234,24057,48177,33.30426115125841,66.6957388487416,Transportation
167227,9336,157891,5.582830523779054,94.41716947622095,Healthcare
73733,18160,55573,24.629406100389243,75.37059389961075,Transportation
59063,5366,53697,9.085214093425664,90.91478590657434,Food
191015,38028,152987,19.908384158312174,80.09161584168783,Entertainment
34728,2118,32610,6.098825155494126,93.90117484450587,Food
219245,50532,168713,23.048188100070696,76.9518118999293,Entertainment
51921,30105,21816,57.98231929277171,42.01768070722829,Food
98883,35,98848,0.035395366240910976,99.9646046337591,Transportation
245547,22228,223319,9.052442098661356,90.94755790133866,Entertainment
34961,14198,20763,40.61096650553474,59.38903349446526,Food
24428,3622,20806,14.827247420992304,85.17275257900769,Housing
175223,67917,107306,38.760322560394464,61.239677439605536,Healthcare
38570,2537,36033,6.577651024112003,93.42234897588799,Food
50315,393,49922,0.781079201033489,99.21892079896651,Food
52150,18109,34041,34.7248322147651,65.2751677852349,Food
87956,21678,66278,24.646414116148986,75.35358588385101,Transportation
14446,6897,7549,47.74331995015921,52.25668004984079,Housing
156675,16126,140549,10.292644008297431,89.70735599170257,Healthcare
121785,42342,79443,34.76782855031408,65.23217144968592,Healthcare
10604,6115,4489,57.66691814409657,42.33308185590343,Housing
193395,33334,160061,17.236226376069702,82.7637736239303,Entertainment
113174,32982,80192,29.142735964090694,70.85726403590931,Transportation
237249,29956,207293,12.626396739290788,87.3736032607092,Entertainment
19839,3601,16238,18.151116487726195,81.8488835122738,Housing
156597,34482,122115,22.019578919136382,77.98042108086362,Healthcare
19350,11476,7874,59.30749354005168,40.69250645994832,Housing
165509,21763,143746,13.149133883957973,86.85086611604203,Healthcare
181353,52091,129262,28.723539174979184,71.27646082502082,Entertainment
94769,34751,60018,36.66916396712005,63.330836032879944,Transportation
49990,9107,40883,18.21764352870574,81.78235647129426,Food
149898,62453,87445,41.66366462527852,58.33633537472148,Healthcare
131604,50745,80859,38.5588583933619,61.4411416066381,Healthcare
167695,25070,142625,14.949759980917737,85.05024001908225,Healthcare
19819,8606,11213,43.42297795045159,56.57702204954841,Housing
247242,5032,242210,2.0352529101042705,97.96474708989574,Entertainment
156750,30500,126250,19.457735247208934,80.54226475279107,Healthcare
177679,46745,130934,26.308680260469725,73.69131973953029,Healthcare
119010,15311,103699,12.865305436517941,87.13469456348206,Transportation
25426,9714,15712,38.20498702115944,61.79501297884056,Housing
215088,46711,168377,21.717157628505543,78.28284237149445,Entertainment
149785,40751,109034,27.206329071669394,72.79367092833061,Healthcare
55951,6605,49346,11.804972207824704,88.1950277921753,Food
195481,9449,186032,4.833717854932193,95.16628214506781,Entertainment
28846,10664,18182,36.968730499896004,63.031269500104,Housing
195052,57650,137402,29.556220905194515,70.44377909480549,Entertainment
96033,1056,94977,1.0996220049358032,98.90037799506419,Transportation
154176,36913,117263,23.94211809879618,76.05788190120381,Healthcare
145689,42543,103146,29.20124374523814,70.79875625476186,Healthcare
44154,9328,34826,21.126058794220228,78.87394120577977,Food
154637,67248,87389,43.48765172630095,56.512348273699054,Healthcare
25547,8599,16948,33.65952949465691,66.34047050534309,Housing
38755,9147,29608,23.602115856018578,76.39788414398141,Food
41753,3964,37789,9.493928579982276,90.50607142001772,Food
239948,66261,173687,27.614733192191643,72.38526680780836,Entertainment
149605,9819,139786,6.563283312723506,93.4367166872765,Healthcare
45770,12426,33344,27.148787415337555,72.85121258466243,Food
108152,43689,64463,40.39592425475257,59.60407574524743,Transportation
20192,4700,15492,23.276545166402535,76.72345483359746,Housing
29957,5971,23986,19.931902393430583,80.06809760656942,Housing
158748,9975,148773,6.283543729684784,93.71645627031522,Healthcare
172661,2407,170254,1.394061195058525,98.60593880494147,Healthcare
49506,12286,37220,24.817193875489842,75.18280612451017,Food
77063,44495,32568,57.73847371631003,42.26152628368997,Transportation
16413,4980,11433,30.34180222993968,69.65819777006031,Housing
86369,37056,49313,42.90428278664798,57.09571721335202,Transportation
193099,44831,148268,23.21658838212523,76.78341161787476,Entertainment
141855,43691,98164,30.79976031863523,69.20023968136478,Healthcare
26239,7858,18381,29.947787644346203,70.0522123556538,Housing
177045,17580,159465,9.929678895196137,90.07032110480387,Healthcare
75817,36880,38937,48.64344408246172,51.35655591753828,Transportation
39828,15082,24746,37.86783167620769,62.1321683237923,Food
178136,28224,149912,15.84407419050613,84.15592580949387,Healthcare
169495,30924,138571,18.24478598188737,81.75521401811264,Healthcare
158560,58027,100533,36.59624117053482,63.40375882946518,Healthcare
148473,14191,134282,9.55796676836866,90.44203323163134,Healthcare
132782,23443,109339,17.655254477263487,82.34474552273652,Healthcare
185491,2982,182509,1.6076251677978985,98.3923748322021,Entertainment
189012,19308,169704,10.215224430194908,89.78477556980509,Entertainment
47804,4068,43736,8.50974813823111,91.49025186176888,Food
46276,13907,32369,30.052294926095602,69.9477050739044,Food
39664,8077,31587,20.36355385235982,79.63644614764019,Food
18423,9617,8806,52.201053031536674,47.79894696846333,Housing
176711,37536,139175,21.241462048202997,78.75853795179701,Healthcare
112876,50593,62283,44.82175130231404,55.17824869768596,Transportation
96826,52628,44198,54.35316960320576,45.64683039679424,Transportation
17477,6977,10500,39.92103907993363,60.07896092006637,Housing
223545,64810,158735,28.99192556308573,71.00807443691427,Entertainment
189904,59827,130077,31.503812452607633,68.49618754739237,Entertainment
35893,14886,21007,41.47326776808848,58.52673223191152,Food
199176,17237,181939,8.654155119090653,91.34584488090934,Entertainment
225541,24296,201245,10.772320775380086,89.22767922461992,Entertainment
22123,1525,20598,6.8932784884509335,93.10672151154907,Housing
242317,60896,181421,25.130717201021803,74.8692827989782,Entertainment
99123,47584,51539,48.005003884063235,51.994996115936765,Transportation
66697,39401,27296,59.07462104742343,40.92537895257658,Transportation
28977,10282,18695,35.483314352762534,64.51668564723747,Housing
12878,924,11954,7.17502717813325,92.82497282186675,Housing
48113,10191,37922,21.181385488329557,78.81861451167043,Food
97794,6779,91015,6.9319181135857,93.0680818864143,Transportation
38922,241,38681,0.619187092132984,99.38081290786701,Food
227347,44981,182366,19.785174205069783,80.2148257949302,Entertainment
40971,22704,18267,55.41480559420078,44.58519440579922,Food
56422,33027,23395,58.535677572578074,41.464322427421926,Food
182923,66004,116919,36.08294200291926,63.91705799708074,Entertainment
92763,11868,80895,12.793894117266582,87.20610588273343,Transportation
168568,27302,141266,16.196431113853162,83.80356888614683,Healthcare
10881,3155,7726,28.99549673743222,71.00450326256778,Housing
159123,56924,102199,35.77358395706466,64.22641604293534,Healthcare
91133,12656,78477,13.887395345264613,86.11260465473539,Transportation
187832,5806,182026,3.091060096256229,96.90893990374377,Entertainment
167745,23118,144627,13.781632835553967,86.21836716444604,Healthcare
31412,3359,28053,10.693365592767096,89.3066344072329,Food
25220,11002,14218,43.624107850911976,56.375892149088024,Housing
12751,1081,11670,8.47776644969022,91.52223355030978,Housing
139493,14345,125148,10.283670148322855,89.71632985167714,Healthcare
38243,4443,33800,11.61781241011427,88.38218758988573,Food
24989,2380,22609,9.524190643883308,90.47580935611668,Housing
152039,4369,147670,2.873604798768737,97.12639520123126,Healthcare
22957,2233,20724,9.726880689985625,90.27311931001437,Housing
71332,4775,66557,6.694050356081423,93.30594964391857,Transportation
136187,58563,77624,43.001901796794115,56.998098203205885,Healthcare
48741,3181,45560,6.526333066617426,93.47366693338257,Food
23113,1951,21162,8.441137022454894,91.5588629775451,Housing
202917,2495,200422,1.2295667686788194,98.77043323132118,Entertainment
35001,7321,27680,20.916545241564528,79.08345475843548,Food
99513,7456,92057,7.492488418598575,92.50751158140143,Transportation
23656,12529,11127,52.96330740615489,47.03669259384512,Housing
144471,14559,129912,10.077454990967045,89.92254500903294,Healthcare
36787,10056,26731,27.335743605077884,72.66425639492212,Food
11265,6676,4589,59.26320461606747,40.73679538393253,Housing
41040,12316,28724,30.009746588693957,69.99025341130604,Food
57543,98,57445,0.1703074222755157,99.82969257772449,Food
78202,30091,48111,38.47855553566405,61.52144446433595,Transportation
118109,44618,73491,37.77696873227273,62.22303126772727,Transportation
204613,1980,202633,0.9676804504112642,99.03231954958873,Entertainment
202456,2959,199497,1.4615521397241868,98.53844786027581,Entertainment
239297,50690,188607,21.182881523796787,78.8171184762032,Entertainment
23531,5596,17935,23.78139475585398,76.21860524414602,Housing
15060,8804,6256,58.459495351925625,41.54050464807437,Housing
24761,10171,14590,41.07669318686644,58.92330681313356,Housing
41998,20992,21006,49.98333253964474,50.01666746035526,Food
29926,12886,17040,43.0595468823097,56.9404531176903,Housing
24429,4726,19703,19.345859429366737,80.65414057063326,Housing
17688,1705,15983,9.639303482587065,90.36069651741293,Housing
174190,52447,121743,30.109076295998623,69.89092370400137,Healthcare
22824,8108,14716,35.52400981423063,64.47599018576936,Housing
107266,10112,97154,9.42703186471016,90.57296813528984,Transportation
44187,17165,27022,38.84626700160681,61.153732998393195,Food
51626,19174,32452,37.140200674078955,62.85979932592105,Food
118266,66698,51568,56.3965975005496,43.60340249945039,Transportation
114274,57607,56667,50.41129215744614,49.588707842553866,Transportation
164599,35338,129261,21.46914622810588,78.53085377189412,Healthcare
134208,41701,92507,31.07191821649976,68.92808178350023,Healthcare
10795,5224,5571,48.39277443260769,51.60722556739231,Housing
205568,41931,163637,20.39762998132005,79.60237001867995,Entertainment
18424,4492,13932,24.381241858445506,75.6187581415545,Housing
26854,12342,14512,45.959633574141655,54.040366425858345,Housing
180996,20765,160231,11.472629229375235,88.52737077062477,Entertainment
227809,45300,182509,19.88507916719708,80.11492083280291,Entertainment
27831,6125,21706,22.007832991987353,77.99216700801264,Housing
121297,40459,80838,33.35531793861349,66.64468206138652,Healthcare
246884,52958,193926,21.450559777061294,78.5494402229387,Entertainment
21843,2452,19391,11.225564253994415,88.7744357460056,Housing
43492,3279,40213,7.539317575646096,92.4606824243539,Food
39103,12575,26528,32.15865790348567,67.84134209651434,Food
100767,47007,53760,46.64920063115901,53.35079936884098,Transportation
193799,41179,152620,21.248303654817622,78.75169634518238,Entertainment
32652,19347,13305,59.25211319367879,40.747886806321205,Food
120971,17659,103312,14.597713501583023,85.40228649841698,Healthcare
97935,21545,76390,21.99928524021034,78.00071475978966,Transportation
48854,15690,33164,32.11610103573914,67.88389896426085,Food
209323,41691,167632,19.91706596981698,80.08293403018301,Entertainment
69173,26982,42191,39.00654879794139,60.9934512020586,Transportation
45180,20698,24482,45.81230633023461,54.18769366976538,Food
72187,40347,31840,55.892335185005614,44.10766481499439,Transportation
167773,13213,154560,7.875522283084882,92.12447771691512,Healthcare
64478,20922,43556,32.44827693166661,67.55172306833337,Transportation
66226,18564,47662,28.031286805786248,71.96871319421375,Transportation
137343,16017,121326,11.662043205696685,88.33795679430332,Healthcare
23954,9253,14701,38.6282040577774,61.3717959422226,Housing
34802,5122,29680,14.71754496867996,85.28245503132004,Food
77168,2870,74298,3.7191582002902757,96.28084179970972,Transportation
33287,12517,20770,37.603268543275156,62.39673145672485,Food
50635,7811,42824,15.426088673842203,84.5739113261578,Food
70858,13404,57454,18.916706652742104,81.08329334725791,Transportation
47156,22529,24627,47.77546865722284,52.22453134277717,Food
79779,43666,36113,54.733701851364394,45.266298148635606,Transportation
179043,45281,133762,25.29057265573075,74.70942734426926,Healthcare
160764,46743,114021,29.07553929984325,70.92446070015676,Healthcare
55002,28953,26049,52.63990400349078,47.360095996509216,Food
237552,58541,179011,24.643446487505894,75.3565535124941,Entertainment
34319,1520,32799,4.429033479996503,95.5709665200035,Food
18964,9871,9093,52.05125500949167,47.94874499050833,Housing
220694,10479,210215,4.7482033947456666,95.25179660525434,Entertainment
161917,16438,145479,10.152114972485904,89.8478850275141,Healthcare
183103,9709,173394,5.302480024904016,94.69751997509599,Entertainment
158451,57863,100588,36.51791405544932,63.48208594455068,Healthcare
203144,56711,146433,27.916650257945104,72.08334974205489,Entertainment
119194,23097,96097,19.377653237579075,80.62234676242093,Transportation
212772,23154,189618,10.882070949185044,89.11792905081496,Entertainment
86992,45106,41886,51.850744896082404,48.1492551039176,Transportation
104592,54780,49812,52.374942634235886,47.625057365764114,Transportation
28295,16600,11695,58.66760911821876,41.33239088178124,Housing
29304,14235,15069,48.57698607698608,51.423013923013926,Housing
182025,58580,123445,32.18239252849883,67.81760747150116,Entertainment
81861,5452,76409,6.660070118860019,93.33992988113998,Transportation
145294,51033,94261,35.123955565955924,64.87604443404408,Healthcare
10544,610,9934,5.7852807283763275,94.21471927162366,Housing
150318,213,150105,0.1416995968546681,99.85830040314532,Healthcare
74246,38769,35477,52.21695444872451,47.783045551275485,Transportation
54930,9885,45045,17.99563080283998,82.00436919716002,Food
112910,9247,103663,8.189708617482951,91.81029138251705,Transportation
21585,16,21569,0.07412555015056752,99.92587444984943,Housing
141874,18329,123545,12.919210003242313,87.08078999675769,Healthcare
42845,22121,20724,51.63029525032093,48.36970474967907,Food
230371,47419,182952,20.583754031540426,79.41624596845958,Entertainment
32869,8975,23894,27.305363716571847,72.69463628342815,Food
10373,5872,4501,56.60850284392171,43.39149715607828,Housing
14169,2622,11547,18.50518738090197,81.49481261909803,Housing
12662,2127,10535,16.79829410835571,83.2017058916443,Housing
215061,58944,156117,27.408037719530736,72.59196228046926,Entertainment
128535,58595,69940,45.586805150348155,54.413194849651845,Healthcare
73041,24977,48064,34.19586259771909,65.80413740228092,Transportation
205308,5001,200307,2.4358524753053947,97.5641475246946,Entertainment
76535,17080,59455,22.316587182334878,77.68341281766511,Transportation
27006,10904,16102,40.37621269347552,59.62378730652448,Housing
82460,48701,33759,59.06015037593985,40.93984962406015,Transportation
122477,4984,117493,4.069335467067286,95.93066453293272,Healthcare
19735,3064,16671,15.525715733468456,84.47428426653154,Housing
35895,20541,15354,57.22524028416214,42.77475971583786,Food
19751,4655,15096,23.568426915092907,76.43157308490709,Housing
27405,13698,13707,49.983579638752055,50.016420361247945,Housing
119589,9732,109857,8.13787221232722,91.86212778767278,Transportation
228129,24396,203733,10.693949475954394,89.30605052404562,Entertainment
51331,27044,24287,52.68551167910229,47.3144883208977,Food
171259,63242,108017,36.92769431095592,63.072305689044086,Healthcare
244925,17099,227826,6.98132081249362,93.01867918750638,Entertainment
176639,36219,140420,20.504531841778995,79.495468158221,Healthcare
32438,18877,13561,58.194093347308716,41.80590665269129,Food
124873,20853,104020,16.699366556421325,83.30063344357868,Healthcare
99287,2747,96540,2.7667267618117175,97.23327323818827,Transportation
41073,992,40081,2.415211939717089,97.58478806028292,Food
162368,45847,116521,28.23647516752069,71.7635248324793,Healthcare
152692,56657,96035,37.1054148219946,62.89458517800539,Healthcare
109706,55520,54186,50.60798862414089,49.39201137585911,Transportation
101577,5168,96409,5.087765931263967,94.91223406873604,Transportation
90018,26633,63385,29.586304961229974,70.41369503877002,Transportation
115743,38187,77556,32.99292397812395,67.00707602187606,Transportation
233633,50936,182697,21.80171465503589,78.19828534496412,Entertainment
91491,19605,71886,21.42833721349641,78.5716627865036,Transportation
32163,9141,23022,28.42085626340826,71.57914373659173,Food
184701,10257,174444,5.553299657283935,94.44670034271606,Entertainment
245707,3537,242170,1.4395194276109349,98.56048057238907,Entertainment
70291,18737,51554,26.656328690728543,73.34367130927146,Transportation
154469,15372,139097,9.951511306475732,90.04848869352426,Healthcare
77927,29953,47974,38.43725538003516,61.56274461996484,Transportation
40644,12140,28504,29.869107371321718,70.13089262867828,Food
52387,21676,30711,41.376677419970605,58.62332258002939,Food
98373,45299,53074,46.04820428369573,53.951795716304275,Transportation
79525,40764,38761,51.259352404904114,48.74064759509588,Transportation
46386,7612,38774,16.410123744233175,83.58987625576682,Food
62227,15564,46663,25.01165089109229,74.9883491089077,Transportation
33231,7617,25614,22.921368601606932,77.07863139839307,Food
19485,7743,11742,39.73826020015396,60.26173979984604,Housing
99507,32798,66709,32.96049524154079,67.0395047584592,Transportation
92842,26230,66612,28.252299605781868,71.74770039421814,Transportation
36998,4682,32316,12.654738093951023,87.34526190604898,Food
130087,45351,84736,34.862053856265426,65.13794614373458,Healthcare
123981,48236,75745,38.905961397310875,61.094038602689125,Healthcare
48089,25970,22119,54.00403418661233,45.99596581338768,Food
133100,43533,89567,32.70698722764838,67.29301277235162,Healthcare
93187,482,92705,0.5172395291188685,99.48276047088113,Transportation
191193,7898,183295,4.130904374114115,95.86909562588588,Entertainment
201831,48839,152992,24.197967606561928,75.80203239343808,Entertainment
51511,22675,28836,44.019723942458896,55.98027605754111,Food
226717,55241,171476,24.365618811116942,75.63438118888305,Entertainment
153612,20037,133575,13.043902820092178,86.95609717990781,Healthcare
141365,34899,106466,24.68715735861069,75.31284264138931,Healthcare
76435,9049,67386,11.83881729574148,88.16118270425852,Transportation
60934,18093,42841,29.692782354678833,70.30721764532116,Transportation
44952,4995,39957,11.111852642819008,88.888147357181,Food
118028,43096,74932,36.513369708882635,63.486630291117365,Transportation
60144,25984,34160,43.20297951582867,56.79702048417133,Transportation
247668,55280,192388,22.320202852205373,77.67979714779463,Entertainment
109941,63402,46539,57.66911343356892,42.33088656643108,Transportation
95572,27534,68038,28.809693215586158,71.19030678441385,Transportation
16614,1870,14744,11.255567593595762,88.74443240640424,Housing
120632,31788,88844,26.351216924199218,73.64878307580078,Healthcare
172149,45225,126924,26.270846766463933,73.72915323353607,Healthcare
166890,51825,115065,31.05338845946432,68.94661154053568,Healthcare
26556,1197,25359,4.507455942159964,95.49254405784004,Housing
96269,36239,60030,37.64347817054296,62.356521829457044,Transportation
89070,33976,55094,38.145278994049626,61.854721005950374,Transportation
59111,16859,42252,28.520918272402767,71.47908172759723,Food
93713,15389,78324,16.421414318184244,83.57858568181575,Transportation
25745,14178,11567,55.07088755098077,44.92911244901923,Housing
46061,13286,32775,28.844358567985935,71.15564143201408,Food
128638,64635,64003,50.24565058536358,49.75434941463642,Healthcare
64600,31224,33376,48.3343653250774,51.6656346749226,Transportation
37111,5147,31964,13.869203201207188,86.1307967987928,Food
48897,20039,28858,40.98206433932552,59.01793566067448,Food
170384,29878,140506,17.535684101793596,82.46431589820641,Healthcare
78050,25986,52064,33.294042280589366,66.70595771941063,Transportation
110602,54953,55649,49.6853583117846,50.3146416882154,Transportation
247799,39152,208647,15.799902340203149,84.20009765979685,Entertainment
227140,54390,172750,23.94558422118517,76.05441577881483,Entertainment
29012,14395,14617,49.61739969667724,50.38260030332277,Housing
72892,42136,30756,57.80606925314164,42.19393074685836,Transportation
137369,23094,114275,16.811653284219872,83.18834671578013,Healthcare
57362,20233,37129,35.272480039050244,64.72751996094975,Food
32751,7941,24810,24.246587890446094,75.7534121095539,Food
14142,8463,5679,59.843020789138734,40.156979210861266,Housing
75595,34320,41275,45.399828030954424,54.600171969045576,Transportation
246438,21942,224496,8.903659338251407,91.0963406617486,Entertainment
25110,13880,11230,55.27678215850259,44.72321784149741,Housing
45673,2792,42881,6.113020821929805,93.88697917807019,Food
24859,10157,14702,40.85844161068426,59.14155838931574,Housing
58438,24831,33607,42.491187241178686,57.508812758821314,Food
38433,3573,34860,9.29669815002732,90.70330184997269,Food
23825,13217,10608,55.475341028331584,44.524658971668416,Housing
20829,8801,12028,42.253588746459265,57.74641125354074,Housing
17850,5743,12107,32.173669467787114,67.82633053221289,Housing
45688,13257,32431,29.016371913850463,70.98362808614954,Food
54159,30307,23852,55.9593050093244,44.040694990675604,Food
106289,24656,81633,23.197132346715087,76.8028676532849,Transportation
20408,9705,10703,47.554880439043515,52.445119560956485,Housing
95793,33194,62599,34.651801279843,65.348198720157,Transportation
65266,3535,61731,5.41629638709282,94.58370361290717,Transportation
146445,10787,135658,7.365905288674929,92.63409471132506,Healthcare
59525,31130,28395,52.29735405291894,47.70264594708106,Food
83634,672,82962,0.8035009685056317,99.19649903149437,Transportation
245515,21543,223972,8.77461662220231,91.22538337779768,Entertainment
127402,59851,67551,46.97806941806251,53.0219305819375,Healthcare
108477,22538,85939,20.776754519391208,79.2232454806088,Transportation
149762,61491,88271,41.059147180192575,58.94085281980743,Healthcare
54499,20106,34393,36.89242004440448,63.10757995559552,Food
146663,47500,99163,32.38717331569653,67.61282668430347,Healthcare
142908,61202,81706,42.82615388921544,57.17384611078457,Healthcare
113460,32641,80819,28.768729067512776,71.23127093248722,Transportation
100934,59030,41904,58.48376166603919,41.51623833396081,Transportation
189618,32884,156734,17.342235441782954,82.65776455821705,Entertainment
234708,13676,221032,5.826814595156534,94.17318540484347,Entertainment
125742,41332,84410,32.87048082581794,67.12951917418205,Healthcare
40921,4085,36836,9.982649495369126,90.01735050463088,Food
188245,31930,156315,16.961937900077025,83.03806209992297,Entertainment
18708,2224,16484,11.887962369039982,88.11203763096002,Housing
31905,12321,19584,38.617771509167845,61.382228490832155,Food
245294,62545,182749,25.4979738599395,74.5020261400605,Entertainment
119895,38459,81436,32.07723424663247,67.92276575336753,Transportation
36218,8160,28058,22.53023358550997,77.46976641449004,Food
36890,7749,29141,21.00569259962049,78.9943074003795,Food
10416,2751,7665,26.411290322580644,73.58870967741935,Housing
127329,12820,114509,10.068405469296076,89.93159453070393,Healthcare
122201,63939,58262,52.32281241561034,47.67718758438965,Healthcare
69495,8395,61100,12.08000575580977,87.91999424419022,Transportation
28831,13325,15506,46.21761298602199,53.782387013978,Housing
13924,3373,10551,24.224360815857512,75.77563918414249,Housing
30297,5060,25237,16.701323563389114,83.29867643661089,Food
19198,3467,15731,18.05917283050318,81.94082716949683,Housing
55151,20790,34361,37.69650595637432,62.30349404362568,Food
53857,8677,45180,16.111183318788644,83.88881668121135,Food
224010,10388,213622,4.637292977992054,95.36270702200794,Entertainment
15912,6220,9692,39.08999497234792,60.91000502765208,Housing
116930,60878,56052,52.06362781151116,47.93637218848884,Transportation
55466,6158,49308,11.102296902607002,88.897703097393,Food
39785,3724,36061,9.360311675254493,90.6396883247455,Food
49695,10081,39614,20.28574303249824,79.71425696750177,Food
124082,31152,92930,25.10597830466949,74.89402169533051,Healthcare
233802,65042,168760,27.81926587454342,72.18073412545658,Entertainment
111629,42043,69586,37.66315204830286,62.33684795169714,Transportation
15138,3059,12079,20.207425023120624,79.79257497687937,Housing
10170,6048,4122,59.469026548672566,40.530973451327434,Housing
37960,18830,19130,49.604847207586936,50.395152792413064,Food
75267,7405,67862,9.83830895345902,90.16169104654098,Transportation
53572,15696,37876,29.298887478533565,70.70111252146644,Food
203189,53497,149692,26.328689053049132,73.67131094695087,Entertainment
18285,10719,7566,58.621821164889255,41.378178835110745,Housing
10438,2587,7851,24.784441463881972,75.21555853611804,Housing
216132,9740,206392,4.5065052838080435,95.49349471619196,Entertainment
15561,4988,10573,32.05449521238995,67.94550478761006,Housing
15553,4861,10692,31.254420369060632,68.74557963093937,Housing
162440,63438,99002,39.053188869736516,60.94681113026348,Healthcare
162440,30759,131681,18.935606993351392,81.0643930066486,Healthcare
118789,40374,78415,33.98799552147084,66.01200447852915,Transportation
179319,62207,117112,34.690690891651194,65.30930910834881,Healthcare
139378,43926,95452,31.515734190474827,68.48426580952518,Healthcare
75856,472,75384,0.622231596709555,99.37776840329045,Transportation
110620,20307,90313,18.357439884288556,81.64256011571145,Transportation
152095,37274,114821,24.50705151385647,75.49294848614353,Healthcare
154693,40986,113707,26.49505795349499,73.50494204650502,Healthcare
17384,3295,14089,18.95421076852278,81.04578923147722,Housing
23700,5763,17937,24.31645569620253,75.68354430379746,Housing
21889,3970,17919,18.136963771757504,81.86303622824249,Housing
246679,36981,209698,14.991547719911303,85.0084522800887,Entertainment
55934,6058,49876,10.830621804269319,89.16937819573069,Food
25026,4321,20705,17.26604331495245,82.73395668504754,Housing
41651,21139,20512,50.75268300881132,49.24731699118869,Food
199203,22557,176646,11.323624644207166,88.67637535579284,Entertainment
17104,6849,10255,40.043264733395695,59.9567352666043,Housing
152618,21139,131479,13.850921909604372,86.14907809039562,Healthcare
174172,20934,153238,12.019153480467585,87.98084651953242,Healthcare
69755,36891,32864,52.88653143143861,47.113468568561395,Transportation
146671,61100,85571,41.657860108678605,58.34213989132139,Healthcare
183437,61027,122410,33.26864264025251,66.73135735974749,Entertainment
28415,10067,18348,35.42847087805737,64.57152912194263,Housing
209485,67954,141531,32.43859942239301,67.56140057760699,Entertainment
243332,62613,180719,25.731510857593744,74.26848914240625,Entertainment
37226,15115,22111,40.60334175038951,59.39665824961049,Food
11433,483,10950,4.22461296247704,95.77538703752296,Housing
10933,1925,9008,17.607244123296443,82.39275587670356,Housing
12999,2425,10574,18.655281175475036,81.34471882452496,Housing
68868,17360,51508,25.207643608061797,74.7923563919382,Transportation
218327,67972,150355,31.13311683850371,68.86688316149629,Entertainment
28896,8517,20379,29.474667774086377,70.52533222591362,Housing
222564,56478,166086,25.376071601876315,74.62392839812368,Entertainment
27879,1561,26318,5.599196527852506,94.4008034721475,Housing
54391,8695,45696,15.986100641650273,84.01389935834973,Food
247311,52580,194731,21.260679872710877,78.73932012728912,Entertainment
246734,30135,216599,12.213557920675708,87.78644207932429,Entertainment
166431,53957,112474,32.42004193930217,67.57995806069783,Healthcare
112231,382,111849,0.3403694166495888,99.6596305833504,Transportation
38523,8952,29571,23.238065571217195,76.76193442878281,Food
25242,11303,13939,44.778543697012914,55.22145630298708,Housing
56301,5164,51137,9.172128381378661,90.82787161862133,Food
142190,56451,85739,39.70110415641044,60.29889584358956,Healthcare
17992,4981,13011,27.684526456202757,72.31547354379725,Housing
75350,5718,69632,7.588586595885865,92.41141340411413,Transportation
153275,1773,151502,1.1567444136356222,98.84325558636438,Healthcare
43451,17221,26230,39.633149985040625,60.36685001495938,Food
190267,6403,183864,3.3652709087755626,96.63472909122444,Entertainment
118277,27591,90686,23.327443205356914,76.67255679464309,Transportation
17229,9084,8145,52.72505659063207,47.27494340936793,Housing
126748,22085,104663,17.42433805661628,82.57566194338372,Healthcare
108190,34046,74144,31.468712450318883,68.53128754968112,Transportation
41503,6188,35315,14.90976555911621,85.09023444088379,Food
191733,60446,131287,31.526132694945574,68.47386730505443,Entertainment
33445,36,33409,0.1076394079832561,99.89236059201674,Food
38927,2278,36649,5.851979345955249,94.14802065404476,Food
140566,19816,120750,14.097292375112048,85.90270762488795,Healthcare
42161,24907,17254,59.075923246602315,40.92407675339769,Food
57506,10863,46643,18.89020276145098,81.10979723854902,Food
182101,13312,168789,7.310228938885563,92.68977106111443,Entertainment
10962,1870,9092,17.0589308520343,82.94106914796569,Housing
180976,62519,118457,34.5454645919901,65.4545354080099,Entertainment
110473,21874,88599,19.800313198700135,80.19968680129986,Transportation
124500,34750,89750,27.91164658634538,72.08835341365462,Healthcare
14712,8505,6207,57.80995106035889,42.19004893964111,Housing
115452,40712,74740,35.26313965977202,64.73686034022798,Transportation
148119,67775,80344,45.7571277148779,54.242872285122104,Healthcare
196547,42478,154069,21.612133484611824,78.38786651538817,Entertainment
227607,47357,180250,20.8064778324041,79.1935221675959,Entertainment
161058,48617,112441,30.18601994312608,69.81398005687393,Healthcare
21501,6670,14831,31.021812938933074,68.97818706106693,Housing
142587,19242,123345,13.49491889162406,86.50508110837593,Healthcare
184774,49677,135097,26.88527606697912,73.11472393302087,Entertainment
215323,16379,198944,7.606711777190546,92.39328822280946,Entertainment
56167,876,55291,1.5596346609218936,98.44036533907811,Food
37409,11201,26208,29.941992568633218,70.05800743136679,Food
37033,10338,26695,27.915642805065755,72.08435719493424,Food
31982,8129,23853,25.417422300043775,74.58257769995622,Food
103530,18504,85026,17.873080266589394,82.1269197334106,Transportation
25933,8487,17446,32.7266417306135,67.27335826938649,Housing
181839,65266,116573,35.89219034420559,64.10780965579441,Entertainment
20776,12293,8483,59.169233731228346,40.83076626877166,Housing
183673,47499,136174,25.860632754950373,74.13936724504963,Entertainment
53148,25860,27288,48.65658162113344,51.34341837886656,Food
38376,22527,15849,58.70075046904315,41.29924953095685,Food
17639,4461,13178,25.29054935087023,74.70945064912978,Housing
25160,14029,11131,55.75914149443562,44.24085850556439,Housing
169759,4775,164984,2.8128111027986735,97.18718889720132,Healthcare
22374,6827,15547,30.513095557343345,69.48690444265665,Housing
47567,11568,35999,24.31938108352429,75.68061891647571,Food
57672,671,57001,1.1634762102926899,98.83652378970731,Food
115614,51026,64588,44.13479336412545,55.86520663587456,Transportation
100563,49387,51176,49.11050784085598,50.88949215914403,Transportation
206583,6101,200482,2.953292381270482,97.04670761872953,Entertainment
54687,24736,29951,45.23195640645857,54.76804359354143,Food
89662,5782,83880,6.448662755682452,93.55133724431755,Transportation
86099,37588,48511,43.656720751692816,56.34327924830718,Transportation
24256,5371,18885,22.14297493403694,77.85702506596306,Housing
131135,30996,100139,23.636710260418653,76.36328973958135,Healthcare
210504,24311,186193,11.548949188613992,88.45105081138601,Entertainment
179037,33372,145665,18.6397225154577,81.3602774845423,Healthcare
27695,12089,15606,43.65047842570861,56.34952157429139,Housing
75619,30528,45091,40.370806278845265,59.629193721154735,Transportation
104758,39612,65146,37.81286393401936,62.18713606598064,Transportation
34877,7616,27261,21.83674054534507,78.16325945465493,Food
50693,25765,24928,50.825557769317264,49.174442230682736,Food
234376,69551,164825,29.67496672014199,70.325033279858,Entertainment
54480,20740,33740,38.06901615271659,61.93098384728341,Food
151524,11088,140436,7.317652649085293,92.68234735091471,Healthcare
221832,14178,207654,6.391323163475063,93.60867683652494,Entertainment
202929,66825,136104,32.930236683766246,67.06976331623376,Entertainment
194667,45865,148802,23.56074732748745,76.43925267251255,Entertainment
156087,12501,143586,8.008994983566858,91.99100501643315,Healthcare
57004,4879,52125,8.559048487825416,91.44095151217458,Food
189750,11399,178351,6.007378129117259,93.99262187088274,Entertainment
108852,14046,94806,12.903759232719656,87.09624076728034,Transportation
117301,58747,58554,50.08226698834623,49.91773301165378,Transportation
16703,4454,12249,26.665868406873017,73.33413159312698,Housing
126003,40262,85741,31.953207463314364,68.04679253668563,Healthcare
205724,13178,192546,6.405669732262644,93.59433026773736,Entertainment
156984,28185,128799,17.95405901238343,82.04594098761658,Healthcare
15543,703,14840,4.522936370070128,95.47706362992987,Housing
38744,23186,15558,59.844104893660955,40.155895106339045,Food
31129,12028,19101,38.639211025089146,61.360788974910854,Food
19559,11396,8163,58.26473746101539,41.735262538984614,Housing
143411,40466,102945,28.216803453012666,71.78319654698733,Healthcare
59156,25833,33323,43.66928122253026,56.33071877746975,Food
230823,24702,206121,10.701706502384944,89.29829349761505,Entertainment
159279,7118,152161,4.468887926217517,95.53111207378248,Healthcare
133980,35667,98313,26.621137483206446,73.37886251679355,Healthcare
98028,49639,48389,50.63757293834414,49.36242706165586,Transportation
171269,9481,161788,5.535736181095237,94.46426381890475,Healthcare
209306,68555,140751,32.75348055000812,67.24651944999188,Entertainment
187295,10221,177074,5.457166502042233,94.54283349795777,Entertainment
167263,11711,155552,7.00154845961151,92.99845154038849,Healthcare
159745,5578,154167,3.491815080284203,96.5081849197158,Healthcare
27146,14761,12385,54.376335371693806,45.6236646283062,Housing
159057,24718,134339,15.54034088408558,84.45965911591442,Healthcare
111386,45317,66069,40.68464618533748,59.31535381466253,Transportation
223023,60632,162391,27.186433686211736,72.81356631378827,Entertainment
212541,3244,209297,1.526293750382279,98.47370624961772,Entertainment
54299,27582,26717,50.796515589605704,49.203484410394296,Food
166260,19331,146929,11.62696980632744,88.37303019367256,Healthcare
249616,48499,201117,19.429443625408627,80.57055637459138,Entertainment
98449,41171,57278,41.81962234253268,58.18037765746732,Transportation
43682,4706,38976,10.773316240098897,89.2266837599011,Food
23318,4009,19309,17.19272664894073,82.80727335105927,Housing
37146,18102,19044,48.732030366661284,51.267969633338716,Food
60270,11737,48533,19.474033515845363,80.52596648415464,Transportation
146691,23546,123145,16.051427831291626,83.94857216870837,Healthcare
132040,30736,101304,23.277794607694638,76.72220539230537,Healthcare
149796,50454,99342,33.6818072578707,66.3181927421293,Healthcare
28115,10332,17783,36.749066334696785,63.25093366530322,Housing
26196,11467,14729,43.77385860436708,56.22614139563292,Housing
222728,58936,163792,26.460974821306703,73.5390251786933,Entertainment
140030,27312,112718,19.504391916017997,80.495608083982,Healthcare
117768,20645,97123,17.530228924665444,82.46977107533455,Transportation
76117,17944,58173,23.57423440230172,76.42576559769829,Transportation
66343,22281,44062,33.58455300483849,66.4154469951615,Transportation
42965,2916,40049,6.786919585709299,93.2130804142907,Food
227542,43996,183546,19.3353314992397,80.6646685007603,Entertainment
130066,9478,120588,7.287069641566589,92.71293035843341,Healthcare
33742,12379,21363,36.687214747199334,63.312785252800666,Food
30708,17224,13484,56.089618340497594,43.91038165950241,Food
36473,2041,34432,5.595920269788611,94.4040797302114,Food
214389,29405,184984,13.715722355158148,86.28427764484185,Entertainment
169274,44601,124673,26.34840554367475,73.65159445632526,Healthcare
112987,2872,110115,2.541885349641994,97.45811465035801,Transportation
194055,23113,170942,11.910540826054469,88.08945917394553,Entertainment
61327,28556,32771,46.56350384007044,53.43649615992956,Transportation
209068,35779,173289,17.11357070426847,82.88642929573153,Entertainment
219620,62397,157223,28.41134687186959,71.5886531281304,Entertainment
167226,23727,143499,14.188583115065839,85.81141688493416,Healthcare
140579,44422,96157,31.59931426457721,68.40068573542278,Healthcare
162552,66113,96439,40.67190806634185,59.32809193365816,Healthcare
39983,18201,21782,45.52184678488357,54.47815321511642,Food
114472,42155,72317,36.825599273184714,63.17440072681529,Transportation
20230,4718,15512,23.321799307958475,76.67820069204151,Housing
234683,45262,189421,19.2864417107332,80.7135582892668,Entertainment
146766,48935,97831,33.34219097066078,66.65780902933922,Healthcare
150810,49722,101088,32.96996220409787,67.03003779590213,Healthcare
11015,5857,5158,53.1729459827508,46.8270540172492,Housing
48243,19888,28355,41.224633625603715,58.775366374396285,Food
87605,33395,54210,38.11997032132869,61.88002967867131,Transportation
168661,51586,117075,30.585612560105773,69.41438743989423,Healthcare
150297,3222,147075,2.1437553643785305,97.85624463562147,Healthcare
95443,23141,72302,24.245884978468823,75.75411502153118,Transportation
110558,25456,85102,23.025018542303588,76.97498145769642,Transportation
184968,9682,175286,5.234418926517019,94.76558107348299,Entertainment
85961,26814,59147,31.193215527971986,68.80678447202801,Transportation
41842,4010,37832,9.583671908608576,90.41632809139143,Food
36103,17843,18260,49.422485666011134,50.57751433398886,Food
22938,5773,17165,25.16784375272474,74.83215624727526,Housing
150277,21031,129246,13.994822893722924,86.00517710627707,Healthcare
21870,1239,20631,5.665294924554184,94.33470507544581,Housing
210092,37258,172834,17.73413552158102,82.26586447841898,Entertainment
92737,27893,64844,30.077531082523695,69.9224689174763,Transportation
158700,47882,110818,30.171392564587272,69.82860743541272,Healthcare
222610,10113,212497,4.54292260006289,95.4570773999371,Entertainment
64677,5302,59375,8.197659136942036,91.80234086305796,Transportation
40734,23622,17112,57.99086757990868,42.00913242009132,Food
39646,8504,31142,21.44983100438884,78.55016899561116,Food
138036,22218,115818,16.095801095366426,83.90419890463357,Healthcare
243678,28874,214804,11.849243674028841,88.15075632597116,Entertainment
137379,3605,133774,2.624127413942451,97.37587258605754,Healthcare
158028,11799,146229,7.466398359784342,92.53360164021565,Healthcare
29350,12439,16911,42.38160136286201,57.61839863713799,Housing
55938,10322,45616,18.45257249097215,81.54742750902784,Food
177447,63013,114434,35.51088494029203,64.48911505970797,Healthcare
146164,52228,93936,35.73246490243835,64.26753509756165,Healthcare
55069,31432,23637,57.07748461021628,42.922515389783726,Food
211899,34976,176923,16.5059769040911,83.4940230959089,Entertainment
58285,6414,51871,11.004546624345886,88.99545337565411,Food
188749,6102,182647,3.2328648098797874,96.76713519012021,Entertainment
37222,1749,35473,4.698834022889689,95.30116597711032,Food
42796,12479,30317,29.15926722123563,70.84073277876438,Food
181932,7061,174871,3.881120418617945,96.11887958138206,Entertainment
221035,55055,165980,24.90782002850227,75.09217997149773,Entertainment
59229,15544,43685,26.243900791841835,73.75609920815816,Food
129039,25064,103975,19.423585117677604,80.5764148823224,Healthcare
51135,12422,38713,24.292558912682118,75.70744108731789,Food
100119,54665,45454,54.60002596909678,45.39997403090322,Transportation
135515,51634,83881,38.10205512304911,61.897944876950895,Healthcare
17083,8131,8952,47.597026283439675,52.40297371656032,Housing
41439,23448,17991,56.58437703612539,43.41562296387461,Food
109393,46642,62751,42.637097437678825,57.362902562321175,Transportation
37328,928,36400,2.4860694384912128,97.51393056150879,Food
202806,61618,141188,30.382730293975523,69.61726970602447,Entertainment
158385,695,157690,0.4388041796887332,99.56119582031127,Healthcare
106709,25334,81375,23.7412027101744,76.2587972898256,Transportation
154772,20900,133872,13.50373452562479,86.4962654743752,Healthcare
55602,28554,27048,51.35426783209237,48.64573216790763,Food
196452,59229,137223,30.14934945940993,69.85065054059007,Entertainment
35844,15242,20602,42.52315589777926,57.47684410222074,Food
116405,39350,77055,33.804389845797,66.195610154203,Transportation
82041,19954,62087,24.32198534878902,75.67801465121097,Transportation
54229,5194,49035,9.57790112301536,90.42209887698463,Food
107866,56664,51202,52.531845067027604,47.46815493297239,Transportation
38741,14931,23810,38.540564260086214,61.45943573991378,Food
46976,15652,31324,33.319141689373296,66.6808583106267,Food
121975,56860,65115,46.61610985857757,53.38389014142242,Healthcare
38778,17898,20880,46.155036360823146,53.844963639176854,Food
204045,12793,191252,6.269695410326154,93.73030458967385,Entertainment
37142,16668,20474,44.87642022508212,55.123579774917886,Food
178887,6844,172043,3.8258789067959107,96.17412109320409,Healthcare
169114,15921,153193,9.414359544449306,90.5856404555507,Healthcare
36614,10446,26168,28.530070464849512,71.46992953515048,Food
24970,4538,20432,18.17380857028434,81.82619142971565,Housing
82724,39217,43507,47.40704027851651,52.59295972148349,Transportation
41469,9933,31536,23.95283223612819,76.0471677638718,Food
32371,4700,27671,14.519168391461493,85.48083160853851,Food
55023,717,54306,1.303091434491031,98.69690856550896,Food
249834,64048,185786,25.636222451707937,74.36377754829206,Entertainment
97653,35695,61958,36.55289648039487,63.44710351960513,Transportation
105968,49522,56446,46.73297599275253,53.267024007247464,Transportation
65625,5935,59690,9.043809523809523,90.95619047619049,Transportation
47370,7723,39647,16.303567658855815,83.69643234114419,Food
124282,4815,119467,3.874253713329364,96.12574628667063,Healthcare
55556,19608,35948,35.294117647058826,64.70588235294117,Food
235914,37138,198776,15.742177234076824,84.25782276592318,Entertainment
199295,34776,164519,17.449509521061742,82.55049047893826,Entertainment
56729,26618,30111,46.92132771598301,53.07867228401699,Food
24641,3306,21335,13.416663284769287,86.5833367152307,Housing
83133,31804,51329,38.25676927333309,61.74323072666691,Transportation
168894,11789,157105,6.980117706964132,93.01988229303588,Healthcare
36091,14266,21825,39.52786013133468,60.47213986866532,Food
19984,7958,12026,39.821857485988794,60.17814251401121,Housing
63240,5223,58017,8.259013282732449,91.74098671726755,Transportation
90436,48199,42237,53.29625370427705,46.703746295722944,Transportation
204435,45490,158945,22.251571404113776,77.74842859588622,Entertainment
51434,18080,33354,35.15184508301901,64.84815491698099,Food
170511,29838,140673,17.499164276791525,82.50083572320848,Healthcare
167106,34695,132411,20.762270654554595,79.2377293454454,Healthcare
136374,31213,105161,22.887793860999896,77.11220613900011,Healthcare
143366,9707,133659,6.7707824728317725,93.22921752716823,Healthcare
120309,52601,67708,43.721583588925185,56.278416411074815,Healthcare
103348,3930,99418,3.8026860703642065,96.1973139296358,Transportation
34187,96,34091,0.2808084944569573,99.71919150554305,Food
26634,6529,20105,24.513779379740182,75.48622062025981,Housing
20061,8498,11563,42.36079956133792,57.63920043866209,Housing
228019,19367,208652,8.493590446410169,91.50640955358983,Entertainment
68046,32698,35348,48.05278782000412,51.94721217999588,Transportation
27440,760,26680,2.7696793002915454,97.23032069970844,Housing
201344,28381,172963,14.0957763827082,85.90422361729179,Entertainment
67118,6431,60687,9.581632348997289,90.41836765100271,Transportation
228235,61652,166583,27.012509036738447,72.98749096326155,Entertainment
130287,2272,128015,1.743842440151358,98.25615755984865,Healthcare
133068,54710,78358,41.1143174918087,58.88568250819131,Healthcare
18408,10897,7511,59.19708822251195,40.80291177748805,Housing
14824,2496,12328,16.83756071235834,83.16243928764166,Housing
220727,44542,176185,20.179678969949304,79.8203210300507,Entertainment
122232,68243,53989,55.830715360952944,44.169284639047056,Healthcare
232213,52412,179801,22.570657112220246,77.42934288777975,Entertainment
47638,21755,25883,45.667324404886855,54.332675595113145,Food
116915,26127,90788,22.3470042338451,77.6529957661549,Transportation
76487,7520,68967,9.831736112019037,90.16826388798096,Transportation
27173,12332,14841,45.38328487837192,54.61671512162809,Housing
39450,18419,21031,46.68948035487959,53.3105196451204,Food
56178,26216,29962,46.66595464416676,53.33404535583325,Food
30447,14266,16181,46.85519098761783,53.144809012382176,Food
234880,68442,166438,29.139134877384198,70.8608651226158,Entertainment
56321,9954,46367,17.67369187336873,82.32630812663128,Food
18105,979,17126,5.407346037006352,94.59265396299365,Housing
41880,20225,21655,48.292741165234006,51.707258834766,Food
162826,42567,120259,26.142630783781463,73.85736921621854,Healthcare
17407,1624,15783,9.329580054001264,90.67041994599873,Housing
99752,15093,84659,15.130523698772958,84.86947630122704,Transportation
246186,29815,216371,12.11076178174226,87.88923821825773,Entertainment
126699,37455,89244,29.562190703951885,70.43780929604812,Healthcare
200925,59200,141725,29.46373024760483,70.53626975239517,Entertainment
206598,19400,187198,9.390216749436103,90.60978325056391,Entertainment
123783,57931,65852,46.80044917314979,53.19955082685021,Healthcare
216618,56884,159734,26.260052257891775,73.73994774210823,Entertainment
166856,1170,165686,0.7012034329002254,99.29879656709979,Healthcare
44254,357,43897,0.8067067383739323,99.19329326162607,Food
40573,8711,31862,21.469943065585486,78.53005693441452,Food
110103,21318,88785,19.36187024876706,80.63812975123294,Transportation
64925,22766,42159,35.06507508663843,64.93492491336157,Transportation
136633,32667,103966,23.908572599591608,76.09142740040839,Healthcare
39157,6868,32289,17.53964808335674,82.46035191664326,Food
131705,15484,116221,11.756577199043317,88.24342280095668,Healthcare
59632,19918,39714,33.401529380198554,66.59847061980145,Food
227830,37294,190536,16.36922266602291,83.6307773339771,Entertainment
192744,6677,186067,3.4641804673556633,96.53581953264434,Entertainment
212637,44495,168142,20.92533284423689,79.07466715576311,Entertainment
13912,4171,9741,29.981311098332377,70.01868890166763,Housing
95063,30373,64690,31.950390793473805,68.0496092065262,Transportation
243443,40256,203187,16.53610906865262,83.46389093134738,Entertainment
70969,4784,66185,6.740971410052277,93.25902858994772,Transportation
43348,22715,20633,52.40149487865645,47.59850512134354,Food
11951,3986,7965,33.352857501464314,66.64714249853569,Housing
138938,35511,103427,25.558882379190717,74.44111762080928,Healthcare
48837,17892,30945,36.63615701210148,63.36384298789852,Food
73242,17618,55624,24.054504246197535,75.94549575380246,Transportation
222601,33833,188768,15.198943400973041,84.80105659902696,Entertainment
145136,3515,141621,2.4218663873883806,97.57813361261162,Healthcare
27296,140,27156,0.5128956623681126,99.48710433763188,Housing
29839,4132,25707,13.847649049901136,86.15235095009886,Housing
22222,8700,13522,39.15039150391504,60.84960849608496,Housing
125553,21809,103744,17.370353555868835,82.62964644413117,Healthcare
241895,4694,237201,1.94051137890407,98.05948862109592,Entertainment
19833,2365,17468,11.92457016084304,88.07542983915695,Housing
249992,23528,226464,9.411501168037377,90.58849883196262,Entertainment
58820,23339,35481,39.67868072084325,60.32131927915675,Food
78020,14411,63609,18.470904896180468,81.52909510381954,Transportation
98470,29534,68936,29.992891235909415,70.00710876409059,Transportation
35985,13369,22616,37.15159094066972,62.84840905933028,Food
214810,26706,188104,12.43238210511615,87.56761789488385,Entertainment
139633,26834,112799,19.217520213703065,80.78247978629693,Healthcare
87399,19912,67487,22.78286936921475,77.21713063078525,Transportation
20960,8582,12378,40.94465648854962,59.05534351145039,Housing
31613,11306,20307,35.76376807009775,64.23623192990226,Food
58786,16378,42408,27.86037491919845,72.13962508080155,Food
40057,21968,18089,54.84185036323239,45.15814963676761,Food
108356,7050,101306,6.506330983055852,93.49366901694415,Transportation
211394,57439,153955,27.17153750816012,72.82846249183989,Entertainment
29470,140,29330,0.4750593824228029,99.5249406175772,Housing
181480,37018,144462,20.397839982367202,79.6021600176328,Entertainment
235209,59526,175683,25.30770506230629,74.69229493769372,Entertainment
54515,30478,24037,55.907548381179495,44.09245161882051,Food
47376,20276,27100,42.798041202296524,57.201958797703476,Food
85427,49253,36174,57.655073922764466,42.344926077235534,Transportation
16550,9629,6921,58.18126888217523,41.818731117824775,Housing
31440,2119,29321,6.739821882951653,93.26017811704834,Food
23350,9522,13828,40.779443254817984,59.220556745182016,Housing
120808,62508,58300,51.74160651612476,48.25839348387524,Healthcare
183653,41340,142313,22.509841930161773,77.49015806983823,Entertainment
153200,7490,145710,4.889033942558747,95.11096605744125,Healthcare
142456,16800,125656,11.793115067108442,88.20688493289155,Healthcare
85284,24461,60823,28.68181604990385,71.31818395009614,Transportation
24181,9887,14294,40.88747363632604,59.11252636367396,Housing
208983,67602,141381,32.348085729461246,67.65191427053875,Entertainment
198175,20969,177206,10.581052100416299,89.4189478995837,Entertainment
21456,1218,20238,5.676733780760626,94.32326621923937,Housing
57146,11993,45153,20.986595737234452,79.01340426276555,Food
146249,60091,86158,41.088144192438925,58.911855807561075,Healthcare
172504,53112,119392,30.78885127301396,69.21114872698604,Healthcare
202188,8576,193612,4.2415969295902824,95.75840307040971,Entertainment
222486,14851,207635,6.675026743255755,93.32497325674424,Entertainment
51181,14611,36570,28.547703249252653,71.45229675074735,Food
19666,2778,16888,14.125902572968574,85.87409742703143,Housing
65530,31889,33641,48.66320769113383,51.336792308866166,Transportation
26556,11914,14642,44.86368428980268,55.136315710197316,Housing
180758,45121,135637,24.962104028590712,75.03789597140928,Entertainment
34653,9084,25569,26.214180590425073,73.78581940957493,Food
45419,61,45358,0.13430502653074702,99.86569497346926,Food
155346,64333,91013,41.412717417892964,58.587282582107036,Healthcare
49302,22078,27224,44.78114478114478,55.218855218855225,Food
218443,6131,212312,2.8066818346204734,97.19331816537952,Entertainment
89061,16658,72403,18.70403431356037,81.29596568643963,Transportation
213213,39409,173804,18.48339453973257,81.51660546026743,Entertainment
57943,34624,23319,59.755276737483385,40.244723262516615,Food
108571,47656,60915,43.893857475753194,56.106142524246806,Transportation
124562,21672,102890,17.398564570254173,82.60143542974583,Healthcare
52875,10011,42864,18.933333333333334,81.06666666666666,Food
24438,6774,17664,27.719125951387184,72.28087404861282,Housing
83918,32295,51623,38.483996282084895,61.51600371791511,Transportation
21735,11421,10314,52.54658385093167,47.453416149068325,Housing
208123,14460,193663,6.947814513532863,93.05218548646714,Entertainment
172192,36963,135229,21.466154060583534,78.53384593941647,Healthcare
227586,9678,217908,4.252458411325828,95.74754158867417,Entertainment
46888,14967,31921,31.920747312745267,68.07925268725474,Food
39074,4375,34699,11.196703690433536,88.80329630956646,Food
55084,14520,40564,26.359741485730886,73.64025851426912,Food
84239,24587,59652,29.187193580170707,70.8128064198293,Transportation
130582,57975,72607,44.3973901456556,55.6026098543444,Healthcare
11329,4626,6703,40.83325977579663,59.16674022420337,Housing
183364,68888,114476,37.56898846011213,62.43101153988787,Entertainment
184658,62086,122572,33.62215555242665,66.37784444757335,Entertainment
203839,57067,146772,27.996114580624905,72.0038854193751,Entertainment
115365,34827,80538,30.188532050448575,69.81146794955141,Transportation
224172,11260,212912,5.022928822511286,94.97707117748871,Entertainment
77503,5811,71692,7.497774279705302,92.50222572029469,Transportation
10251,6138,4113,59.877085162423185,40.12291483757682,Housing
41604,5418,36186,13.02278627055091,86.97721372944909,Food
42543,10469,32074,24.608043626448534,75.39195637355147,Food
77650,15245,62405,19.632968448164842,80.36703155183515,Transportation
248257,6200,242057,2.497411956158336,97.50258804384167,Entertainment
56996,11242,45754,19.724191171310267,80.27580882868973,Food
56729,13339,43390,23.51354686315641,76.4864531368436,Food
171387,14879,156508,8.681521935736082,91.31847806426391,Healthcare
202342,56032,146310,27.691729843532237,72.30827015646776,Entertainment
245761,22539,223222,9.171105260802163,90.82889473919784,Entertainment
148575,25711,122864,17.305064782096586,82.69493521790342,Healthcare
122332,59105,63227,48.315240493084396,51.68475950691561,Healthcare
48636,6248,42388,12.8464511884201,87.1535488115799,Food
245827,6704,239123,2.727121105492887,97.2728788945071,Entertainment
56123,25838,30285,46.03816617073214,53.96183382926786,Food
150974,63109,87865,41.8012372991376,58.1987627008624,Healthcare
40335,22593,17742,56.013387876534026,43.986612123465974,Food
36704,9960,26744,27.136006974716654,72.86399302528335,Food
58821,9788,49033,16.640315533567943,83.35968446643206,Food
120365,34786,85579,28.900427865243216,71.09957213475678,Healthcare
22088,7856,14232,35.56682361463238,64.43317638536762,Housing
19978,8187,11791,40.98007808589448,59.01992191410551,Housing
60621,29115,31506,48.02791111990894,51.972088880091064,Transportation
225710,37323,188387,16.535820300385453,83.46417969961455,Entertainment
168397,60977,107420,36.21026502847438,63.789734971525625,Healthcare
130817,9287,121530,7.099230222371711,92.90076977762828,Healthcare
35058,8910,26148,25.415026527468765,74.58497347253123,Food
223565,26453,197112,11.832353006955472,88.16764699304453,Entertainment
58276,17457,40819,29.955727915436885,70.0442720845631,Food
125321,47236,78085,37.69200692621348,62.30799307378652,Healthcare
228857,49117,179740,21.46187357170635,78.53812642829365,Entertainment
15313,3426,11887,22.37314699928166,77.62685300071834,Housing
141374,43431,97943,30.72064170215174,69.27935829784826,Healthcare
126441,35122,91319,27.77738233642568,72.22261766357431,Healthcare
36974,8379,28595,22.66187050359712,77.33812949640287,Food
17560,8105,9455,46.15603644646925,53.84396355353075,Housing
227320,14160,213160,6.22910434629597,93.77089565370403,Entertainment
211241,42033,169208,19.898125837313778,80.10187416268623,Entertainment
189676,2492,187184,1.3138193551108206,98.68618064488918,Entertainment
102009,37691,64318,36.9487006048486,63.0512993951514,Transportation
224567,57151,167416,25.44942044022497,74.55057955977503,Entertainment
52667,24120,28547,45.79717849887026,54.20282150112974,Food
177799,35041,142758,19.708209832451253,80.29179016754875,Healthcare
12844,3551,9293,27.64715042042977,72.35284957957022,Housing
52922,15006,37916,28.35493745512263,71.64506254487736,Food
92927,33634,59293,36.194001743303886,63.805998256696114,Transportation
176165,59804,116361,33.94771946754463,66.05228053245537,Healthcare
11032,2902,8130,26.305293691080493,73.6947063089195,Housing
202058,50191,151867,24.839897455186136,75.16010254481387,Entertainment
47098,15663,31435,33.256189222472294,66.74381077752771,Food
189661,61175,128486,32.25491798524736,67.74508201475264,Entertainment
16223,1944,14279,11.982987117056032,88.01701288294397,Housing
111035,36519,74516,32.88962939613636,67.11037060386364,Transportation
16484,6430,10054,39.00752244600825,60.992477553991755,Housing
123273,42625,80648,34.57772586048851,65.4222741395115,Healthcare
239422,67173,172249,28.056318968181703,71.9436810318183,Entertainment
57263,2619,54644,4.573633934652394,95.42636606534761,Food
17353,1923,15430,11.081657350314067,88.91834264968594,Housing
82472,33873,48599,41.07212144727907,58.92787855272093,Transportation
116350,39823,76527,34.22690159003008,65.77309840996992,Transportation
121314,23563,97751,19.42314984255733,80.57685015744266,Healthcare
19103,3311,15792,17.332356174422866,82.66764382557713,Housing
239310,19594,219716,8.187706322343404,91.8122936776566,Entertainment
166111,45715,120396,27.52075419448441,72.47924580551559,Healthcare
17102,1549,15553,9.057420184773711,90.94257981522628,Housing
14360,3546,10814,24.69359331476323,75.30640668523677,Housing
12844,6058,6786,47.16599190283401,52.834008097166,Housing
42509,11855,30654,27.88821190806653,72.11178809193348,Food
54441,7786,46655,14.301721129295936,85.69827887070407,Food
45494,16115,29379,35.42225348397591,64.57774651602409,Food
44149,16681,27468,37.78341525289361,62.21658474710638,Food
245907,39615,206292,16.109748807475995,83.890251192524,Entertainment
40194,8123,32071,20.20948400258745,79.79051599741254,Food
204439,1479,202960,0.7234431786498663,99.27655682135014,Entertainment
41396,16427,24969,39.682578026862494,60.3174219731375,Food
86339,8923,77416,10.33484288676033,89.66515711323967,Transportation
73516,27579,45937,37.51428260514718,62.48571739485283,Transportation
37530,7923,29607,21.11111111111111,78.88888888888889,Food
69015,14961,54054,21.677896109541404,78.32210389045859,Transportation
12393,5473,6920,44.16202695069798,55.83797304930202,Housing
35147,17366,17781,49.40962244288275,50.59037755711725,Food
194202,6652,187550,3.4252994304899023,96.5747005695101,Entertainment
218596,44949,173647,20.562590349320207,79.4374096506798,Entertainment
83055,5416,77639,6.520980073445308,93.4790199265547,Transportation
109671,29767,79904,27.142088610480435,72.85791138951956,Transportation
242312,42602,199710,17.581465218396115,82.41853478160388,Entertainment
241876,3715,238161,1.5359109626420149,98.46408903735798,Entertainment
85659,14015,71644,16.361386427579124,83.63861357242088,Transportation
149948,21381,128567,14.258943100274763,85.74105689972524,Healthcare
235095,64228,170867,27.3200195665582,72.6799804334418,Entertainment
131972,65624,66348,49.725699390779866,50.274300609220134,Healthcare
17446,4032,13414,23.111314914593603,76.8886850854064,Housing
248204,42054,206150,16.943320816747516,83.05667918325248,Entertainment
13677,2876,10801,21.028003217079767,78.97199678292023,Housing
117563,63068,54495,53.646130159999316,46.353869840000684,Transportation
10151,3665,6486,36.10481725938331,63.89518274061668,Housing
49319,9045,40274,18.339787911352623,81.66021208864737,Food
142063,3434,138629,2.4172374228335314,97.58276257716648,Healthcare
63330,7199,56131,11.367440391599558,88.63255960840044,Transportation
152028,56008,96020,36.84058199805299,63.15941800194701,Healthcare
62328,8416,53912,13.502759594403798,86.4972404055962,Transportation
46377,131,46246,0.28246760247536495,99.71753239752464,Food
237429,3683,233746,1.5512005694333884,98.44879943056661,Entertainment
119581,44817,74764,37.47836194713207,62.521638052867935,Transportation
114165,15948,98217,13.96925502562081,86.03074497437919,Transportation
234037,24674,209363,10.542777424082516,89.45722257591748,Entertainment
70743,32119,38624,45.40237196613092,54.59762803386907,Transportation
12720,1976,10744,15.534591194968552,84.46540880503144,Housing
104976,26303,78673,25.056203322664228,74.94379667733577,Transportation
93709,21405,72304,22.841989563435742,77.15801043656427,Transportation
30902,12436,18466,40.24334994498738,59.756650055012614,Food
93382,44583,48799,47.742605641344156,52.25739435865584,Transportation
155367,53026,102341,34.12951270218257,65.87048729781742,Healthcare
52099,9787,42312,18.78538935488205,81.21461064511794,Food
190437,31812,158625,16.704736999637674,83.29526300036233,Entertainment
84158,31947,52211,37.96074051189429,62.0392594881057,Transportation
22007,5410,16597,24.583087199527423,75.41691280047257,Housing
154731,28356,126375,18.325998022374314,81.6740019776257,Healthcare
37514,22472,15042,59.90296955803167,40.097030441968336,Food
67335,4283,63052,6.360733645206802,93.6392663547932,Transportation
163024,50034,112990,30.691186573756013,69.30881342624399,Healthcare
111637,46669,64968,41.804240529573526,58.19575947042647,Transportation
39720,19663,20057,49.50402819738167,50.495971802618335,Food
122494,43362,79132,35.39928486293206,64.60071513706794,Healthcare
31649,3595,28054,11.358968687794244,88.64103131220575,Food
88731,36493,52238,41.1276780381152,58.8723219618848,Transportation
25638,10820,14818,42.2029799516343,57.79702004836571,Housing
120151,7809,112342,6.499321686877346,93.50067831312265,Healthcare
28549,14548,14001,50.95800203159481,49.0419979684052,Housing
207261,51550,155711,24.872021267869982,75.12797873213002,Entertainment
45489,22712,22777,49.92855415594979,50.07144584405021,Food
159823,44709,115114,27.97407131639376,72.02592868360624,Healthcare
52097,12823,39274,24.613701364761887,75.38629863523812,Food
244193,57511,186682,23.55145315385781,76.4485468461422,Entertainment
30481,11953,18528,39.21459269708999,60.78540730291001,Food
20857,1664,19193,7.9781368365536744,92.02186316344633,Housing
45377,12157,33220,26.79110562619829,73.2088943738017,Food
27165,6518,20647,23.994110068102337,76.00588993189767,Housing
101479,11952,89527,11.777806245627174,88.22219375437282,Transportation
89523,32398,57125,36.18958256537426,63.81041743462574,Transportation
67305,13398,53907,19.906396255850233,80.09360374414976,Transportation
218731,54596,164135,24.96033941233753,75.03966058766247,Entertainment
180182,58271,121911,32.34007836520851,67.65992163479149,Entertainment
151217,63663,87554,42.100425216741506,57.8995747832585,Healthcare
56819,25785,31034,45.380946514370194,54.619053485629806,Food
170579,2784,167795,1.6320883578869614,98.36791164211304,Healthcare
236198,21061,215137,8.916671606025453,91.08332839397455,Entertainment
189222,7207,182015,3.808753738994409,96.19124626100559,Entertainment
194123,66085,128038,34.04284912143331,65.95715087856668,Entertainment
17203,1814,15389,10.54467244085334,89.45532755914665,Housing
43613,16073,27540,36.85369041340885,63.14630958659115,Food
154901,18553,136348,11.977327454309526,88.02267254569047,Healthcare
155305,66221,89084,42.63932262322527,57.36067737677474,Healthcare
14288,4493,9795,31.445968645016798,68.55403135498321,Housing
202750,35251,167499,17.38643649815043,82.61356350184957,Entertainment
37407,6516,30891,17.41919961504531,82.58080038495469,Food
176704,39703,137001,22.468648134733794,77.5313518652662,Healthcare
30026,2603,27423,8.669153400386332,91.33084659961366,Food
219551,29085,190466,13.24749147122992,86.75250852877008,Entertainment
47223,15079,32144,31.93147406983885,68.06852593016114,Food
26355,946,25409,3.589451716941757,96.41054828305823,Housing
248686,3736,244950,1.5022960681341129,98.49770393186589,Entertainment
28971,4804,24167,16.58209934072003,83.41790065927997,Housing
97181,14080,83101,14.488428808100348,85.51157119189965,Transportation
221183,42095,179088,19.03175198817269,80.96824801182731,Entertainment
68879,34840,34039,50.58145443458819,49.41854556541181,Transportation
67238,3044,64194,4.527201879889349,95.47279812011065,Transportation
109520,47459,62061,43.3336376917458,56.6663623082542,Transportation
92669,6488,86181,7.001262558137025,92.99873744186297,Transportation
91091,40482,50609,44.44127301270158,55.558726987298414,Transportation
121673,25035,96638,20.57564126798879,79.42435873201121,Healthcare
42178,19847,22331,47.05533690549576,52.94466309450424,Food
14442,2905,11537,20.114942528735632,79.88505747126436,Housing
237917,8905,229012,3.742901936389581,96.25709806361041,Entertainment
107955,57708,50247,53.455606502709465,46.544393497290535,Transportation
27799,15816,11983,56.89413288247779,43.10586711752221,Housing
231291,17400,213891,7.522990518437813,92.47700948156219,Entertainment
153386,64671,88715,42.16225731161905,57.83774268838094,Healthcare
69463,15102,54361,21.74107078588601,78.25892921411399,Transportation
19635,3997,15638,20.35650623885918,79.64349376114082,Housing
214184,55778,158406,26.042094647592723,73.95790535240727,Entertainment
215785,43434,172351,20.128368514957018,79.87163148504298,Entertainment
11662,6477,5185,55.539358600583085,44.460641399416915,Housing
122994,61597,61397,50.081304779094914,49.918695220905086,Healthcare
23173,8278,14895,35.722608207828074,64.27739179217193,Housing
15981,6995,8986,43.77072773919029,56.229272260809715,Housing
227799,69393,158406,30.46238130983894,69.53761869016107,Entertainment
200750,10096,190654,5.029140722291407,94.9708592777086,Entertainment
179897,22359,157538,12.428778690028183,87.57122130997182,Healthcare
154970,33997,120973,21.937794411821642,78.06220558817836,Healthcare
178807,15249,163558,8.528189612263501,91.4718103877365,Healthcare
224000,3514,220486,1.56875,98.43125,Entertainment
41692,23456,18236,56.26019380216828,43.73980619783172,Food
183911,33267,150644,18.088640701208735,81.91135929879127,Entertainment
136381,5456,130925,4.000557262375257,95.99944273762475,Healthcare
47186,13849,33337,29.34980714618743,70.65019285381257,Food
26265,15472,10793,58.90729107176851,41.09270892823149,Housing
208048,9122,198926,4.384565100361455,95.61543489963854,Entertainment
204937,62121,142816,30.31224229885282,69.68775770114718,Entertainment
41041,1373,39668,3.3454350527521255,96.65456494724788,Food
21362,6968,14394,32.618668663982774,67.38133133601723,Housing
46657,27773,18884,59.52590179394303,40.47409820605697,Food
249052,65750,183302,26.400109214140016,73.59989078585998,Entertainment
235594,56738,178856,24.08295627223104,75.91704372776896,Entertainment
73561,5042,68519,6.8541754462283,93.14582455377169,Transportation
50706,27876,22830,54.97574251567862,45.02425748432138,Food
112857,35864,76993,31.778268073757054,68.22173192624294,Transportation
27943,7902,20041,28.278996528647603,71.72100347135239,Housing
15972,3509,12463,21.96969696969697,78.03030303030303,Housing
46064,26117,19947,56.69720389023966,43.30279610976034,Food
53591,31512,22079,58.8009180646004,41.1990819353996,Food
153797,6846,146951,4.4513221974420825,95.54867780255792,Healthcare
174130,21582,152548,12.394188250157928,87.60581174984208,Healthcare
174725,5334,169391,3.052797252825869,96.94720274717413,Healthcare
46731,21095,25636,45.14134086580642,54.85865913419358,Food
231743,21791,209952,9.403088766435232,90.59691123356477,Entertainment
142839,55848,86991,39.09856551782077,60.90143448217924,Healthcare
20282,7689,12593,37.91046247904546,62.08953752095454,Housing
71364,11181,60183,15.667563477383556,84.33243652261645,Transportation
129869,25634,104235,19.738351723659996,80.26164827634,Healthcare
106580,15526,91054,14.567461062112965,85.43253893788703,Transportation
34817,1432,33385,4.11293333716288,95.88706666283711,Food
220679,10952,209727,4.9628646133071115,95.03713538669288,Entertainment
111246,61293,49953,55.09681246966183,44.903187530338165,Transportation
76432,40114,36318,52.48325308771196,47.51674691228805,Transportation
23312,9806,13506,42.06417295813315,57.93582704186685,Housing
118840,42977,75863,36.16374957926624,63.83625042073376,Transportation
232490,56687,175803,24.382554088347884,75.61744591165211,Entertainment
215126,42404,172722,19.711238994821638,80.28876100517836,Entertainment
55156,29878,25278,54.169990572195225,45.830009427804775,Food
61838,11463,50375,18.53714544454866,81.46285455545133,Transportation
53288,10849,42439,20.35918030325777,79.64081969674223,Food
234531,12610,221921,5.376687943171691,94.62331205682831,Entertainment
65659,31431,34228,47.870055894850665,52.12994410514933,Transportation
20987,2599,18388,12.383856673178634,87.61614332682136,Housing
124659,25962,98697,20.82641445864318,79.17358554135681,Healthcare
48889,26796,22093,54.80987543210129,45.19012456789871,Food
38382,7390,30992,19.25381689333542,80.74618310666459,Food
139490,5198,134292,3.7264320022940716,96.27356799770594,Healthcare
19309,7952,11357,41.18286809259931,58.8171319074007,Housing
165249,14642,150607,8.860567991334289,91.13943200866571,Healthcare
10930,5328,5602,48.746569075937785,51.253430924062215,Housing
103150,18131,85019,17.577314590402327,82.42268540959768,Transportation
79260,39004,40256,49.21019429724956,50.78980570275044,Transportation
33900,19296,14604,56.92035398230089,43.07964601769911,Food
49928,23251,26677,46.56905944560167,53.43094055439833,Food
56725,27414,29311,48.327897752313795,51.672102247686205,Food
30932,15447,15485,49.93857493857494,50.061425061425055,Food
216125,29732,186393,13.756853672643146,86.24314632735685,Entertainment
168733,25787,142946,15.282724778199878,84.71727522180012,Healthcare
27942,10432,17510,37.3344785627371,62.6655214372629,Housing
227781,3449,224332,1.514173701932997,98.485826298067,Entertainment
27306,13033,14273,47.729436753826995,52.270563246173005,Housing
34384,17433,16951,50.70090739879014,49.299092601209864,Food
65953,21031,44922,31.88785953633648,68.11214046366352,Transportation
29795,14037,15758,47.11193153213627,52.88806846786373,Housing
105545,61129,44416,57.91747595812213,42.082524041877875,Transportation
139860,41190,98670,29.45087945087945,70.54912054912054,Healthcare
247438,60901,186537,24.61263023464464,75.38736976535536,Entertainment
177402,33194,144208,18.711175747736778,81.28882425226323,Healthcare
13978,7292,6686,52.167692087566174,47.832307912433826,Housing
27773,11418,16355,41.1118712418536,58.888128758146394,Housing
31172,5722,25450,18.35621711792634,81.64378288207365,Food
18325,1306,17019,7.1268758526603,92.87312414733971,Housing
64049,4172,59877,6.513762900279474,93.48623709972053,Transportation
43758,4394,39364,10.041592394533572,89.95840760546643,Food
164282,29984,134298,18.251543078365252,81.74845692163476,Healthcare
41254,240,41014,0.5817617685557764,99.41823823144422,Food
38928,23031,15897,59.1630702836005,40.8369297163995,Food
197569,62358,135211,31.5626439370549,68.4373560629451,Entertainment
58285,29490,28795,50.596208286866265,49.403791713133735,Food
38149,6881,31268,18.03717004377572,81.96282995622428,Food
187670,18204,169466,9.700005328502158,90.29999467149784,Entertainment
54084,12151,41933,22.466903335552104,77.5330966644479,Food
113859,62689,51170,55.05844948576748,44.94155051423252,Transportation
17071,535,16536,3.133969890457501,96.8660301095425,Housing
28843,7781,21062,26.977082827722498,73.0229171722775,Housing
191009,13237,177772,6.930039945761718,93.06996005423828,Entertainment
37997,7258,30739,19.101508013790564,80.89849198620944,Food
153328,11440,141888,7.461129082750705,92.5388709172493,Healthcare
18522,196,18326,1.0582010582010581,98.94179894179894,Housing
17215,2457,14758,14.27243682834737,85.72756317165263,Housing
15015,5494,9521,36.59007659007659,63.40992340992341,Housing
186018,48353,137665,25.993721037749033,74.00627896225096,Entertainment
149977,2407,147570,1.6049127532888376,98.39508724671117,Healthcare
80787,9524,71263,11.789025462017404,88.2109745379826,Transportation
36906,18357,18549,49.73987969435864,50.26012030564135,Food
34038,10957,23081,32.19049297843586,67.80950702156413,Food
39250,14289,24961,36.40509554140127,63.59490445859872,Food
79135,7817,71318,9.878056485752197,90.1219435142478,Transportation
105025,25110,79915,23.90859319209712,76.09140680790289,Transportation
232533,8920,223613,3.8360146731861713,96.16398532681383,Entertainment
112397,15291,97106,13.604455634936876,86.39554436506313,Transportation
128348,11154,117194,8.69043537881385,91.30956462118614,Healthcare
15474,5810,9664,37.546852785317306,62.453147214682694,Housing
45171,5714,39457,12.649708884018507,87.35029111598149,Food
51388,16769,34619,32.63213201525648,67.36786798474353,Food
138073,5619,132454,4.069586378220217,95.93041362177979,Healthcare
11223,4059,7164,36.16680032076985,63.833199679230155,Housing
145339,37237,108102,25.620790015068216,74.37920998493178,Healthcare
35676,18911,16765,53.00762417311358,46.99237582688642,Food
246087,48542,197545,19.725544218101728,80.27445578189827,Entertainment
144506,1222,143284,0.8456396274203147,99.15436037257969,Healthcare
77844,34496,43348,44.31426956477056,55.68573043522943,Transportation
56959,29254,27705,51.35974999561088,48.640250004389124,Food
175821,2628,173193,1.4947019980548397,98.50529800194516,Healthcare
51807,19606,32201,37.844306753913564,62.15569324608644,Food
16483,6481,10002,39.31929867135837,60.68070132864163,Housing
26312,10567,15745,40.160383095165706,59.839616904834294,Housing
249371,69884,179487,28.024108657381973,71.97589134261803,Entertainment
46084,19789,26295,42.94115094175853,57.05884905824147,Food
104297,14917,89380,14.302424806082628,85.69757519391737,Transportation
133627,1890,131737,1.4143848174395892,98.58561518256042,Healthcare
20819,5429,15390,26.077141073058264,73.92285892694174,Housing
38051,9660,28391,25.386980631258048,74.61301936874194,Food
47222,24281,22941,51.41883020625979,48.5811697937402,Food
218481,46104,172377,21.102063795021078,78.89793620497892,Entertainment
174944,23003,151941,13.148779037863545,86.85122096213645,Healthcare
192799,36258,156541,18.806114139596158,81.19388586040384,Entertainment
69073,8343,60730,12.07852561782462,87.92147438217538,Transportation
229418,16413,213005,7.154190168164661,92.84580983183534,Entertainment
54545,29998,24547,54.99679163993033,45.00320836006967,Food
135308,69272,66036,51.19579034499069,48.80420965500931,Healthcare
82642,7507,75135,9.08375886353186,90.91624113646813,Transportation
58069,30342,27727,52.25163167955363,47.74836832044637,Food
53536,6697,46839,12.50933950986252,87.49066049013747,Food
240841,63663,177178,26.433622182269627,73.56637781773037,Entertainment
234133,25519,208614,10.89936061981865,89.10063938018135,Entertainment
72277,26989,45288,37.341062855403514,62.658937144596486,Transportation
24656,14644,10012,59.393251135626215,40.606748864373785,Housing
249915,51646,198269,20.665426244923275,79.33457375507673,Entertainment
141591,6945,134646,4.904972773693244,95.09502722630675,Healthcare
64641,34464,30177,53.31600686870562,46.68399313129438,Transportation
55089,13048,42041,23.685309226887398,76.3146907731126,Food
15415,6134,9281,39.79240999026922,60.20759000973078,Housing
149880,19323,130557,12.892313851080864,87.10768614891914,Healthcare
233782,49341,184441,21.1055598805725,78.8944401194275,Entertainment
85388,11439,73949,13.39649599475336,86.60350400524663,Transportation
119644,62364,57280,52.12463642138344,47.875363578616565,Transportation
85001,20936,64065,24.63029846707686,75.36970153292314,Transportation
209075,58878,150197,28.161186177209135,71.83881382279085,Entertainment
69840,14302,55538,20.47823596792669,79.5217640320733,Transportation
59506,27306,32200,45.88780963264208,54.11219036735792,Food
230655,3791,226864,1.6435802388849146,98.35641976111509,Entertainment
79471,13560,65911,17.062827949818175,82.93717205018183,Transportation
106074,50973,55101,48.054188585327225,51.94581141467277,Transportation
12110,3046,9064,25.152766308835673,74.84723369116433,Housing
198604,61338,137266,30.884574328815127,69.11542567118487,Entertainment
89872,23716,66156,26.38864162364251,73.61135837635749,Transportation
13224,214,13010,1.61826981246219,98.38173018753781,Housing
138066,23217,114849,16.81587067054887,83.18412932945112,Healthcare
142739,3187,139552,2.2327464813400684,97.76725351865994,Healthcare
15890,4186,11704,26.343612334801765,73.65638766519824,Housing
146765,56771,89994,38.68156576840527,61.31843423159473,Healthcare
50009,22502,27507,44.99590073786718,55.00409926213281,Food
47180,14244,32936,30.19075879610004,69.80924120389996,Food
121884,11310,110574,9.279314758294772,90.72068524170523,Healthcare
57132,1210,55922,2.1179024014562766,97.88209759854372,Food
53569,22163,31406,41.372808900670165,58.627191099329835,Food
28326,15819,12507,55.84621902139377,44.15378097860623,Housing
24019,6491,17528,27.024438985802906,72.9755610141971,Housing
18226,5373,12853,29.479863930648527,70.52013606935148,Housing
89401,35238,54163,39.41566649142627,60.58433350857373,Transportation
14021,6875,7146,49.0335924684402,50.966407531559796,Housing
56766,2645,54121,4.659479265757672,95.34052073424233,Food
174092,49555,124537,28.464834685109025,71.53516531489097,Healthcare
44226,7731,36495,17.48066748066748,82.51933251933252,Food
36582,17579,19003,48.05368760592641,51.94631239407359,Food
10395,6029,4366,57.999037999037995,42.000962000962,Housing
178916,45246,133670,25.288962418118,74.711037581882,Healthcare
49173,3842,45331,7.813230838061538,92.18676916193846,Food
18943,5350,13593,28.242622604656077,71.75737739534392,Housing
164468,64013,100455,38.92124911836953,61.07875088163047,Healthcare
14236,3967,10269,27.86597358808654,72.13402641191345,Housing
190775,2944,187831,1.5431791377276898,98.45682086227231,Entertainment
24935,10980,13955,44.03448967315019,55.96551032684981,Housing
132956,2205,130751,1.6584433948073047,98.3415566051927,Healthcare
43326,3082,40244,7.113511517333702,92.8864884826663,Food
246103,12647,233456,5.13890525511676,94.86109474488325,Entertainment
112165,47136,65029,42.02380421700174,57.97619578299826,Transportation
16477,9553,6924,57.977787218547064,42.022212781452936,Housing
47726,10097,37629,21.156183212504715,78.84381678749529,Food
171733,26620,145113,15.500806484484636,84.49919351551537,Healthcare
238147,54829,183318,23.023174761806782,76.97682523819321,Entertainment
167126,46437,120689,27.78562282349844,72.21437717650157,Healthcare
206849,24649,182200,11.91642212435158,88.08357787564842,Entertainment
120399,22145,98254,18.393009908720174,81.60699009127983,Healthcare
97853,14575,83278,14.894791166341347,85.10520883365865,Transportation
32893,9150,23743,27.81746876235065,72.18253123764936,Food
17202,4779,12423,27.781653296128354,72.21834670387165,Housing
69554,23320,46234,33.527906374902955,66.47209362509705,Transportation
120208,59690,60518,49.655596965260216,50.344403034739784,Healthcare
15707,5107,10600,32.51416565862355,67.48583434137646,Housing
241101,67361,173740,27.93891356734315,72.06108643265685,Entertainment
24473,8711,15762,35.594328443590896,64.4056715564091,Housing
231109,28373,202736,12.276890990831166,87.72310900916884,Entertainment
11342,801,10541,7.062246517369071,92.93775348263092,Housing
240350,68198,172152,28.37445392136468,71.62554607863532,Entertainment
12192,6570,5622,53.887795275590555,46.11220472440945,Housing
18325,7249,11076,39.55798090040928,60.44201909959072,Housing
11978,5879,6099,49.081649691100345,50.918350308899655,Housing
12110,715,11395,5.904211395540875,94.09578860445913,Housing
62141,15832,46309,25.477543007032395,74.5224569929676,Transportation
28607,6070,22537,21.218582864333904,78.7814171356661,Housing
223430,56099,167331,25.10808754419729,74.89191245580271,Entertainment
126807,19378,107429,15.281490769437017,84.71850923056297,Healthcare
108145,45992,62153,42.52808729021221,57.47191270978779,Transportation
36177,14813,21364,40.9459048566769,59.0540951433231,Food
28682,11518,17164,40.15759012621156,59.84240987378844,Housing
140154,25979,114175,18.536038928607105,81.4639610713929,Healthcare
119795,9411,110384,7.855920530906967,92.14407946909303,Transportation
14610,4425,10185,30.287474332648873,69.71252566735113,Housing
54559,29687,24872,54.412654190875934,45.587345809124066,Food
103922,12707,91215,12.227439810627201,87.7725601893728,Transportation
176634,64496,112138,36.513921442077965,63.486078557922035,Healthcare
236580,62014,174566,26.212697607574604,73.78730239242539,Entertainment
58499,650,57849,1.111130104788116,98.88886989521188,Food
19292,9468,9824,49.07733775658304,50.92266224341696,Housing
131886,57941,73945,43.93263879411006,56.06736120588993,Healthcare
33718,15084,18634,44.735749451331635,55.26425054866837,Food
51305,25195,26110,49.10827404736381,50.89172595263619,Food
86669,27616,59053,31.86375751422077,68.13624248577923,Transportation
231046,31762,199284,13.74704604277936,86.25295395722064,Entertainment
59679,14744,44935,24.705507800063675,75.29449219993633,Food
233827,27873,205954,11.920351370885312,88.07964862911469,Entertainment
128406,3570,124836,2.780243913835802,97.2197560861642,Healthcare
216353,61479,154874,28.416060789543014,71.58393921045698,Entertainment
199685,47276,152409,23.67528857951273,76.32471142048726,Entertainment
108410,43086,65324,39.74356609168896,60.256433908311045,Transportation
89678,46120,43558,51.428443988492155,48.57155601150784,Transportation
13330,7775,5555,58.32708177044261,41.67291822955739,Housing
40645,8528,32117,20.98167056218477,79.01832943781523,Food
121918,48846,73072,40.06463360619433,59.93536639380568,Healthcare
171410,5314,166096,3.100169184995041,96.89983081500496,Healthcare
18072,10333,7739,57.17684816290394,42.82315183709606,Housing
134911,51976,82935,38.5261394548999,61.4738605451001,Healthcare
57521,16547,40974,28.76688513760192,71.23311486239808,Food
10639,4590,6049,43.14315255193157,56.85684744806843,Housing
220851,26682,194169,12.081448578453347,87.91855142154665,Entertainment
222958,36036,186922,16.16268534881009,83.83731465118991,Entertainment
32979,12928,20051,39.200703477970826,60.79929652202917,Food
52369,8409,43960,16.05720941778533,83.94279058221467,Food
179661,2583,177078,1.4377076828026116,98.56229231719739,Healthcare
97093,37650,59443,38.77725479694726,61.22274520305274,Transportation
211705,65183,146522,30.789542051439504,69.2104579485605,Entertainment
83677,50034,33643,59.794208683389705,40.2057913166103,Transportation
19998,747,19251,3.7353735373537353,96.26462646264626,Housing
161318,33198,128120,20.57922860437149,79.4207713956285,Healthcare
138937,14386,124551,10.354333258959096,89.64566674104091,Healthcare
49550,20671,28879,41.71745711402623,58.28254288597377,Food
201682,68240,133442,33.835443916660886,66.16455608333912,Entertainment
54774,15075,39699,27.522182057180416,72.47781794281958,Food
24870,12375,12495,49.758745476477685,50.241254523522315,Housing
165892,42784,123108,25.790273189786127,74.20972681021387,Healthcare
84137,44423,39714,52.79841211357667,47.20158788642333,Transportation
162241,13464,148777,8.298765416879828,91.70123458312017,Healthcare
10683,6308,4375,59.04708415239165,40.95291584760835,Housing
83056,33425,49631,40.2439318050472,59.7560681949528,Transportation
166145,14556,151589,8.761021998856421,91.23897800114358,Healthcare
55937,3083,52854,5.5115576452080015,94.488442354792,Food
16319,699,15620,4.283350695508304,95.7166493044917,Housing
42248,15082,27166,35.69873130088999,64.30126869911001,Food
22409,9931,12478,44.31701548484984,55.68298451515016,Housing
19201,1051,18150,5.473673246185094,94.5263267538149,Housing
137341,21297,116044,15.506658608864068,84.49334139113593,Healthcare
65797,22839,42958,34.7113090262474,65.28869097375261,Transportation
16142,6235,9907,38.6259447404287,61.3740552595713,Housing
198198,40220,157978,20.29283847465666,79.70716152534334,Entertainment
59100,3383,55717,5.7241962774957695,94.27580372250422,Food
25199,7235,17964,28.711456803841422,71.28854319615859,Housing
53241,24656,28585,46.310174489585094,53.6898255104149,Food
56704,17485,39219,30.835567155756205,69.16443284424379,Food
24621,10399,14222,42.23630234352788,57.76369765647211,Housing
65698,11264,54434,17.14511857286371,82.85488142713629,Transportation
138887,15044,123843,10.831827312851456,89.16817268714856,Healthcare
228870,21630,207240,9.450779918731158,90.54922008126884,Entertainment
22875,469,22406,2.050273224043716,97.94972677595628,Housing
42960,13343,29617,31.059124767225327,68.94087523277467,Food
240627,45,240582,0.018701143263224824,99.98129885673677,Entertainment
162505,43389,119116,26.700101535337375,73.29989846466263,Healthcare
68767,24444,44323,35.546119504995126,64.45388049500487,Transportation
32024,15516,16508,48.451161628778415,51.548838371221585,Food
86298,33518,52780,38.83983406336184,61.16016593663816,Transportation
219102,63655,155447,29.05267866108023,70.94732133891978,Entertainment
121974,13732,108242,11.258136980012132,88.74186301998786,Healthcare
226627,24093,202534,10.63112515278409,89.3688748472159,Entertainment
44645,15659,28986,35.07447642513159,64.92552357486841,Food
19794,11578,8216,58.49247246640395,41.50752753359604,Housing
229485,14095,215390,6.14201363923568,93.85798636076433,Entertainment
137483,6746,130737,4.906788475666082,95.09321152433392,Healthcare
46525,4459,42066,9.584094572810317,90.41590542718968,Food
45206,762,44444,1.6856169535017476,98.31438304649825,Food
39984,6220,33764,15.556222488995598,84.4437775110044,Food
119286,25096,94190,21.038512482604833,78.96148751739517,Transportation
190567,14600,175967,7.661347452601971,92.33865254739803,Entertainment
172320,54000,118320,31.337047353760443,68.66295264623955,Healthcare
205310,33490,171820,16.311918562174274,83.68808143782573,Entertainment
27747,2894,24853,10.429956391681984,89.57004360831802,Housing
31031,15556,15475,50.130514646643675,49.86948535335632,Food
179144,31174,147970,17.4016433706962,82.59835662930381,Healthcare
33109,8375,24734,25.295236944637413,74.70476305536259,Food
90428,4471,85957,4.9442650506480295,95.05573494935197,Transportation
22138,6571,15567,29.681994760140935,70.31800523985906,Housing
148753,29295,119458,19.693720462780583,80.30627953721941,Healthcare
79227,37032,42195,46.741641107198305,53.258358892801695,Transportation
27915,73,27842,0.26150814974028297,99.73849185025972,Housing
16047,8827,7220,55.00716644855736,44.99283355144264,Housing
35284,3942,31342,11.17220269810679,88.82779730189321,Food
126055,48202,77853,38.23886398794178,61.76113601205822,Healthcare
173862,46745,127117,26.886266119105954,73.11373388089405,Healthcare
44253,24348,19905,55.01999864415972,44.98000135584028,Food
46530,7310,39220,15.710294433698687,84.28970556630131,Food
104075,29233,74842,28.088397790055247,71.91160220994475,Transportation
202839,2655,200184,1.308919882271161,98.69108011772883,Entertainment
71826,42368,29458,58.986996352295826,41.013003647704174,Transportation
46327,14679,31648,31.68562609277527,68.31437390722472,Food
28639,10245,18394,35.77289709836237,64.22710290163762,Housing
193909,56377,137532,29.07394705764044,70.92605294235956,Entertainment
16297,4769,11528,29.26305454991716,70.73694545008283,Housing
57734,25077,32657,43.43541067655108,56.56458932344892,Food
135585,16777,118808,12.37378766087694,87.62621233912306,Healthcare
120496,5662,114834,4.698911167175674,95.30108883282432,Healthcare
32516,2672,29844,8.217492926559231,91.78250707344077,Food
44984,3749,41235,8.334074337542237,91.66592566245775,Food
89119,36839,52280,41.33686419282083,58.66313580717917,Transportation
199130,32646,166484,16.394315271430724,83.60568472856927,Entertainment
246113,27787,218326,11.290342241165643,88.70965775883435,Entertainment
40290,5417,34873,13.445023579051874,86.55497642094812,Food
47787,5303,42484,11.097160315566995,88.902839684433,Food
220453,6528,213925,2.961175397930625,97.03882460206937,Entertainment
129249,53597,75652,41.4680190949253,58.5319809050747,Healthcare
25002,7779,17223,31.11351091912647,68.88648908087353,Housing
104094,35710,68384,34.30553153880147,65.69446846119853,Transportation
148283,17632,130651,11.890776420763,88.109223579237,Healthcare
14966,6904,8062,46.13123078979019,53.86876921020981,Housing
148826,37300,111526,25.062825044011127,74.93717495598887,Healthcare
183546,45576,137970,24.830832597822887,75.16916740217711,Entertainment
80922,13999,66923,17.2993747065075,82.70062529349251,Transportation
222227,54240,167987,24.407475239282356,75.59252476071765,Entertainment
84139,17832,66307,21.193501230107323,78.80649876989267,Transportation
117916,69566,48350,58.99623460768682,41.00376539231318,Transportation
19965,650,19315,3.2556974705735033,96.74430252942649,Housing
89328,14244,75084,15.945728103170339,84.05427189682966,Transportation
190849,32172,158677,16.8573060377576,83.1426939622424,Entertainment
25476,8932,16544,35.060449050086355,64.93955094991365,Housing
45191,22912,22279,50.7003606912881,49.29963930871191,Food
213582,47402,166180,22.193817831090634,77.80618216890936,Entertainment
184263,35883,148380,19.47379560736556,80.52620439263444,Entertainment
98286,43417,54869,44.1741448426022,55.8258551573978,Transportation
122848,28931,93917,23.550240948163584,76.44975905183642,Healthcare
109920,15282,94638,13.902838427947598,86.0971615720524,Transportation
140514,67631,72883,48.13114707431288,51.86885292568712,Healthcare
225829,66159,159670,29.296060293407844,70.70393970659215,Entertainment
41724,1254,40470,3.0054644808743167,96.99453551912568,Food
232332,37613,194719,16.189332506929738,83.81066749307026,Entertainment
15947,4563,11384,28.61353232582931,71.38646767417069,Housing
198071,53028,145043,26.772218043024974,73.22778195697502,Entertainment
22069,4912,17157,22.25746522271059,77.7425347772894,Housing
42719,19884,22835,46.5460333809312,53.453966619068794,Food
138236,10582,127654,7.655024740299199,92.3449752597008,Healthcare
47506,4971,42535,10.463941396876184,89.53605860312382,Food
131947,37568,94379,28.472038015263706,71.5279619847363,Healthcare
245875,59356,186519,24.140721911540417,75.85927808845958,Entertainment
207610,48487,159123,23.354848032368384,76.64515196763162,Entertainment
77842,33,77809,0.042393566455127055,99.95760643354488,Transportation
41537,849,40688,2.0439608060283603,97.95603919397165,Food
241540,64999,176541,26.91024260991968,73.08975739008032,Entertainment
70056,3729,66327,5.322884549503255,94.67711545049674,Transportation
12996,4837,8159,37.219144352108344,62.780855647891656,Housing
107201,50304,56897,46.924935401722,53.075064598278,Transportation
13304,4773,8531,35.87642814191221,64.12357185808779,Housing
19465,2959,16506,15.20164397636784,84.79835602363217,Housing
18973,5810,13163,30.622463500764248,69.37753649923576,Housing
59718,35049,24669,58.69084698080981,41.30915301919019,Food
20587,3306,17281,16.05867780638267,83.94132219361732,Housing
169504,48896,120608,28.846516896356427,71.15348310364357,Healthcare
167431,23671,143760,14.137764213317725,85.86223578668228,Healthcare
60887,16876,44011,27.71691822556539,72.2830817744346,Transportation
94068,35501,58567,37.739720202406765,62.260279797593235,Transportation
94830,14108,80722,14.877148581672467,85.12285141832754,Transportation
211502,38386,173116,18.149237359457594,81.85076264054241,Entertainment
50843,17459,33384,34.33904372283303,65.66095627716696,Food
50574,20873,29701,41.27219519911417,58.72780480088583,Food
21278,6128,15150,28.799699219851487,71.20030078014851,Housing
167845,21584,146261,12.8594834519944,87.14051654800559,Healthcare
203110,19728,183382,9.712963418837084,90.28703658116292,Entertainment
200179,20282,179897,10.131931920930768,89.86806807906923,Entertainment
175897,21727,154170,12.35211515830287,87.64788484169713,Healthcare
37160,17080,20080,45.96340150699677,54.03659849300323,Food
27230,4509,22721,16.55894234300404,83.44105765699597,Housing
175688,8773,166915,4.993511224443331,95.00648877555666,Healthcare
149478,54672,94806,36.57528198129491,63.42471801870509,Healthcare
179689,56555,123134,31.47382421851087,68.52617578148913,Healthcare
37544,5755,31789,15.328681014276583,84.67131898572342,Food
213536,26382,187154,12.354825415854938,87.64517458414505,Entertainment
21168,6719,14449,31.741307634164777,68.25869236583523,Housing
233839,48479,185360,20.73178554475515,79.26821445524484,Entertainment
230781,12836,217945,5.561983005533384,94.43801699446661,Entertainment
183716,36202,147514,19.705414879487908,80.2945851205121,Entertainment
190253,43948,146305,23.099767152160545,76.90023284783946,Entertainment
79835,29801,50034,37.32823949395628,62.67176050604372,Transportation
221052,27689,193363,12.526011979081844,87.47398802091816,Entertainment
218583,62581,156002,28.630314342835444,71.36968565716455,Entertainment
132078,67177,64901,50.86161207771166,49.138387922288345,Healthcare
54191,16962,37229,31.300400435496666,68.69959956450333,Food
212193,58460,153733,27.550390446433198,72.4496095535668,Entertainment
78498,11128,67370,14.176157354327499,85.8238426456725,Transportation
29645,4344,25301,14.653398549502445,85.34660145049754,Housing
78286,46417,31869,59.29157192856961,40.7084280714304,Transportation
64984,11908,53076,18.32451064877508,81.67548935122491,Transportation
34160,14378,19782,42.09016393442623,57.90983606557377,Food
167471,17696,149775,10.566605561559912,89.43339443844009,Healthcare
150139,60738,89401,40.45451215207241,59.54548784792759,Healthcare
120711,35760,84951,29.62447498570967,70.37552501429033,Healthcare
38435,15055,23380,39.17002731885001,60.82997268114999,Food
166380,68795,97585,41.34811876427455,58.65188123572545,Healthcare
39804,20315,19489,51.037584162395746,48.96241583760426,Food
125261,31250,94011,24.94790876649556,75.05209123350444,Healthcare
171967,67689,104278,39.3616217064902,60.638378293509795,Healthcare
157830,8325,149505,5.274662611670785,94.72533738832921,Healthcare
206587,11211,195376,5.426769351411269,94.57323064858873,Entertainment
214341,15838,198503,7.389160263318731,92.61083973668127,Entertainment
242089,27443,214646,11.335913651590944,88.66408634840906,Entertainment
119726,1435,118291,1.19857006832267,98.80142993167733,Transportation
44399,11663,32736,26.26860965337057,73.73139034662944,Food
22394,837,21557,3.737608287934268,96.26239171206574,Housing
38008,16323,21685,42.946221848031996,57.053778151968004,Food
227710,8940,218770,3.9260462869439197,96.07395371305608,Entertainment
101838,2105,99733,2.0670083858677506,97.93299161413225,Transportation
51609,23987,27622,46.4783274235114,53.5216725764886,Food
234533,63972,170561,27.276332115309998,72.72366788469,Entertainment
50443,7828,42615,15.518506036516463,84.48149396348353,Food
28572,6562,22010,22.966540669186617,77.03345933081339,Housing
92614,33048,59566,35.683589954002635,64.31641004599736,Transportation
122349,27524,94825,22.49630156355998,77.50369843644002,Healthcare
164871,20155,144716,12.224709014926821,87.77529098507317,Healthcare
75581,29521,46060,39.058758153504186,60.94124184649581,Transportation
194896,317,194579,0.16265084968393398,99.83734915031607,Entertainment
75585,17011,58574,22.505788185486537,77.49421181451346,Transportation
56296,7184,49112,12.761119795367343,87.23888020463265,Food
15397,4028,11369,26.16094044294343,73.83905955705657,Housing
41011,9938,31073,24.232522981639075,75.76747701836094,Food
189646,60700,128946,32.007002520485536,67.99299747951446,Entertainment
15805,4622,11183,29.243910155014234,70.75608984498575,Housing
139769,46733,93036,33.43588349347853,66.56411650652147,Healthcare
218432,53611,164821,24.543565045414592,75.4564349545854,Entertainment
88716,22063,66653,24.86924568285315,75.13075431714685,Transportation
83278,19484,63794,23.39633516655059,76.60366483344941,Transportation
183858,46923,136935,25.521326240903306,74.4786737590967,Entertainment
29101,14846,14255,51.01542902305762,48.98457097694237,Housing
200455,18008,182447,8.983562395550123,91.01643760444988,Entertainment
52195,26164,26031,50.12740683973561,49.872593160264394,Food
97092,52877,44215,54.46071766983892,45.539282330161086,Transportation
140287,45590,94697,32.49766550001069,67.5023344999893,Healthcare
238922,2029,236893,0.8492311298247963,99.1507688701752,Entertainment
188102,63006,125096,33.49565661183826,66.50434338816174,Entertainment
12128,1955,10173,16.119722955145118,83.88027704485488,Housing
202099,12018,190081,5.946590532362852,94.05340946763715,Entertainment
236986,50839,186147,21.452322078097442,78.54767792190256,Entertainment
150262,4395,145867,2.9248911900547045,97.0751088099453,Healthcare
153012,13517,139495,8.833947664235485,91.16605233576452,Healthcare
65431,11469,53962,17.52838868426281,82.47161131573719,Transportation
245123,28235,216888,11.518706934885751,88.48129306511426,Entertainment
100313,57579,42734,57.399340065594686,42.60065993440531,Transportation
11688,6591,5097,56.3911704312115,43.6088295687885,Housing
29817,7913,21904,26.538551832847034,73.46144816715297,Housing
170137,24072,146065,14.148597894637852,85.85140210536215,Healthcare
22448,1124,21324,5.007127583749109,94.99287241625089,Housing
163922,25007,138915,15.25542636131819,84.74457363868181,Healthcare
145060,24860,120200,17.137736109196194,82.8622638908038,Healthcare
111517,30560,80957,27.403893576764084,72.59610642323592,Transportation
157099,32807,124292,20.883010076448606,79.1169899235514,Healthcare
78765,42438,36327,53.879261093125116,46.120738906874884,Transportation
69863,34671,35192,49.62712737786811,50.37287262213188,Transportation
237175,12507,224668,5.273321387161379,94.72667861283863,Entertainment
226397,21038,205359,9.292525961033054,90.70747403896695,Entertainment
25310,12993,12317,51.33544053733702,48.66455946266298,Housing
82675,44797,37878,54.1844572119746,45.8155427880254,Transportation
161186,69424,91762,43.070738153437645,56.929261846562355,Healthcare
238672,64031,174641,26.82803177582624,73.17196822417377,Entertainment
91484,262,91222,0.28638887674347424,99.71361112325653,Transportation
51436,5014,46422,9.748036394742982,90.25196360525702,Food
22459,7148,15311,31.826884545171204,68.1731154548288,Housing
57958,19175,38783,33.08430242589461,66.91569757410538,Food
64648,31779,32869,49.156973146887765,50.843026853112235,Transportation
104893,6631,98262,6.321680188382447,93.67831981161756,Transportation
249998,28524,221474,11.409691277530221,88.59030872246979,Entertainment
81907,4140,77767,5.054513045283064,94.94548695471694,Transportation
103981,13472,90509,12.95621315432627,87.04378684567374,Transportation
11749,5985,5764,50.94050557494255,49.05949442505745,Housing
103360,17337,86023,16.7734133126935,83.22658668730651,Transportation
125568,16021,109547,12.758823904179408,87.24117609582059,Healthcare
165698,64277,101421,38.79165711112989,61.20834288887011,Healthcare
26162,15283,10879,58.41678770736183,41.58321229263818,Housing
49256,24107,25149,48.94226084131883,51.05773915868118,Food
31280,11864,19416,37.92838874680307,62.071611253196934,Food
41396,14860,26536,35.89718813411924,64.10281186588077,Food
101954,53247,48707,52.226494301351586,47.773505698648414,Transportation
20495,7172,13323,34.99390095145157,65.00609904854842,Housing
231291,4252,227039,1.8383767634711252,98.16162323652887,Entertainment
97639,5547,92092,5.681131515070822,94.31886848492917,Transportation
52684,22552,30132,42.80616505960064,57.193834940399356,Food
36982,14491,22491,39.18392731599156,60.81607268400844,Food
22464,201,22263,0.8947649572649572,99.10523504273505,Housing
42311,24754,17557,58.504880527522396,41.495119472477604,Food
12751,1221,11530,9.575719551407733,90.42428044859227,Housing
68310,12921,55389,18.91523935002196,81.08476064997804,Transportation
55224,5160,50064,9.343763581051718,90.65623641894828,Food
21022,2472,18550,11.7591095043288,88.2408904956712,Housing
162655,35914,126741,22.079862285204882,77.92013771479512,Healthcare
74103,37544,36559,50.66461546765988,49.33538453234012,Transportation
15908,8422,7486,52.941916017098315,47.058083982901685,Housing
130300,46096,84204,35.37682271680737,64.62317728319263,Healthcare
38401,4180,34221,10.88513319965626,89.11486680034373,Food
26669,3726,22943,13.971277513217595,86.0287224867824,Housing
13741,6843,6898,49.79986900516702,50.20013099483298,Housing
180760,210,180550,0.1161761451648595,99.88382385483514,Entertainment
62330,27022,35308,43.35312048772661,56.64687951227339,Transportation
49340,23945,25395,48.53060397243616,51.46939602756384,Food
106235,36955,69280,34.786087447639666,65.21391255236033,Transportation
215174,29437,185737,13.680556201028004,86.31944379897199,Entertainment
192722,5171,187551,2.6831394443810255,97.31686055561897,Entertainment
173309,2729,170580,1.5746441327340182,98.42535586726598,Healthcare
137155,47380,89775,34.544858007363935,65.45514199263607,Healthcare
226085,47753,178332,21.121702014728974,78.87829798527103,Entertainment
190737,38871,151866,20.379370546878686,79.62062945312131,Entertainment
70299,39736,30563,56.52427488299976,43.47572511700024,Transportation
58719,3580,55139,6.096834074149764,93.90316592585025,Food
64920,22845,42075,35.189463955637706,64.8105360443623,Transportation
22228,10667,11561,47.98902285405794,52.01097714594205,Housing
219458,42174,177284,19.21734454884306,80.78265545115694,Entertainment
132640,60740,71900,45.793124246079614,54.20687575392038,Healthcare
148713,20418,128295,13.729801698573763,86.27019830142623,Healthcare
52170,27539,24631,52.78704236151045,47.212957638489556,Food
156184,27248,128936,17.446089228089946,82.55391077191005,Healthcare
50848,4924,45924,9.683763373190686,90.31623662680931,Food
17299,10354,6945,59.85317070350887,40.14682929649113,Housing
11735,6380,5355,54.367277375372815,45.63272262462718,Housing
78333,3869,74464,4.939169953914697,95.0608300460853,Transportation
55139,7185,47954,13.030704220243386,86.96929577975662,Food
38150,2214,35936,5.803407601572739,94.19659239842726,Food
10635,4067,6568,38.24165491302304,61.75834508697696,Housing
102605,30910,71695,30.125237561522344,69.87476243847766,Transportation
27526,1053,26473,3.8254740972171764,96.17452590278283,Housing
207429,18321,189108,8.832419767727753,91.16758023227224,Entertainment
109721,46395,63326,42.28452165036775,57.71547834963226,Transportation
224065,47753,176312,21.31211925111017,78.68788074888982,Entertainment
49917,507,49410,1.0156860388244486,98.98431396117556,Food
127680,6356,121324,4.978070175438597,95.0219298245614,Healthcare
236804,20399,216405,8.614297055792978,91.38570294420703,Entertainment
57925,22952,34973,39.6236512731981,60.3763487268019,Food
14259,5476,8783,38.40381513430115,61.59618486569885,Housing
187346,38534,148812,20.568360146466965,79.43163985353303,Entertainment
24654,10588,14066,42.94637786971688,57.053622130283124,Housing
28605,3419,25186,11.952455864359377,88.04754413564062,Housing
111435,27049,84386,24.27334320455871,75.7266567954413,Transportation
13219,4102,9117,31.03109161056056,68.96890838943945,Housing
216238,3891,212347,1.7994062098243602,98.20059379017565,Entertainment
65799,21421,44378,32.55520600617031,67.44479399382969,Transportation
181323,31098,150225,17.1506096854784,82.8493903145216,Entertainment
85242,44434,40808,52.126885807465804,47.873114192534196,Transportation
34486,9326,25160,27.042857971350692,72.9571420286493,Food
231792,66673,165119,28.764150617795263,71.23584938220473,Entertainment
247793,9191,238602,3.7091443261109074,96.2908556738891,Entertainment
160259,44090,116169,27.51171541067896,72.48828458932104,Healthcare
23077,5280,17797,22.879923733587553,77.12007626641244,Housing
33420,709,32711,2.121484141232795,97.8785158587672,Food
199377,7694,191683,3.859020849947586,96.1409791500524,Entertainment
62040,21080,40960,33.978078658929725,66.02192134107028,Transportation
37431,9971,27460,26.638347893457293,73.3616521065427,Food
113580,43978,69602,38.7198450431414,61.2801549568586,Transportation
95419,51914,43505,54.40635512843354,45.59364487156646,Transportation
63337,4768,58569,7.527985221908205,92.47201477809179,Transportation
153289,40321,112968,26.303909608647718,73.69609039135229,Healthcare
182892,6378,176514,3.4873039826783017,96.5126960173217,Entertainment
202631,52279,150352,25.80009968859651,74.19990031140348,Entertainment
17244,8652,8592,50.17397355601948,49.82602644398052,Housing
160551,40697,119854,25.348331682767473,74.65166831723253,Healthcare
24310,11129,13181,45.779514603044014,54.220485396955986,Housing
41171,11565,29606,28.090160549901626,71.90983945009836,Food
39722,22344,17378,56.25094406122552,43.74905593877448,Food
164611,17861,146750,10.850429193674785,89.14957080632522,Healthcare
184550,63662,120888,34.49580059604443,65.50419940395557,Entertainment
66949,22164,44785,33.1057969499171,66.89420305008291,Transportation
63642,33539,30103,52.699475189340376,47.300524810659624,Transportation
115543,26731,88812,23.135109872514995,76.86489012748501,Transportation
157055,66102,90953,42.08844035528955,57.91155964471045,Healthcare
134739,47325,87414,35.12346091332131,64.87653908667869,Healthcare
36628,14495,22133,39.573550289396096,60.42644971060391,Food
128252,19839,108413,15.468764619655055,84.53123538034495,Healthcare
46742,20497,26245,43.85135424243721,56.14864575756279,Food
166884,45631,121253,27.342944799980824,72.65705520001917,Healthcare
205490,29676,175814,14.4415786656285,85.5584213343715,Entertainment
50843,20280,30563,39.88749680388647,60.11250319611353,Food
248991,35067,213924,14.08364157740641,85.91635842259359,Entertainment
59836,7712,52124,12.88856206965706,87.11143793034294,Food
74032,485,73547,0.6551221093581154,99.34487789064188,Transportation
242416,7230,235186,2.982476404197743,97.01752359580226,Entertainment
210189,2532,207657,1.204630118607539,98.79536988139246,Entertainment
10899,4454,6445,40.866134507753,59.133865492247,Housing
244243,56010,188233,22.93207993678427,77.06792006321574,Entertainment
147918,51778,96140,35.00452953663517,64.99547046336484,Healthcare
234611,48150,186461,20.523334370511186,79.47666562948882,Entertainment
181249,37729,143520,20.816114847530194,79.1838851524698,Entertainment
68982,16324,52658,23.664144269519586,76.33585573048042,Transportation
98358,42147,56211,42.85060696638809,57.14939303361191,Transportation
107350,15519,91831,14.456450861667443,85.54354913833255,Transportation
142454,13564,128890,9.521670153172252,90.47832984682775,Healthcare
32196,9810,22386,30.46962355572121,69.5303764442788,Food
49399,10629,38770,21.516629891293345,78.48337010870665,Food
93891,47424,46467,50.50963351119916,49.49036648880084,Transportation
59198,8919,50279,15.066387377951958,84.93361262204803,Food
112718,35222,77496,31.247892971841235,68.75210702815878,Transportation
121312,51788,69524,42.6899235030335,57.3100764969665,Healthcare
221652,36673,184979,16.545305253279917,83.45469474672008,Entertainment
178890,59192,119698,33.08849013360165,66.91150986639835,Healthcare
234787,53039,181748,22.59026266360574,77.40973733639427,Entertainment
90627,2749,87878,3.0333123682787693,96.96668763172123,Transportation
23385,3714,19671,15.881975625400898,84.1180243745991,Housing
230349,43775,186574,19.00377253645555,80.99622746354444,Entertainment
209641,2551,207090,1.216842125347618,98.78315787465239,Entertainment
143086,22308,120778,15.590623820639335,84.40937617936066,Healthcare
180834,46921,133913,25.947001117046575,74.05299888295343,Entertainment
65522,2893,62629,4.415310887946033,95.58468911205397,Transportation
157914,32996,124918,20.894917486733284,79.10508251326671,Healthcare
13600,6043,7557,44.43382352941177,55.56617647058823,Housing
23796,2169,21627,9.11497730711044,90.88502269288956,Housing
21210,1428,19782,6.732673267326733,93.26732673267327,Housing
17236,286,16950,1.6593177071246228,98.34068229287539,Housing
216547,16506,200041,7.6223637362789605,92.37763626372104,Entertainment
38555,18427,20128,47.79406043314745,52.20593956685254,Food
164775,35619,129156,21.616750113791532,78.38324988620846,Healthcare
116441,763,115678,0.6552674745149905,99.34473252548501,Transportation
79079,5916,73163,7.481126468468241,92.51887353153177,Transportation
43777,14996,28781,34.25543093405213,65.74456906594787,Food
129854,53628,76226,41.298689297210714,58.701310702789286,Healthcare
10191,6050,4141,59.36610734962221,40.63389265037778,Housing
85072,1472,83600,1.730299040812488,98.26970095918752,Transportation
169892,38456,131436,22.635556706613613,77.36444329338639,Healthcare
12490,5533,6957,44.29943955164131,55.70056044835868,Housing
42192,23540,18652,55.79256731133865,44.207432688661356,Food
157253,44100,113153,28.04398008305088,71.95601991694912,Healthcare
142327,11437,130890,8.035720558994429,91.96427944100557,Healthcare
18536,3183,15353,17.17198964177816,82.82801035822183,Housing
43333,8656,34677,19.975538273371335,80.02446172662867,Food
191898,41496,150402,21.62398774348873,78.37601225651127,Entertainment
209223,32902,176321,15.725804524359177,84.27419547564082,Entertainment
151794,52068,99726,34.301751057354046,65.69824894264596,Healthcare
88667,46695,41972,52.66333585212085,47.33666414787914,Transportation
56225,29503,26722,52.47309915518008,47.52690084481992,Food
26527,14519,12008,54.732913635164174,45.267086364835826,Housing
33332,7570,25762,22.710908436337455,77.28909156366255,Food
125084,5675,119409,4.536951168814557,95.46304883118545,Healthcare
14554,3018,11536,20.736567266730795,79.2634327332692,Housing
51087,26645,24442,52.15612582457376,47.84387417542623,Food
202068,16163,185905,7.998792485697884,92.00120751430212,Entertainment
101882,8521,93361,8.363597102530377,91.63640289746962,Transportation
10705,2860,7845,26.716487622606262,73.28351237739375,Housing
129999,68187,61812,52.45194193801491,47.548058061985095,Healthcare
241128,68750,172378,28.51182774294151,71.4881722570585,Entertainment
14051,1269,12782,9.031385666500604,90.9686143334994,Housing
40176,18672,21504,46.47550776583035,53.52449223416965,Food
16262,6322,9940,38.87590702250645,61.12409297749354,Housing
125483,18740,106743,14.934293888415166,85.06570611158483,Healthcare
82787,17899,64888,21.620544288354452,78.37945571164555,Transportation
153321,9901,143420,6.45769333620313,93.54230666379686,Healthcare
93565,11127,82438,11.892267407684498,88.1077325923155,Transportation
119246,11689,107557,9.802425238582426,90.19757476141757,Transportation
130382,16273,114109,12.48101731834149,87.51898268165851,Healthcare
28334,3741,24593,13.203218747794171,86.79678125220583,Housing
177298,16588,160710,9.355999503660502,90.64400049633949,Healthcare
23503,6730,16773,28.634642386078372,71.36535761392163,Housing
49196,9584,39612,19.481258638913733,80.51874136108627,Food
14823,3452,11371,23.288133306348243,76.71186669365176,Housing
180458,44714,135744,24.77806470203593,75.22193529796407,Entertainment
49918,29622,20296,59.34131976441363,40.65868023558637,Food
233455,52953,180502,22.682315649696942,77.31768435030305,Entertainment
172604,18004,154600,10.430812727399132,89.56918727260087,Healthcare
147047,2989,144058,2.0326834277475907,97.9673165722524,Healthcare
199270,29279,169991,14.693129924223417,85.30687007577659,Entertainment
175336,28861,146475,16.46039603960396,83.53960396039604,Healthcare
33880,8122,25758,23.9728453364817,76.0271546635183,Food
28923,14191,14732,49.06475815095253,50.93524184904747,Housing
12905,6570,6335,50.91049980627663,49.08950019372336,Housing
20682,3078,17604,14.882506527415144,85.11749347258485,Housing
34316,17862,16454,52.05152115631192,47.94847884368807,Food
212318,53268,159050,25.088781921457436,74.91121807854256,Entertainment
68057,29173,38884,42.86553918039291,57.13446081960709,Transportation
15388,5290,10098,34.37743696386795,65.62256303613205,Housing
142336,21383,120953,15.022903552158272,84.97709644784173,Healthcare
130949,34354,96595,26.23464096709406,73.76535903290595,Healthcare
50916,4490,46426,8.818446068033623,91.18155393196638,Food
29495,3049,26446,10.337345312764876,89.66265468723512,Housing
103532,60927,42605,58.848471970018934,41.151528029981066,Transportation
13555,7258,6297,53.54481741054962,46.45518258945039,Housing
33340,14910,18430,44.72105578884223,55.278944211157764,Food
142298,10759,131539,7.560893336519135,92.43910666348086,Healthcare
171618,54769,116849,31.913319115710475,68.08668088428954,Healthcare
241270,67312,173958,27.899034276951134,72.10096572304887,Entertainment
124726,16075,108651,12.888251046293476,87.11174895370652,Healthcare
21986,10528,11458,47.885017738560904,52.1149822614391,Housing
36442,19372,17070,53.158443554140824,46.841556445859176,Food
45584,23419,22165,51.375482625482626,48.624517374517374,Food
148422,37438,110984,25.22402339275849,74.77597660724152,Healthcare
211489,62419,149070,29.51406456127742,70.48593543872258,Entertainment
151878,63293,88585,41.67358011035173,58.32641988964827,Healthcare
228462,67534,160928,29.560276982605423,70.43972301739457,Entertainment
82028,43972,38056,53.60608572682498,46.393914273175014,Transportation
173476,48337,125139,27.863796721160277,72.13620327883973,Healthcare
104690,2886,101804,2.756710287515522,97.24328971248448,Transportation
226946,49675,177271,21.888466859957877,78.11153314004213,Entertainment
27075,3375,23700,12.465373961218837,87.53462603878116,Housing
28248,13419,14829,47.50424808836024,52.495751911639765,Housing
210636,15657,194979,7.433202301600867,92.56679769839914,Entertainment
190315,18810,171505,9.88361400835457,90.11638599164543,Entertainment
201367,29877,171490,14.837088500101805,85.1629114998982,Entertainment
243230,20851,222379,8.572544505200838,91.42745549479916,Entertainment
54327,11682,42645,21.503119995582306,78.49688000441769,Food
125491,23711,101780,18.89458208158354,81.10541791841645,Healthcare
30060,7289,22771,24.248170326014638,75.75182967398536,Food
198522,44545,153977,22.43831917873082,77.56168082126918,Entertainment
16217,169,16048,1.0421162977122773,98.95788370228772,Housing
24204,13621,10583,56.27582217815237,43.724177821847626,Housing
96055,39252,56803,40.86408828275467,59.13591171724533,Transportation
14057,55,14002,0.3912641388631999,99.6087358611368,Housing
219679,29940,189739,13.628976825276881,86.37102317472312,Entertainment
105503,59047,46456,55.967128896808624,44.032871103191376,Transportation
155322,41158,114164,26.498499890549954,73.50150010945005,Healthcare
207667,54048,153619,26.026282461825907,73.9737175381741,Entertainment
215895,16353,199542,7.574515389425415,92.42548461057459,Entertainment
216340,19250,197090,8.898030877322732,91.10196912267726,Entertainment
110154,28782,81372,26.128874121684188,73.87112587831581,Transportation
135512,14690,120822,10.840368380660015,89.15963161933999,Healthcare
217499,1056,216443,0.4855194736527524,99.51448052634724,Entertainment
115250,53866,61384,46.73839479392625,53.261605206073746,Transportation
249600,38039,211561,15.239983974358976,84.76001602564102,Entertainment
239492,55535,183957,23.188666009720578,76.81133399027942,Entertainment
81213,13620,67593,16.770714048243505,83.2292859517565,Transportation
41072,9886,31186,24.069925983638488,75.93007401636152,Food
26339,10204,16135,38.74103041117734,61.25896958882265,Housing
13943,5957,7986,42.7239475005379,57.2760524994621,Housing
59946,28111,31835,46.893871150702296,53.1061288492977,Food
137921,43374,94547,31.448437873855323,68.55156212614467,Healthcare
166957,40774,126183,24.421857124888444,75.57814287511155,Healthcare
129079,53930,75149,41.78061497222631,58.21938502777368,Healthcare
52256,18511,33745,35.42368340477648,64.57631659522352,Food
62175,14292,47883,22.986731001206273,77.01326899879373,Transportation
211857,4123,207734,1.9461240364963157,98.05387596350369,Entertainment
56598,5421,51177,9.578076963850313,90.42192303614969,Food
191297,9574,181723,5.0047831382614465,94.99521686173856,Entertainment
55681,8310,47371,14.92430092850344,85.07569907149656,Food
133877,59077,74800,44.12781881876648,55.872181181233515,Healthcare
196471,33560,162911,17.081401326404404,82.9185986735956,Entertainment
38128,12293,25835,32.24139739823752,67.75860260176249,Food
12255,60,12195,0.4895960832313341,99.51040391676867,Housing
11842,7074,4768,59.736530991386594,40.26346900861341,Housing
225516,61611,163905,27.3200127707125,72.6799872292875,Entertainment
10992,4744,6248,43.15866084425036,56.84133915574964,Housing
205364,23650,181714,11.51613720028827,88.48386279971173,Entertainment
26984,12265,14719,45.45286095463978,54.54713904536022,Housing
140492,48886,91606,34.79628733308658,65.20371266691342,Healthcare
106497,22430,84067,21.061626149093403,78.9383738509066,Transportation
22167,11644,10523,52.528533405512704,47.471466594487296,Housing
30609,10183,20426,33.26799307393251,66.7320069260675,Food
79098,30252,48846,38.246226200409616,61.753773799590384,Transportation
25496,14641,10855,57.42469406965799,42.57530593034202,Housing
214117,14256,199861,6.6580420984788695,93.34195790152113,Entertainment
101598,55927,45671,55.047343451642746,44.952656548357254,Transportation
122860,8589,114271,6.990883932931792,93.0091160670682,Healthcare
43960,17459,26501,39.715650591446774,60.284349408553226,Food
135429,8811,126618,6.505992069645348,93.49400793035466,Healthcare
142019,36985,105034,26.04229011611122,73.95770988388878,Healthcare
93701,45356,48345,48.40503303059733,51.59496696940268,Transportation
34685,7745,26940,22.329537263946953,77.67046273605305,Food
56194,17152,39042,30.522831619034065,69.47716838096594,Food
67830,9941,57889,14.655757039657969,85.34424296034203,Transportation
13781,2057,11724,14.926347870256148,85.07365212974385,Housing
172650,54352,118298,31.481030987547058,68.51896901245294,Healthcare
54186,650,53536,1.1995718451260473,98.80042815487396,Food
131122,24971,106151,19.04409633776178,80.95590366223821,Healthcare
46212,4845,41367,10.484289794858478,89.51571020514152,Food
139688,57465,82223,41.13810778305939,58.86189221694062,Healthcare
36728,17102,19626,46.56392942714005,53.43607057285994,Food
17982,9732,8250,54.12078745412079,45.87921254587921,Housing
138647,4264,134383,3.075436179650479,96.92456382034952,Healthcare
143087,65877,77210,46.03982192652023,53.96017807347977,Healthcare
25418,6672,18746,26.249114800535057,73.75088519946495,Housing
168389,27656,140733,16.423875668838225,83.57612433116176,Healthcare
204702,29009,175693,14.171331985031902,85.8286680149681,Entertainment
37149,693,36456,1.8654607122668174,98.13453928773318,Food
40714,15421,25293,37.8764061502186,62.1235938497814,Food
180449,20390,160059,11.299591574350648,88.70040842564936,Entertainment
146354,30580,115774,20.894543367451522,79.10545663254848,Healthcare
108643,11760,96883,10.82444336036376,89.17555663963624,Transportation
10873,3183,7690,29.274349305619424,70.72565069438058,Housing
205326,35621,169705,17.348509200003896,82.65149079999611,Entertainment
201983,18771,183212,9.293356371575825,90.70664362842417,Entertainment
20604,2080,18524,10.095127159774801,89.90487284022521,Housing
32683,14318,18365,43.80870789095248,56.19129210904752,Food
180749,20541,160208,11.364378226158928,88.63562177384108,Entertainment
97075,32861,64214,33.85114602111769,66.1488539788823,Transportation
49877,12446,37431,24.95338532790665,75.04661467209334,Food
173210,34113,139097,19.694590381617687,80.3054096183823,Healthcare
32148,12459,19689,38.75513251213139,61.2448674878686,Food
34926,5465,29461,15.647368722441735,84.35263127755826,Food
115097,40513,74584,35.199006055761664,64.80099394423834,Transportation
224049,38245,185804,17.069926667827126,82.93007333217287,Entertainment
143603,19878,123725,13.842329199250711,86.15767080074929,Healthcare
97399,744,96655,0.7638682121993039,99.2361317878007,Transportation
73212,188,73024,0.25678850461672953,99.74321149538326,Transportation
49904,19037,30867,38.14724270599551,61.85275729400449,Food
143994,15234,128760,10.579607483645152,89.42039251635485,Healthcare
71608,37147,34461,51.87548877220423,48.12451122779577,Transportation
108570,6987,101583,6.435479414202819,93.56452058579718,Transportation
154346,19884,134462,12.882743964858175,87.11725603514182,Healthcare
249653,14170,235483,5.675878118828934,94.32412188117107,Entertainment
20485,5919,14566,28.894312911886743,71.10568708811326,Housing
53477,21221,32256,39.68248031864166,60.31751968135835,Food
105556,18639,86917,17.657925650839363,82.34207434916063,Transportation
151067,21529,129538,14.251292472876273,85.74870752712373,Healthcare
35024,18872,16152,53.883051621745096,46.11694837825491,Food
13325,6564,6761,49.26078799249531,50.73921200750468,Housing
37498,20562,16936,54.834924529308225,45.16507547069177,Food
128480,63378,65102,49.329078455790786,50.670921544209214,Healthcare
228537,33982,194555,14.869364698057645,85.13063530194236,Entertainment
63111,11035,52076,17.485065994834496,82.5149340051655,Transportation
111250,4808,106442,4.321797752808989,95.67820224719101,Transportation
220284,16609,203675,7.539812242378022,92.46018775762198,Entertainment
67406,40000,27406,59.341898347328126,40.65810165267187,Transportation
112533,11833,100700,10.515137781806226,89.48486221819377,Transportation
54373,5399,48974,9.929560627517334,90.07043937248267,Food
121093,44031,77062,36.361309076494926,63.63869092350507,Healthcare
27245,8171,19074,29.990824004404477,70.00917599559551,Housing
165466,11215,154251,6.777827469087305,93.2221725309127,Healthcare
239682,36826,202856,15.364524661843609,84.63547533815638,Entertainment
51278,3818,47460,7.445688209368539,92.55431179063146,Food
18426,507,17919,2.751546727450342,97.24845327254967,Housing
29338,3812,25526,12.993387415638422,87.00661258436158,Housing
148403,14348,134055,9.668268161694844,90.33173183830515,Healthcare
17330,13,17317,0.07501442585112521,99.92498557414888,Housing
27416,3689,23727,13.455646337904872,86.54435366209513,Housing
52094,28921,23173,55.516950128613665,44.483049871386335,Food
215014,6379,208635,2.9667835582799262,97.03321644172007,Entertainment
113742,63452,50290,55.78590142603436,44.21409857396564,Transportation
210011,38069,171942,18.127145720938426,81.87285427906157,Entertainment
65438,36136,29302,55.22173660564198,44.77826339435802,Transportation
192819,44933,147886,23.303201447990084,76.69679855200991,Entertainment
162402,46630,115772,28.71270058250514,71.28729941749485,Healthcare
37268,21998,15270,59.026510679403245,40.973489320596755,Food
207462,36691,170771,17.685648456102804,82.31435154389719,Entertainment
135694,19783,115911,14.579126564181172,85.42087343581882,Healthcare
45676,1147,44529,2.5111656011909975,97.488834398809,Food
15008,3102,11906,20.66897654584222,79.33102345415777,Housing
127922,33045,94877,25.832147715013836,74.16785228498617,Healthcare
41549,1451,40098,3.4922621483068186,96.50773785169318,Food
14004,6117,7887,43.680377035132814,56.31962296486718,Housing
135044,3342,131702,2.474748970705844,97.52525102929415,Healthcare
170473,25533,144940,14.977738410188124,85.02226158981188,Healthcare
45800,17221,28579,37.60043668122271,62.3995633187773,Food
129907,626,129281,0.4818831933614047,99.51811680663859,Healthcare
78609,3538,75071,4.500756910786297,95.4992430892137,Transportation
144613,25665,118948,17.747367110840656,82.25263288915934,Healthcare
115024,57163,57861,49.696585060509115,50.303414939490885,Transportation
152312,50642,101670,33.24885760806765,66.75114239193235,Healthcare
28625,12752,15873,44.54847161572052,55.45152838427948,Housing
148944,49929,99015,33.521994843699645,66.47800515630036,Healthcare
235629,57957,177672,24.59671772150287,75.40328227849713,Entertainment
91099,33277,57822,36.52839218871777,63.471607811282226,Transportation
39800,22486,17314,56.49748743718593,43.50251256281407,Food
176908,30373,146535,17.16881090736428,82.83118909263571,Healthcare
224204,52471,171733,23.40323990651371,76.5967600934863,Entertainment
112893,50068,62825,44.349959696349636,55.650040303650364,Transportation
47801,22314,25487,46.68103177757787,53.31896822242213,Food
220084,4019,216065,1.8261209356427544,98.17387906435725,Entertainment
49851,14956,34895,30.00140418446972,69.99859581553028,Food
13910,965,12945,6.93745506829619,93.06254493170381,Housing
11752,6141,5611,52.25493533015657,47.74506466984343,Housing
78600,31031,47569,39.47964376590331,60.520356234096695,Transportation
195784,48187,147597,24.612327871531892,75.38767212846811,Entertainment
113669,53426,60243,47.0013812033184,52.9986187966816,Transportation
20776,12257,8519,58.99595687331537,41.004043126684635,Housing
107214,64306,42908,59.979107206148456,40.020892793851544,Transportation
202654,63466,139188,31.317417864932345,68.68258213506765,Entertainment
48014,12980,35034,27.03378181363769,72.96621818636231,Food
240682,51815,188867,21.528406777407533,78.47159322259246,Entertainment
185300,21434,163866,11.5671883432272,88.4328116567728,Entertainment
82003,47249,34754,57.61862370888869,42.3813762911113,Transportation
36938,6639,30299,17.97336076669013,82.02663923330988,Food
20876,11657,9219,55.83924123395286,44.16075876604714,Housing
134321,25210,109111,18.76847253966245,81.23152746033755,Healthcare
162958,63968,98990,39.254286380539774,60.745713619460226,Healthcare
98204,29802,68402,30.34703270742536,69.65296729257464,Transportation
165467,68381,97086,41.32606501598506,58.67393498401494,Healthcare
162743,46813,115930,28.76498528354522,71.23501471645478,Healthcare
14813,4526,10287,30.55424289475461,69.44575710524539,Housing
48252,12427,35825,25.75437287573572,74.24562712426427,Food
233157,67117,166040,28.786182700926844,71.21381729907316,Entertainment
141589,52318,89271,36.95061057003016,63.049389429969835,Healthcare
38016,12537,25479,32.978219696969695,67.0217803030303,Food
41451,4255,37196,10.265132324913754,89.73486767508625,Food
186581,15501,171080,8.307919884661354,91.69208011533865,Entertainment
29239,1563,27676,5.345600054721434,94.65439994527857,Housing
101883,53214,48669,52.23049969082183,47.76950030917818,Transportation
186765,32624,154141,17.46794099536851,82.53205900463149,Entertainment
93092,8383,84709,9.005070253082973,90.99492974691702,Transportation
109948,16958,92990,15.423654818641538,84.57634518135846,Transportation
42568,13674,28894,32.12272129299004,67.87727870700996,Food
176699,64342,112357,36.41333567252786,63.58666432747214,Healthcare
67769,27368,40401,40.38424648438077,59.61575351561924,Transportation
52585,27512,25073,52.31910240562898,47.68089759437102,Food
128225,1619,126606,1.2626242932345486,98.73737570676545,Healthcare
177178,42272,134906,23.858492589373398,76.1415074106266,Healthcare
11924,4695,7229,39.374371016437436,60.625628983562564,Housing
237787,68307,169480,28.726128846404553,71.27387115359545,Entertainment
83212,5667,77545,6.8103158198336775,93.18968418016632,Transportation
214560,50780,163780,23.667039522744222,76.33296047725578,Entertainment
47733,18267,29466,38.26912199107536,61.73087800892464,Food
247130,44034,203096,17.818152389430665,82.18184761056933,Entertainment
177352,69748,107604,39.32743921692454,60.67256078307547,Healthcare
127348,32916,94432,25.84728460596162,74.15271539403838,Healthcare
138313,25251,113062,18.256418413308946,81.74358158669106,Healthcare
243987,26401,217586,10.820658477705779,89.17934152229422,Entertainment
134371,33557,100814,24.97339455686123,75.02660544313878,Healthcare
171747,67151,104596,39.09879066301013,60.90120933698987,Healthcare
143309,38213,105096,26.664759366124947,73.33524063387506,Healthcare
146360,13418,132942,9.167805411314568,90.83219458868544,Healthcare
239920,33999,205921,14.170973657885963,85.82902634211403,Entertainment
224669,12902,211767,5.742670328349705,94.2573296716503,Entertainment
61851,17534,44317,28.348773665745096,71.6512263342549,Transportation
88387,22890,65497,25.89747361037257,74.10252638962743,Transportation
89667,40536,49131,45.20726688748369,54.79273311251631,Transportation
23120,1904,21216,8.235294117647058,91.76470588235294,Housing
18596,10715,7881,57.619918261991835,42.38008173800817,Housing
43299,16358,26941,37.779163491073696,62.220836508926304,Food
139849,53171,86678,38.02029331636265,61.979706683637346,Healthcare
11681,1147,10534,9.819364780412636,90.18063521958737,Housing
58149,9508,48641,16.351098041238888,83.64890195876112,Food
142412,7173,135239,5.036794652136056,94.96320534786395,Healthcare
55582,14717,40865,26.477996473678527,73.52200352632147,Food
62624,15880,46744,25.357690342360755,74.64230965763925,Transportation
166973,69687,97286,41.73549016906925,58.26450983093074,Healthcare
50056,13418,36638,26.805977305417933,73.19402269458207,Food
73520,7864,65656,10.696409140369967,89.30359085963003,Transportation
87633,49969,37664,57.02075702075702,42.97924297924298,Transportation
123217,4148,119069,3.3664185948367518,96.63358140516326,Healthcare
72150,17100,55050,23.7006237006237,76.29937629937629,Transportation
132648,14471,118177,10.909323924974368,89.09067607502563,Healthcare
227108,4633,222475,2.0399985909787413,97.96000140902126,Entertainment
50061,8209,41852,16.397994446774934,83.60200555322507,Food
130229,36754,93475,28.222592510116794,71.7774074898832,Healthcare
206094,41059,165035,19.92246256562539,80.0775374343746,Entertainment
244374,52436,191938,21.457274505471123,78.54272549452888,Entertainment
206911,21875,185036,10.572178376210061,89.42782162378994,Entertainment
92307,5089,87218,5.5131246817684465,94.48687531823155,Transportation
18191,5494,12697,30.201748117200815,69.79825188279919,Housing
157035,7363,149672,4.6887636514152895,95.31123634858471,Healthcare
124984,60333,64651,48.27257889009793,51.727421109902075,Healthcare
238276,23633,214643,9.918330003861069,90.08166999613894,Entertainment
10502,2161,8341,20.577032946105504,79.4229670538945,Housing
136330,25895,110435,18.994351940145236,81.00564805985476,Healthcare
248631,21976,226655,8.838801275786205,91.1611987242138,Entertainment
190197,33362,156835,17.540760369511613,82.45923963048838,Entertainment
229039,9816,219223,4.285732997437117,95.71426700256288,Entertainment
189519,21283,168236,11.23000860072077,88.76999139927922,Entertainment
133553,37223,96330,27.871331980562026,72.12866801943798,Healthcare
187766,44532,143234,23.71675383189715,76.28324616810285,Entertainment
24041,12998,11043,54.0659706335011,45.9340293664989,Housing
56044,31600,24444,56.384269502533726,43.615730497466274,Food
56193,13790,42403,24.540423184382394,75.4595768156176,Food
121369,27374,93995,22.554359020837282,77.44564097916272,Healthcare
26579,5946,20633,22.371044809812258,77.62895519018774,Housing
114870,2697,112173,2.347871506920867,97.65212849307913,Transportation
95554,56582,38972,59.21468489021914,40.78531510978085,Transportation
16455,7422,9033,45.10483135824977,54.895168641750224,Housing
200838,41009,159829,20.41894462203368,79.58105537796632,Entertainment
13959,1465,12494,10.495021133319007,89.504978866681,Housing
26110,3963,22147,15.178092684795097,84.8219073152049,Housing
17325,6890,10435,39.76911976911977,60.23088023088023,Housing
30063,12146,17917,40.401822838705385,59.59817716129462,Food
40077,12248,27829,30.561169748234647,69.43883025176535,Food
163659,1439,162220,0.8792672569183485,99.12073274308165,Healthcare
12560,1908,10652,15.19108280254777,84.80891719745223,Housing
27124,9349,17775,34.46763014304675,65.53236985695325,Housing
223918,37637,186281,16.80838521244384,83.19161478755616,Entertainment
124984,63373,61611,50.704890225948915,49.29510977405108,Healthcare
16582,6951,9631,41.918948257146305,58.081051742853695,Housing
19440,4610,14830,23.713991769547324,76.28600823045268,Housing
117347,49455,67892,42.14423888126667,57.85576111873333,Transportation
13715,6706,7009,48.89537003281079,51.10462996718921,Housing
245513,48754,196759,19.85801159205419,80.1419884079458,Entertainment
129740,13600,116140,10.482503468475413,89.51749653152459,Healthcare
90789,21575,69214,23.763892101466038,76.23610789853397,Transportation
15224,5464,9760,35.89069889647924,64.10930110352075,Housing
19898,3059,16839,15.373404362247461,84.62659563775253,Housing
248587,43667,204920,17.566083503964407,82.4339164960356,Entertainment
128859,27867,100992,21.625963262170277,78.37403673782973,Healthcare
72123,2476,69647,3.4330241393175545,96.56697586068245,Transportation
80848,23191,57657,28.68469226202256,71.31530773797743,Transportation
100080,23525,76555,23.50619504396483,76.49380495603518,Transportation
249021,42008,207013,16.869260022247122,83.13073997775288,Entertainment
130215,41972,88243,32.23284567830127,67.76715432169873,Healthcare
183358,64123,119235,34.97147656497126,65.02852343502875,Entertainment
157442,49091,108351,31.18037118430914,68.81962881569086,Healthcare
215840,33290,182550,15.423461823573017,84.57653817642698,Entertainment
30886,8200,22686,26.549245612899046,73.45075438710094,Food
15608,399,15209,2.5563813429010764,97.44361865709892,Housing
42638,4837,37801,11.344340728927248,88.65565927107275,Food
34869,8390,26479,24.061487280965903,75.93851271903411,Food
188559,54973,133586,29.154270016281377,70.84572998371861,Entertainment
205177,39348,165829,19.177588131223285,80.82241186877671,Entertainment
235497,22510,212987,9.558508176324963,90.44149182367504,Entertainment
208765,63346,145419,30.343208871218835,69.65679112878117,Entertainment
149203,41170,108033,27.593278955516983,72.40672104448302,Healthcare
166753,43673,123080,26.190233459068203,73.8097665409318,Healthcare
78469,31153,47316,39.701028431609934,60.29897156839007,Transportation
32246,655,31591,2.0312596911244802,97.96874030887552,Food
193529,49860,143669,25.763580651995312,74.23641934800469,Entertainment
182257,38611,143646,21.184920195109104,78.8150798048909,Entertainment
140450,57402,83048,40.87006051975792,59.12993948024208,Healthcare
214584,42595,171989,19.850035417365692,80.1499645826343,Entertainment
234429,33002,201427,14.077609852023427,85.92239014797657,Entertainment
120748,27781,92967,23.00742041276046,76.99257958723955,Healthcare
57865,21822,36043,37.71191566577378,62.28808433422621,Food
43715,11188,32527,25.59304586526364,74.40695413473635,Food
236265,43273,192992,18.31545087084418,81.68454912915583,Entertainment
242409,34881,207528,14.389317228320731,85.61068277167927,Entertainment
101142,36024,65118,35.61725099365249,64.38274900634751,Transportation
63957,13420,50537,20.982847850899823,79.01715214910018,Transportation
151588,11247,140341,7.419452727128796,92.5805472728712,Healthcare
17616,1874,15742,10.638056312443233,89.36194368755676,Housing
28259,16904,11355,59.81811104426909,40.18188895573091,Housing
57022,33736,23286,59.16313001999228,40.83686998000772,Food
157382,47723,109659,30.323035671169514,69.6769643288305,Healthcare
58226,18781,39445,32.25534984371243,67.74465015628756,Food
26917,6697,20220,24.880187242263254,75.11981275773675,Housing
40690,18401,22289,45.22241336937823,54.77758663062178,Food
34250,4275,29975,12.481751824817518,87.51824817518248,Food
166870,43142,123728,25.853658536585368,74.14634146341463,Healthcare
135144,30303,104841,22.42274906766116,77.57725093233884,Healthcare
21358,8605,12753,40.289352935668134,59.710647064331866,Housing
193277,43949,149328,22.73886701469911,77.26113298530089,Entertainment
94654,39380,55274,41.60415830287151,58.39584169712849,Transportation
244157,28854,215303,11.817805756132325,88.18219424386767,Entertainment
69229,19491,49738,28.154386167646507,71.8456138323535,Transportation
36695,8026,28669,21.872189671617388,78.12781032838262,Food
184811,8994,175817,4.866593438702242,95.13340656129776,Entertainment
65773,2626,63147,3.992519726939626,96.00748027306038,Transportation
13981,6031,7950,43.13711465560404,56.86288534439596,Housing
86632,15596,71036,18.002585649644473,81.99741435035553,Transportation
20801,11536,9265,55.45887216960723,44.54112783039277,Housing
33476,2800,30676,8.364201218783606,91.6357987812164,Food
89462,52657,36805,58.85962755136259,41.14037244863741,Transportation
149227,2328,146899,1.5600394030570877,98.43996059694291,Healthcare
235455,47725,187730,20.26926588944809,79.73073411055192,Entertainment
44614,9796,34818,21.957233155511723,78.04276684448827,Food
211298,52695,158603,24.938712150611934,75.06128784938807,Entertainment
109851,54786,55065,49.87300980418931,50.12699019581069,Transportation
183951,8234,175717,4.476192029399133,95.52380797060087,Entertainment
26954,2608,24346,9.675743859909474,90.32425614009053,Housing
42257,5951,36306,14.082873843386896,85.91712615661311,Food
75131,31428,43703,41.83093529967656,58.16906470032344,Transportation
105980,446,105534,0.4208341196452161,99.57916588035478,Transportation
248646,36879,211767,14.8319297314254,85.16807026857461,Entertainment
25479,3821,21658,14.996663919306094,85.0033360806939,Housing
241288,8399,232889,3.4809024899704917,96.51909751002951,Entertainment
55670,7526,48144,13.518950961020298,86.4810490389797,Food
113055,1383,111672,1.2232983945867055,98.7767016054133,Transportation
17842,3826,14016,21.443784329111086,78.55621567088892,Housing
248358,48204,200154,19.409078829753824,80.59092117024618,Entertainment
28390,10852,17538,38.22472701655513,61.77527298344487,Housing
94043,40582,53461,43.152600406197166,56.84739959380284,Transportation
10573,5344,5229,50.54383807812353,49.45616192187648,Housing
221714,52059,169655,23.480249330218207,76.5197506697818,Entertainment
11718,6395,5323,54.57415941286909,45.425840587130914,Housing
47731,12298,35433,25.765225953782654,74.23477404621734,Food
190958,61097,129861,31.994993663528103,68.0050063364719,Entertainment
24550,11345,13205,46.211812627291245,53.78818737270876,Housing
219622,59189,160433,26.950396590505505,73.0496034094945,Entertainment
25976,8714,17262,33.54635047736372,66.45364952263628,Housing
40961,2150,38811,5.248895290642318,94.75110470935768,Food
15780,2552,13228,16.172370088719898,83.8276299112801,Housing
179105,42335,136770,23.636972725496218,76.36302727450378,Healthcare
132213,58056,74157,43.91096185700347,56.08903814299653,Healthcare
64747,26902,37845,41.549415416930515,58.450584583069485,Transportation
198709,56624,142085,28.495941301098593,71.5040586989014,Entertainment
19124,8946,10178,46.77891654465593,53.221083455344065,Housing
128411,50976,77435,39.69753370038392,60.30246629961608,Healthcare
10069,1855,8214,18.42288211341742,81.57711788658258,Housing
50010,7696,42314,15.388922215556889,84.61107778444311,Food
73772,22050,51722,29.889388928048582,70.11061107195142,Transportation
88257,33760,54497,38.25192336018673,61.74807663981328,Transportation
112377,46994,65383,41.81816563887628,58.18183436112372,Transportation
17045,3712,13333,21.77764740393077,78.22235259606923,Housing
68428,15336,53092,22.411878178523413,77.58812182147659,Transportation
14594,639,13955,4.378511717144032,95.62148828285598,Housing
187537,15924,171613,8.491124418114826,91.50887558188518,Entertainment
103714,29849,73865,28.780106832250222,71.21989316774977,Transportation
173059,30817,142242,17.807221814525683,82.19277818547431,Healthcare
197848,24869,172979,12.56975051554729,87.43024948445272,Entertainment
56789,3995,52794,7.034813079997887,92.96518692000213,Food
42873,22885,19988,53.37858325752804,46.62141674247195,Food
53457,7003,46454,13.100248798099406,86.89975120190059,Food
63944,5663,58281,8.856186663330414,91.14381333666958,Transportation
43075,25755,17320,59.79106210098665,40.20893789901335,Food
146970,36217,110753,24.642444036197865,75.35755596380214,Healthcare
157050,40999,116051,26.105698822031197,73.8943011779688,Healthcare
175375,7928,167447,4.520598717034925,95.47940128296507,Healthcare
194304,16264,178040,8.370388669301713,91.6296113306983,Entertainment
51781,28836,22945,55.688379907688144,44.311620092311856,Food
53843,2589,51254,4.808424493434615,95.19157550656539,Food
47537,21927,25610,46.12617540021457,53.87382459978542,Food
57141,632,56509,1.1060359461682505,98.89396405383175,Food
121743,31565,90178,25.927568730851053,74.07243126914894,Healthcare
94221,24972,69249,26.503645684083168,73.49635431591683,Transportation
162916,48923,113993,30.029585798816566,69.97041420118343,Healthcare
212464,67241,145223,31.648185104300026,68.35181489569997,Entertainment
36574,12281,24293,33.57849838683218,66.42150161316782,Food
220264,38553,181711,17.503087204445574,82.49691279555442,Entertainment
144544,52187,92357,36.10457715297764,63.89542284702237,Healthcare
44335,35,44300,0.07894440058644411,99.92105559941355,Food
43552,9482,34070,21.771675238795005,78.22832476120499,Food
39056,7514,31542,19.239041376485048,80.76095862351495,Food
121694,38798,82896,31.881604680592307,68.1183953194077,Healthcare
154372,26535,127837,17.188998004819528,82.81100199518048,Healthcare
98268,43725,54543,44.4956649163512,55.50433508364879,Transportation
23331,3997,19334,17.13171317131713,82.86828682868287,Housing
70549,21174,49375,30.013182327176857,69.98681767282314,Transportation
217465,14270,203195,6.561975490308786,93.43802450969122,Entertainment
142662,13726,128936,9.62134275420224,90.37865724579775,Healthcare
30319,1797,28522,5.9269764833932514,94.07302351660675,Food
153296,36109,117187,23.555082976724766,76.44491702327522,Healthcare
32578,17250,15328,52.94984345263675,47.05015654736325,Food
63888,27712,36176,43.37590783871776,56.62409216128225,Transportation
48368,27047,21321,55.919202778696665,44.08079722130334,Food
231773,69005,162768,29.77266549598098,70.22733450401903,Entertainment
212809,40518,172291,19.03960828724349,80.9603917127565,Entertainment
206242,30976,175266,15.019249231485343,84.98075076851465,Entertainment
144526,51704,92822,35.774877876645036,64.22512212335498,Healthcare
28407,10551,17856,37.1422536698701,62.85774633012989,Housing
22388,11742,10646,52.44773986063963,47.55226013936037,Housing
158243,48066,110177,30.374803308835148,69.62519669116486,Healthcare
20982,6123,14859,29.182156133828997,70.817843866171,Housing
19844,9916,9928,49.969764160451525,50.030235839548475,Housing
82108,5474,76634,6.666829054416135,93.33317094558386,Transportation
15880,8300,7580,52.267002518891694,47.73299748110831,Housing
31015,14595,16420,47.05787522166693,52.94212477833307,Food
23946,998,22948,4.167710682368663,95.83228931763134,Housing
17730,1678,16052,9.46418499717992,90.53581500282007,Housing
162677,31206,131471,19.182797814073286,80.81720218592672,Healthcare
30630,15049,15581,49.13157035586026,50.86842964413974,Food
189379,52210,137169,27.569054647030555,72.43094535296945,Entertainment
87015,35463,51552,40.75504223409757,59.24495776590243,Transportation
16897,5979,10918,35.38497958217435,64.61502041782565,Housing
170275,12811,157464,7.523711642930553,92.47628835706945,Healthcare
31620,18736,12884,59.25363693864642,40.74636306135358,Food
157593,55013,102580,34.908276382834266,65.09172361716574,Healthcare
144449,44716,99733,30.956254456590216,69.04374554340978,Healthcare
170125,58376,111749,34.31359294636297,65.68640705363703,Healthcare
51248,19666,31582,38.37418045582267,61.62581954417733,Food
195620,65727,129893,33.5993252223699,66.4006747776301,Entertainment
19686,8322,11364,42.27369704358427,57.72630295641573,Housing
165179,56806,108373,34.390570229871834,65.60942977012817,Healthcare
59631,20881,38750,35.0170213479566,64.9829786520434,Food
231293,25744,205549,11.130470874604939,88.86952912539506,Entertainment
39137,7476,31661,19.102128420676088,80.8978715793239,Food
22264,13089,9175,58.7899748472871,41.210025152712895,Housing
56661,21895,34766,38.64209950406806,61.35790049593195,Food
37917,17528,20389,46.227285913969986,53.772714086030014,Food
147606,54120,93486,36.665176212349095,63.334823787650905,Healthcare
51928,3894,48034,7.498844553997844,92.50115544600216,Food
45712,1549,44163,3.3886069303465174,96.61139306965349,Food
108996,62813,46183,57.62872032001174,42.371279679988255,Transportation
106832,26041,80791,24.375655234386702,75.62434476561329,Transportation
48947,18842,30105,38.49469834719186,61.50530165280814,Food
166507,55928,110579,33.588978241155026,66.41102175884497,Healthcare
48046,10751,37295,22.376472547142324,77.62352745285767,Food
210510,35013,175497,16.632464015961236,83.36753598403877,Entertainment
62092,34676,27416,55.846163757005726,44.15383624299427,Transportation
233628,37034,196594,15.85169585837314,84.14830414162687,Entertainment
152356,12741,139615,8.362650634041325,91.63734936595867,Healthcare
52896,12498,40398,23.62749546279492,76.37250453720507,Food
13558,1341,12217,9.890839356837292,90.10916064316271,Housing
195227,1893,193334,0.9696404698120649,99.03035953018794,Entertainment
50079,1873,48206,3.7400906567623156,96.25990934323768,Food
161895,64105,97790,39.59665215108558,60.40334784891442,Healthcare
104787,12524,92263,11.951864257970932,88.04813574202906,Transportation
17709,3727,13982,21.045795922977018,78.95420407702298,Housing
233736,58131,175605,24.870366567409384,75.12963343259061,Entertainment
92167,41410,50757,44.92931309470852,55.070686905291474,Transportation
209229,57154,152075,27.316480984949504,72.68351901505049,Entertainment
192705,20746,171959,10.765678109026751,89.23432189097325,Entertainment
27901,7964,19937,28.543779792838965,71.45622020716104,Housing
136005,5385,130620,3.9594132568655565,96.04058674313445,Healthcare
15055,3776,11279,25.08136831617403,74.91863168382598,Housing
91861,47508,44353,51.71726848172783,48.28273151827217,Transportation
143359,55509,87850,38.72027567156579,61.27972432843421,Healthcare
53492,30825,22667,57.62543931802886,42.37456068197113,Food
162215,41301,120914,25.460654070215455,74.53934592978455,Healthcare
12643,3840,8803,30.372538163410585,69.62746183658942,Housing
137544,5657,131887,4.112865701157448,95.88713429884254,Healthcare
73834,36769,37065,49.79955034266057,50.20044965733944,Transportation
217120,3236,213884,1.4904200442151805,98.50957995578482,Entertainment
126026,19406,106620,15.398409851935316,84.60159014806469,Healthcare
228169,58692,169477,25.72303862487893,74.27696137512108,Entertainment
129601,12308,117293,9.496840302158162,90.50315969784184,Healthcare
174616,50387,124229,28.855889494662573,71.14411050533742,Healthcare
106593,50734,55859,47.595995984726954,52.404004015273046,Transportation
105927,19594,86333,18.497644604302963,81.50235539569704,Transportation
59579,9464,50115,15.884791621208816,84.11520837879118,Food
25631,7147,18484,27.884202723264796,72.11579727673521,Housing
59510,16296,43214,27.383633002856662,72.61636699714333,Food
24610,2965,21645,12.04794798862251,87.95205201137749,Housing
12113,6180,5933,51.019565755799555,48.980434244200445,Housing
180816,38310,142506,21.18728431112291,78.81271568887709,Entertainment
35787,13424,22363,37.51082795428508,62.48917204571492,Food
26315,3885,22430,14.7634429032871,85.2365570967129,Housing
17080,1655,15425,9.689695550351288,90.31030444964871,Housing
47344,21066,26278,44.495606623859416,55.50439337614059,Food
37419,15627,21792,41.76220636575002,58.23779363424998,Food
55036,6278,48758,11.407079002834507,88.59292099716549,Food
29002,17079,11923,58.88904213502517,41.11095786497483,Housing
100160,39360,60800,39.29712460063898,60.70287539936102,Transportation
81916,768,81148,0.9375457786024709,99.06245422139753,Transportation
73828,30117,43711,40.793465893698865,59.206534106301135,Transportation
101606,14276,87330,14.050351357203313,85.94964864279669,Transportation
28793,5809,22984,20.175042545063036,79.82495745493696,Housing
45481,15009,30472,33.00059365449309,66.99940634550691,Food
12793,5651,7142,44.1725943875557,55.8274056124443,Housing
160508,57651,102857,35.917835871109226,64.08216412889077,Healthcare
84918,14412,70506,16.97166678442733,83.02833321557267,Transportation
75125,8871,66254,11.808319467554076,88.19168053244593,Transportation
154176,41725,112451,27.063226442507265,72.93677355749274,Healthcare
73497,11009,62488,14.978842673850634,85.02115732614936,Transportation
40770,9913,30857,24.314446897228354,75.68555310277164,Food
41771,7736,34035,18.52002585525843,81.47997414474156,Food
165133,36529,128604,22.120957046744138,77.87904295325586,Healthcare
33267,11777,21490,35.40144888327772,64.59855111672228,Food
19175,2287,16888,11.926988265971318,88.07301173402868,Housing
210575,69519,141056,33.013890537813126,66.98610946218687,Entertainment
183137,50205,132932,27.413903252756132,72.58609674724387,Entertainment
23826,12450,11376,52.253840342483,47.746159657517,Housing
100061,3785,96276,3.7826925575399004,96.2173074424601,Transportation
161315,15095,146220,9.357468307348976,90.64253169265103,Healthcare
198978,28061,170917,14.102564102564102,85.8974358974359,Entertainment
174980,7637,167343,4.364498799862841,95.63550120013716,Healthcare
72028,3420,68608,4.74815349586272,95.25184650413728,Transportation
29082,4123,24959,14.177154253490132,85.82284574650987,Housing
179058,34491,144567,19.26247361190229,80.73752638809772,Healthcare
172231,18155,154076,10.541075648402435,89.45892435159757,Healthcare
216691,21555,195136,9.947344375170173,90.05265562482982,Entertainment
132059,14832,117227,11.231343566133319,88.76865643386668,Healthcare
128225,43466,84759,33.898225775004875,66.10177422499513,Healthcare
153068,9883,143185,6.456607520840412,93.54339247915959,Healthcare
48087,7773,40314,16.16445193087529,83.83554806912471,Food
157040,67318,89722,42.866785532348445,57.13321446765155,Healthcare
127290,34135,93155,26.816717731165056,73.18328226883494,Healthcare
32952,10887,22065,33.03896576839039,66.96103423160962,Food
209804,24649,185155,11.748584393052564,88.25141560694743,Entertainment
75100,20803,54297,27.70039946737683,72.29960053262316,Transportation
47087,14689,32398,31.195446726272646,68.80455327372735,Food
246152,17874,228278,7.261366960252202,92.7386330397478,Entertainment
96759,39775,56984,41.10728717742019,58.89271282257981,Transportation
20116,4795,15321,23.836746868164646,76.16325313183535,Housing
186817,49006,137811,26.232088086202005,73.76791191379799,Entertainment
89008,49388,39620,55.48714722272155,44.51285277727845,Transportation
32423,15304,17119,47.20106097523363,52.79893902476637,Food
154299,24847,129452,16.103150376865695,83.8968496231343,Healthcare
59079,24180,34899,40.92824861625958,59.07175138374041,Food
11141,865,10276,7.764114531909164,92.23588546809084,Housing
171179,11615,159564,6.785294925195264,93.21470507480474,Healthcare
131918,47030,84888,35.65093467153838,64.34906532846162,Healthcare
49785,14418,35367,28.960530280204882,71.03946971979512,Food
67268,2043,65225,3.037105310102872,96.96289468989713,Transportation
246897,12828,234069,5.195688890508998,94.804311109491,Entertainment
37792,15020,22772,39.74386113463167,60.256138865368335,Food
80540,2346,78194,2.9128383411969208,97.08716165880308,Transportation
41255,65,41190,0.15755665979881225,99.84244334020119,Food
58231,2482,55749,4.262334495371881,95.73766550462813,Food
168411,34903,133508,20.724893267066875,79.27510673293312,Healthcare
141315,24383,116932,17.254360825107028,82.74563917489297,Healthcare
87771,23939,63832,27.274384477788793,72.7256155222112,Transportation
78152,25841,52311,33.06505271778074,66.93494728221927,Transportation
67335,27260,40075,40.48414643201901,59.51585356798099,Transportation
85372,18153,67219,21.26341189148667,78.73658810851333,Transportation
99699,39090,60609,39.20801612854692,60.79198387145307,Transportation
47981,22977,25004,47.88770555011359,52.112294449886406,Food
174623,185,174438,0.105942516163392,99.8940574838366,Healthcare
21715,1703,20012,7.842505180750633,92.15749481924937,Housing
42134,22263,19871,52.838562680970234,47.161437319029766,Food
113562,50233,63329,44.23398672091016,55.76601327908983,Transportation
22868,10843,12025,47.415602588770334,52.584397411229666,Housing
15543,7817,7726,50.29273627999743,49.70726372000257,Housing
68552,28064,40488,40.93826584198857,59.06173415801143,Transportation
246358,48734,197624,19.781780985395237,80.21821901460477,Entertainment
38347,231,38116,0.602393929120922,99.39760607087908,Food
12829,4383,8446,34.16478291371112,65.83521708628888,Housing
56760,15255,41505,26.876321353065542,73.12367864693447,Food
167380,8717,158663,5.207910144581192,94.79208985541881,Healthcare
183352,56185,127167,30.64324359701558,69.35675640298442,Entertainment
26218,1270,24948,4.844000305133878,95.15599969486613,Housing
15314,3704,11610,24.187018414522658,75.81298158547735,Housing
186742,35303,151439,18.904692035000163,81.09530796499985,Entertainment
213836,56863,156973,26.59187414654221,73.40812585345779,Entertainment
104153,24796,79357,23.80728351559725,76.19271648440275,Transportation
103166,35519,67647,34.42897853944129,65.57102146055871,Transportation
16830,7685,9145,45.66250742721331,54.337492572786694,Housing
44334,14191,30143,32.00929309333694,67.99070690666305,Food
34445,13713,20732,39.81129336623603,60.188706633763964,Food
207547,30486,177061,14.688721108953635,85.31127889104636,Entertainment
23150,8974,14176,38.7645788336933,61.23542116630669,Housing
201564,4458,197106,2.211704471036495,97.78829552896352,Entertainment
196136,65646,130490,33.46963331565852,66.53036668434147,Entertainment
61050,13930,47120,22.81736281736282,77.18263718263718,Transportation
24168,8980,15188,37.156570671962925,62.84342932803707,Housing
211632,43142,168490,20.385385952974975,79.61461404702503,Entertainment
31282,2546,28736,8.138865801419346,91.86113419858066,Food
238065,10705,227360,4.496671077226807,95.50332892277319,Entertainment
20606,10135,10471,49.184703484422016,50.81529651557799,Housing
142317,60488,81829,42.50230120084038,57.49769879915962,Healthcare
155407,2921,152486,1.8795807138674576,98.12041928613255,Healthcare
19152,4471,14681,23.344820384294067,76.65517961570593,Housing
58641,11063,47578,18.865640081171875,81.13435991882812,Food
26357,5953,20404,22.586030276586865,77.41396972341313,Housing
50610,10140,40470,20.03556609365738,79.96443390634262,Food
130105,38414,91691,29.52538334422197,70.47461665577802,Healthcare
190941,1152,189789,0.603327729508068,99.39667227049193,Entertainment
38677,9270,29407,23.967732761072472,76.03226723892753,Food
199561,33678,165883,16.876042914196663,83.12395708580334,Entertainment
28873,3218,25655,11.145360717625463,88.85463928237454,Housing
44065,12023,32042,27.284693067060022,72.71530693293997,Food
195813,26542,169271,13.554769090918375,86.44523090908163,Entertainment
21436,7489,13947,34.936555327486474,65.06344467251353,Housing
125553,30672,94881,24.42952378676734,75.57047621323267,Healthcare
240924,59379,181545,24.646361508193454,75.35363849180654,Entertainment
166700,42207,124493,25.31913617276545,74.68086382723456,Healthcare
77712,27395,50317,35.25195593988059,64.74804406011941,Transportation
45489,25152,20337,55.29248829387324,44.70751170612676,Food
25662,631,25031,2.458888629101395,97.5411113708986,Housing
170000,32814,137186,19.30235294117647,80.69764705882353,Healthcare
109895,33607,76288,30.58100914509304,69.41899085490697,Transportation
39175,6714,32461,17.13848117421825,82.86151882578174,Food
51343,5157,46186,10.044212453499018,89.95578754650099,Food
43974,10064,33910,22.886250966480194,77.11374903351981,Food
237424,14626,222798,6.160287081339713,93.8397129186603,Entertainment
15481,2071,13410,13.377688779794585,86.62231122020542,Housing
73514,40042,33472,54.46853660527247,45.53146339472753,Transportation
191078,58752,132326,30.747652791006814,69.25234720899319,Entertainment
38912,20577,18335,52.880859375,47.119140625,Food
14360,3302,11058,22.994428969359333,77.00557103064068,Housing
169694,12691,157003,7.478755878227869,92.52124412177213,Healthcare
59678,25417,34261,42.5902342571802,57.40976574281979,Food
89651,51476,38175,57.41821061672485,42.581789383275144,Transportation
102425,18938,83487,18.489626556016596,81.5103734439834,Transportation
188236,53488,134748,28.41539344227459,71.58460655772541,Entertainment
96869,12015,84854,12.403348852574094,87.5966511474259,Transportation
22535,302,22233,1.3401375637896606,98.65986243621035,Housing
131576,12726,118850,9.67197665227701,90.32802334772299,Healthcare
24999,10169,14830,40.6776271050842,59.3223728949158,Housing
181991,57288,124703,31.478479705040357,68.52152029495964,Entertainment
248477,28804,219673,11.59221980304012,88.40778019695989,Entertainment
102929,44105,58824,42.84992567692293,57.15007432307707,Transportation
207733,11968,195765,5.761241593776627,94.23875840622338,Entertainment
19570,1543,18027,7.884517118037813,92.11548288196218,Housing
12726,6153,6573,48.349834983498354,51.650165016501646,Housing
53927,31035,22892,57.5500213251247,42.4499786748753,Food
218849,20296,198553,9.273974292777213,90.72602570722279,Entertainment
134450,42720,91730,31.773893640758644,68.22610635924136,Healthcare
12262,1575,10687,12.844560430598598,87.15543956940141,Housing
227307,7000,220307,3.0795356060306105,96.92046439396938,Entertainment
136833,53973,82860,39.444432264146805,60.55556773585319,Healthcare
50958,19341,31617,37.95478629459555,62.04521370540446,Food
124898,16271,108627,13.027430383192684,86.97256961680732,Healthcare
96154,34329,61825,35.7021028766354,64.2978971233646,Transportation
33948,14972,18976,44.10274537527984,55.89725462472016,Food
44280,23227,21053,52.45483288166215,47.54516711833785,Food
95830,30134,65696,31.44526766148388,68.55473233851612,Transportation
24319,6839,17480,28.122044491961017,71.87795550803898,Housing
233832,63372,170460,27.10150877553115,72.89849122446886,Entertainment
150564,69205,81359,45.9638426184214,54.0361573815786,Healthcare
138862,50699,88163,36.51034840345091,63.48965159654909,Healthcare
228172,56748,171424,24.870711568465893,75.1292884315341,Entertainment
225349,481,224868,0.21344669823251933,99.78655330176748,Entertainment
178041,15163,162878,8.516577642228476,91.48342235777153,Healthcare
247279,43760,203519,17.696609902175275,82.30339009782472,Entertainment
191587,38011,153576,19.8400726562867,80.1599273437133,Entertainment
24622,9723,14899,39.489074811144505,60.51092518885549,Housing
55118,28517,26601,51.738089190464095,48.261910809535905,Food
220610,65351,155259,29.62286387743076,70.37713612256924,Entertainment
23442,6802,16640,29.016295537923387,70.98370446207662,Housing
168342,69380,98962,41.213719689679344,58.78628031032066,Healthcare
44596,25860,18736,57.98726343169791,42.01273656830209,Food
180163,34992,145171,19.422411926977237,80.57758807302277,Entertainment
74434,40459,33975,54.35553644839723,45.64446355160276,Transportation
217745,51040,166705,23.44026269259914,76.55973730740085,Entertainment
216342,42624,173718,19.702138281054996,80.297861718945,Entertainment
201648,54753,146895,27.152761247322065,72.84723875267794,Entertainment
16220,5095,11125,31.411837237977807,68.5881627620222,Housing
143300,43677,99623,30.479413817166783,69.52058618283323,Healthcare
12748,3731,9017,29.26733605271415,70.73266394728584,Housing
53001,18577,34424,35.05028207014962,64.94971792985038,Food
83764,45849,37915,54.73592474093883,45.26407525906117,Transportation
34893,2960,31933,8.48307683489525,91.51692316510474,Food
156069,7595,148474,4.866437280946248,95.13356271905376,Healthcare
175305,58498,116807,33.369270699637774,66.63072930036222,Healthcare
249478,39989,209489,16.02906869543607,83.97093130456393,Entertainment
225442,35335,190107,15.673654421092786,84.32634557890721,Entertainment
49911,10764,39147,21.566388170944283,78.43361182905572,Food
237129,16401,220728,6.9164884936047475,93.08351150639525,Entertainment
130774,12498,118276,9.55694557022038,90.44305442977962,Healthcare
155020,12272,142748,7.916397884143982,92.08360211585602,Healthcare
20102,10138,9964,50.432792756939605,49.56720724306039,Housing
15940,7063,8877,44.3099121706399,55.6900878293601,Housing
57078,14171,42907,24.827429132064893,75.17257086793511,Food
12338,6113,6225,49.546117685200194,50.453882314799806,Housing
164317,47993,116324,29.20756829786328,70.79243170213672,Healthcare
98456,5772,92684,5.862517266596246,94.13748273340376,Transportation
55804,32984,22820,59.10687405920723,40.89312594079277,Food
35149,19384,15765,55.148083871518395,44.851916128481605,Food
177040,40915,136125,23.110596475372798,76.8894035246272,Healthcare
126528,35178,91350,27.802541729893775,72.19745827010622,Healthcare
30714,1945,28769,6.3326170476004435,93.66738295239956,Food
32185,14134,18051,43.91486717414945,56.08513282585055,Food
141159,173,140986,0.12255683307475966,99.87744316692525,Healthcare
19049,8604,10445,45.167725339912856,54.832274660087144,Housing
41329,23705,17624,57.35681966657795,42.64318033342205,Food
228391,48542,179849,21.253902299127372,78.74609770087262,Entertainment
163893,62444,101449,38.10046798826063,61.89953201173937,Healthcare
73064,37793,35271,51.725884156356074,48.274115843643926,Transportation
216787,62101,154686,28.646090402099755,71.35390959790024,Entertainment
45444,18907,26537,41.60505237215034,58.39494762784966,Food
203940,68353,135587,33.51623026380308,66.48376973619692,Entertainment
112848,10386,102462,9.203530412590387,90.79646958740962,Transportation
202992,55938,147054,27.55675100496571,72.44324899503428,Entertainment
94409,19443,74966,20.594434852609393,79.4055651473906,Transportation
235425,26611,208814,11.303387490708293,88.69661250929171,Entertainment
62961,37201,25760,59.08578326265466,40.914216737345335,Transportation
181111,55935,125176,30.88437477569005,69.11562522430995,Entertainment
67274,19418,47856,28.864048518001013,71.13595148199899,Transportation
33118,13351,19767,40.3134247237152,59.686575276284806,Food
153746,6809,146937,4.428733105251519,95.57126689474849,Healthcare
119447,50763,68684,42.49834654700411,57.501653452995896,Transportation
39835,9121,30714,22.896949918413455,77.10305008158655,Food
236165,49904,186261,21.13098892723308,78.86901107276692,Entertainment
103510,2869,100641,2.7717128779828037,97.22828712201719,Transportation
241031,42677,198354,17.706021217187832,82.29397878281218,Entertainment
13693,6714,6979,49.03235229679398,50.96764770320602,Housing
23147,11226,11921,48.49872553678662,51.50127446321338,Housing
222420,44100,178320,19.827353655246828,80.17264634475318,Entertainment
240967,65347,175620,27.118651101603124,72.88134889839688,Entertainment
205907,10357,195550,5.029940701384605,94.9700592986154,Entertainment
203531,55233,148298,27.137389390314006,72.862610609686,Entertainment
186779,59720,127059,31.973615877587953,68.02638412241205,Entertainment
147563,67510,80053,45.74995086844263,54.25004913155737,Healthcare
157120,3538,153582,2.2517820773930755,97.74821792260693,Healthcare
17099,713,16386,4.169834493245219,95.83016550675478,Housing
49644,7053,42591,14.207154943195551,85.79284505680445,Food
154913,1714,153199,1.1064274786493065,98.89357252135069,Healthcare
59044,18862,40182,31.945667637693926,68.05433236230608,Food
121268,46523,74745,38.363789293135866,61.636210706864134,Healthcare
26319,10321,15998,39.21501576807629,60.7849842319237,Housing
87609,39260,48349,44.812747548767824,55.18725245123218,Transportation
146090,50015,96075,34.23574508864399,65.76425491135602,Healthcare
159534,6852,152682,4.295009214336756,95.70499078566324,Healthcare
122164,6986,115178,5.7185422874169145,94.28145771258308,Healthcare
228147,57769,170378,25.320955348963608,74.67904465103639,Entertainment
160008,26492,133516,16.55667216639168,83.44332783360832,Healthcare
88016,38402,49614,43.630703508453,56.369296491547,Transportation
42036,10061,31975,23.934246836045293,76.06575316395471,Food
143798,50124,93674,34.85723028136692,65.14276971863309,Healthcare
175414,7375,168039,4.204339448390664,95.79566055160934,Healthcare
176218,33050,143168,18.755178245128192,81.24482175487181,Healthcare
91667,2954,88713,3.2225337362409587,96.77746626375904,Transportation
111048,42310,68738,38.100641164181255,61.89935883581874,Transportation
71884,30858,41026,42.92749429636637,57.07250570363364,Transportation
57165,13339,43826,23.33420799440217,76.66579200559784,Food
237007,69567,167440,29.35229761146295,70.64770238853704,Entertainment
125090,315,124775,0.2518186905428092,99.7481813094572,Healthcare
23186,5756,17430,24.825325627533857,75.17467437246614,Housing
177904,43211,134693,24.28894235093084,75.71105764906916,Healthcare
28298,16726,11572,59.106650646688806,40.89334935331119,Housing
36129,9529,26600,26.374934263334165,73.62506573666585,Food
246884,55182,191702,22.35138769624601,77.64861230375399,Entertainment
131019,44652,86367,34.08055320220731,65.91944679779269,Healthcare
159614,13299,146315,8.331975891839063,91.66802410816094,Healthcare
155791,42164,113627,27.064464571124137,72.93553542887587,Healthcare
49298,20539,28759,41.66294778692848,58.33705221307153,Food
29128,7127,22001,24.467865970887118,75.53213402911288,Housing
84890,19575,65315,23.059253151136765,76.94074684886324,Transportation
156940,29764,127176,18.965209634255128,81.03479036574487,Healthcare
149933,8032,141901,5.357059486570668,94.64294051342932,Healthcare
26295,9977,16318,37.94257463396083,62.057425366039176,Housing
144397,6197,138200,4.291640408041719,95.70835959195828,Healthcare
131089,8303,122786,6.3338647788906774,93.66613522110933,Healthcare
33084,11781,21303,35.60935799782372,64.39064200217628,Food
76768,13261,63507,17.27412463526469,82.7258753647353,Transportation
119936,55551,64385,46.31720250800427,53.68279749199573,Transportation
219123,46628,172495,21.279372772369857,78.72062722763015,Entertainment
189518,52573,136945,27.740372946105385,72.25962705389462,Entertainment
46867,28019,18848,59.784069814581684,40.215930185418316,Food
18181,9402,8779,51.713327099719486,48.286672900280514,Housing
17803,9784,8019,54.95702971409313,45.04297028590687,Housing
28085,6202,21883,22.08296243546377,77.91703756453623,Housing
53318,29960,23358,56.19115495705015,43.80884504294985,Food
154004,50176,103828,32.5809719228072,67.4190280771928,Healthcare
110702,8391,102311,7.57980885620856,92.42019114379144,Transportation
26267,1342,24925,5.109072219895686,94.89092778010432,Housing
109701,55857,53844,50.9174939152788,49.082506084721196,Transportation
125768,42591,83177,33.86473506774379,66.13526493225622,Healthcare
12020,519,11501,4.3178036605657235,95.68219633943428,Housing
124014,5730,118284,4.620446078668537,95.37955392133146,Healthcare
18075,291,17784,1.6099585062240664,98.39004149377594,Housing
157172,18682,138490,11.88634107856361,88.11365892143638,Healthcare
169854,58671,111183,34.54201843936558,65.45798156063442,Healthcare
10801,5770,5031,53.420979538931576,46.579020461068424,Housing
45598,17138,28460,37.584981797447256,62.415018202552744,Food
118112,49639,68473,42.02705906258466,57.97294093741533,Transportation
26506,1347,25159,5.081868256243869,94.91813174375613,Housing
117133,32457,84676,27.709526777253206,72.29047322274678,Transportation
104321,30894,73427,29.614363359246944,70.38563664075306,Transportation
99819,1841,97978,1.8443382522365481,98.15566174776346,Transportation
59483,32654,26829,54.896356942319656,45.10364305768035,Food
39074,2230,36844,5.707119823923837,94.29288017607617,Food
88114,25569,62545,29.018090201330093,70.9819097986699,Transportation
14580,8699,5881,59.6639231824417,40.3360768175583,Housing
90614,27960,62654,30.856159092413975,69.14384090758602,Transportation
87124,51542,35582,59.15935907442266,40.84064092557734,Transportation
20841,10899,9942,52.29595508852742,47.70404491147258,Housing
102619,48843,53776,47.59644900067239,52.40355099932761,Transportation
24285,8858,15427,36.475190446777844,63.52480955322215,Housing
183010,37305,145705,20.384132014644006,79.61586798535599,Entertainment
156840,27481,129359,17.52167814333078,82.47832185666921,Healthcare
187420,65367,122053,34.87728097321524,65.12271902678476,Entertainment
159792,11230,148562,7.027886252127765,92.97211374787223,Healthcare
161341,20097,141244,12.456226253711083,87.5437737462889,Healthcare
11566,686,10880,5.931177589486426,94.06882241051358,Housing
123607,19353,104254,15.656880273770904,84.3431197262291,Healthcare
76335,12466,63869,16.330647802449725,83.66935219755027,Transportation
126484,5031,121453,3.977578191708042,96.02242180829195,Healthcare
239237,7926,231311,3.313032683071598,96.6869673169284,Entertainment
172856,50308,122548,29.10399407599389,70.89600592400612,Healthcare
40044,22734,17310,56.77255019478573,43.22744980521426,Food
212674,28923,183751,13.599687785060704,86.4003122149393,Entertainment
36555,20606,15949,56.36985364519218,43.63014635480783,Food
65386,36929,28457,56.478451044566114,43.521548955433886,Transportation
74289,27224,47065,36.64607142376395,63.35392857623605,Transportation
17091,196,16895,1.1468024106254753,98.85319758937452,Housing
220788,31872,188916,14.435567150388609,85.56443284961139,Entertainment
91201,1079,90122,1.1831010624883498,98.81689893751165,Transportation
43642,19166,24476,43.91641079693873,56.083589203061265,Food
71023,29970,41053,42.197597961223835,57.802402038776165,Transportation
59264,20845,38419,35.17312365010799,64.826876349892,Food
83188,23689,59499,28.476462951387223,71.52353704861278,Transportation
47571,27987,19584,58.83206155010405,41.16793844989595,Food
19480,3982,15498,20.44147843942505,79.55852156057495,Housing
15840,7346,8494,46.37626262626263,53.62373737373738,Housing
30139,3576,26563,11.865025382394903,88.1349746176051,Food
96543,25022,71521,25.917984732191872,74.08201526780813,Transportation
51900,8432,43468,16.246628131021197,83.7533718689788,Food
240392,49218,191174,20.474059036906386,79.52594096309362,Entertainment
131435,59952,71483,45.61342108266444,54.38657891733556,Healthcare
230280,3281,226999,1.4247872155636616,98.57521278443635,Entertainment
123164,30808,92356,25.013802734565292,74.98619726543471,Healthcare
122500,49949,72551,40.77469387755102,59.225306122448984,Healthcare
182669,11534,171135,6.314152921404288,93.68584707859571,Entertainment
131124,60262,70862,45.95802446539154,54.04197553460847,Healthcare
234335,8325,226010,3.5526063114771587,96.44739368852284,Entertainment
225386,49862,175524,22.12293576353456,77.87706423646544,Entertainment
132112,50631,81481,38.32430059343587,61.675699406564135,Healthcare
47410,9054,38356,19.09723686985868,80.90276313014132,Food
163659,35280,128379,21.557017945850824,78.44298205414918,Healthcare
42992,23110,19882,53.754186825455896,46.245813174544104,Food
143883,47189,96694,32.79678627773956,67.20321372226044,Healthcare
72127,31015,41112,43.00054071290917,56.99945928709083,Transportation
13787,1844,11943,13.374918401392616,86.62508159860738,Housing
161800,30841,130959,19.061186650185412,80.93881334981458,Healthcare
27082,669,26413,2.47027545971494,97.52972454028506,Housing
40136,15403,24733,38.377018138329674,61.622981861670326,Food
198140,15547,182593,7.846472191379833,92.15352780862017,Entertainment
145569,16455,129114,11.303917729736414,88.69608227026359,Healthcare
125901,59480,66421,47.24346907490806,52.75653092509194,Healthcare
27320,11919,15401,43.627379209370424,56.37262079062958,Housing
85581,6811,78770,7.958542199787336,92.04145780021267,Transportation
146558,31722,114836,21.64467309870495,78.35532690129506,Healthcare
20681,157,20524,0.7591509114646294,99.24084908853537,Housing
161466,49538,111928,30.680143188039587,69.3198568119604,Healthcare
86067,14326,71741,16.645171784772327,83.35482821522767,Transportation
235275,8552,226723,3.6348953352459885,96.36510466475401,Entertainment
73999,15033,58966,20.315139393775592,79.6848606062244,Transportation
221060,40511,180549,18.325793902108025,81.67420609789198,Entertainment
147978,31771,116207,21.470083390774306,78.5299166092257,Healthcare
226493,45377,181116,20.034614756305935,79.96538524369406,Entertainment
20599,4019,16580,19.51065585708044,80.48934414291956,Housing
25108,4311,20797,17.169826350167277,82.83017364983273,Housing
119486,32659,86827,27.33290929481278,72.66709070518722,Transportation
246777,39292,207485,15.922067291522305,84.0779327084777,Entertainment
178479,2047,176432,1.1469136425013586,98.85308635749864,Healthcare
179358,43872,135486,24.46057605459472,75.53942394540528,Healthcare
111842,19542,92300,17.472863503871533,82.52713649612846,Transportation
177922,42220,135702,23.729499443576398,76.2705005564236,Healthcare
218433,3884,214549,1.7781196064697185,98.22188039353028,Entertainment
48474,25934,22540,53.500845814250944,46.499154185749056,Food
217414,23468,193946,10.79415309041736,89.20584690958265,Entertainment
192417,43644,148773,22.681987558271878,77.31801244172813,Entertainment
129248,45452,83796,35.166501609309236,64.83349839069076,Healthcare
135742,68001,67741,50.09576991645916,49.90423008354084,Healthcare
72876,20862,52014,28.626708381360118,71.37329161863988,Transportation
232527,33288,199239,14.315756879846212,85.6842431201538,Entertainment
242037,3573,238464,1.476220577845536,98.52377942215446,Entertainment
242177,12275,229902,5.0686068454064594,94.93139315459355,Entertainment
195384,23230,172154,11.889407525692993,88.110592474307,Entertainment
174867,47552,127315,27.19323828967158,72.80676171032842,Healthcare
50306,20255,30051,40.26358684848726,59.73641315151275,Food
30816,5169,25647,16.773753894080997,83.226246105919,Food
202651,39146,163505,19.316953777676893,80.68304622232311,Entertainment
196092,24209,171883,12.345735675091284,87.65426432490871,Entertainment
64657,38077,26580,58.890762021126875,41.10923797887313,Transportation
68427,30566,37861,44.669501804843115,55.330498195156885,Transportation
42597,7503,35094,17.613916472991058,82.38608352700895,Food
47104,22182,24922,47.09154211956522,52.90845788043478,Food
11972,6394,5578,53.40795188773806,46.59204811226195,Housing
85240,16379,68861,19.21515720319099,80.784842796809,Transportation
19994,241,19753,1.205361608482545,98.79463839151745,Housing
53022,14177,38845,26.73795782882577,73.26204217117423,Food
71803,11171,60632,15.55784577246076,84.44215422753923,Transportation
11264,376,10888,3.3380681818181817,96.66193181818183,Housing
155386,26697,128689,17.18108452498938,82.81891547501063,Healthcare
222253,15111,207142,6.799008337345278,93.20099166265472,Entertainment
208022,69208,138814,33.269558027516325,66.73044197248367,Entertainment
26085,4104,21981,15.733179988499138,84.26682001150087,Housing
124068,26560,97508,21.407615178772932,78.59238482122707,Healthcare
86983,39291,47692,45.17089546233172,54.829104537668286,Transportation
118220,42592,75628,36.0277448824226,63.972255117577404,Transportation
182939,4755,178184,2.5992270647592917,97.40077293524071,Entertainment
189696,16769,172927,8.839933367071524,91.16006663292848,Entertainment
18208,731,17477,4.014718804920914,95.98528119507908,Housing
17094,7761,9333,45.4018954018954,54.598104598104605,Housing
22294,13318,8976,59.73804611106127,40.26195388893873,Housing
73952,33891,40061,45.82837516226741,54.17162483773258,Transportation
169383,23633,145750,13.952403724104546,86.04759627589546,Healthcare
182108,60279,121829,33.10068750411844,66.89931249588157,Entertainment
29711,3820,25891,12.85719093938272,87.14280906061728,Housing
239566,19592,219974,8.178122104138316,91.82187789586168,Entertainment
13657,4902,8755,35.89368089624369,64.10631910375632,Housing
193378,59812,133566,30.930095460703903,69.06990453929609,Entertainment
82449,21457,60992,26.024572766194858,73.97542723380514,Transportation
68841,4660,64181,6.769221830014091,93.23077816998591,Transportation
56741,19224,37517,33.88026294919018,66.11973705080982,Food
213925,51554,162371,24.099100151922404,75.9008998480776,Entertainment
159711,46186,113525,28.918484011746216,71.08151598825378,Healthcare
131473,45434,86039,34.55766583252835,65.44233416747164,Healthcare
192529,34282,158247,17.806148684094346,82.19385131590565,Entertainment
25717,4433,21284,17.237624917369835,82.76237508263017,Housing
52286,26921,25365,51.487970011092834,48.512029988907166,Food
15492,1315,14177,8.48825200103279,91.51174799896721,Housing
245933,29823,216110,12.12647347041674,87.87352652958326,Entertainment
188245,60148,128097,31.951977476161385,68.04802252383861,Entertainment
69607,2324,67283,3.338744666484693,96.6612553335153,Transportation
99583,56091,43492,56.32587891507587,43.67412108492413,Transportation
137754,4444,133310,3.2260406231397996,96.77395937686019,Healthcare
32403,6794,25609,20.967194395580655,79.03280560441934,Food
59934,26511,33423,44.233657022725,55.76634297727501,Food
52352,9946,42406,18.998319070904646,81.00168092909536,Food
19797,394,19403,1.990200535434662,98.00979946456533,Housing
142457,49099,93358,34.465838814519465,65.53416118548053,Healthcare
34528,17622,16906,51.036839666357736,48.963160333642264,Food
57978,15786,42192,27.227569077926113,72.7724309220739,Food
26308,8112,18196,30.834727079215448,69.16527292078455,Housing
92412,19377,73035,20.96805609661083,79.03194390338916,Transportation
78531,18533,59998,23.599597611134456,76.40040238886554,Transportation
11450,6842,4608,59.75545851528384,40.24454148471616,Housing
118090,42062,76028,35.61859598611229,64.38140401388772,Transportation
154174,43774,110400,28.392595379246828,71.60740462075317,Healthcare
136970,54059,82911,39.46776666423305,60.53223333576696,Healthcare
86888,2267,84621,2.609105975508701,97.3908940244913,Transportation
246513,3667,242846,1.4875483240234795,98.51245167597652,Entertainment
16309,8206,8103,50.315776565086765,49.684223434913235,Housing
21731,10184,11547,46.863927108738665,53.136072891261335,Housing
172471,28619,143852,16.593514271964562,83.40648572803543,Healthcare
244870,62858,182012,25.669947318985585,74.33005268101441,Entertainment
11687,6867,4820,58.757593907760764,41.24240609223924,Housing
69015,33055,35960,47.895385061218576,52.104614938781424,Transportation
183443,42933,140510,23.404000152635966,76.59599984736403,Entertainment
231814,46815,184999,20.19507018557982,79.80492981442018,Entertainment
229250,20449,208801,8.919956379498364,91.08004362050164,Entertainment
102698,40854,61844,39.780716274903114,60.219283725096886,Transportation
136080,4114,131966,3.023221634332746,96.97677836566726,Healthcare
125956,11640,114316,9.241322366540697,90.7586776334593,Healthcare
103468,53385,50083,51.595662427030575,48.40433757296942,Transportation
154240,62159,92081,40.30018153526971,59.69981846473029,Healthcare
10538,455,10083,4.31770734484722,95.68229265515278,Housing
169010,17622,151388,10.426601976214425,89.57339802378557,Healthcare
246450,14008,232442,5.683911543923717,94.31608845607629,Entertainment
59516,35347,24169,59.39075206667115,40.60924793332885,Food
156148,42657,113491,27.318313394984244,72.68168660501576,Healthcare
232626,6734,225892,2.8947753045661275,97.10522469543386,Entertainment
222602,41490,181112,18.638646553040854,81.36135344695916,Entertainment
74974,19688,55286,26.259770053618585,73.7402299463814,Transportation
239059,26667,212392,11.154986844251837,88.84501315574816,Entertainment
54761,12824,41937,23.418126038604118,76.58187396139589,Food
44946,17202,27744,38.272593779201706,61.72740622079829,Food
47717,1911,45806,4.0048619988683285,95.99513800113168,Food
17030,7892,9138,46.341749853200234,53.658250146799766,Housing
171194,3050,168144,1.7816044954846548,98.21839550451534,Healthcare
46349,9972,36377,21.515027292929727,78.48497270707027,Food
46490,1924,44566,4.1385244138524415,95.86147558614756,Food
198127,1309,196818,0.6606873369101637,99.33931266308984,Entertainment
242266,19794,222472,8.17035820131591,91.8296417986841,Entertainment
202804,45595,157209,22.482298179523085,77.51770182047692,Entertainment
78485,38092,40393,48.534114799006176,51.465885200993824,Transportation
51553,4631,46922,8.98298838088957,91.01701161911043,Food
42425,12383,30042,29.187978786093105,70.81202121390689,Food
180703,39808,140895,22.029518048953257,77.97048195104675,Entertainment
188539,27469,161070,14.569399434599738,85.43060056540025,Entertainment
177271,46702,130569,26.344974643342677,73.65502535665732,Healthcare
221268,18539,202729,8.378527396641179,91.62147260335882,Entertainment
190334,12895,177439,6.774932487101622,93.22506751289838,Entertainment
22852,1407,21445,6.157010327323648,93.84298967267635,Housing
153651,50078,103573,32.59204300655381,67.40795699344618,Healthcare
72216,8903,63313,12.328292899080537,87.67170710091946,Transportation
226893,43692,183201,19.256654017532494,80.7433459824675,Entertainment
36850,16476,20374,44.71099050203528,55.28900949796473,Food
228993,39596,189397,17.29135825112558,82.70864174887443,Entertainment
48790,15634,33156,32.043451526952246,67.95654847304775,Food
215210,16818,198392,7.814692625807352,92.18530737419265,Entertainment
22807,13446,9361,58.955583811987545,41.04441618801245,Housing
13889,482,13407,3.470372237022104,96.5296277629779,Housing
232406,17990,214416,7.740764007813912,92.25923599218608,Entertainment
96125,7289,88836,7.582834850455137,92.41716514954487,Transportation
100689,5477,95212,5.4395216955178824,94.56047830448212,Transportation
13512,6615,6897,48.95648312611012,51.04351687388987,Housing
133080,42260,90820,31.755335136759843,68.24466486324016,Healthcare
82647,29660,52987,35.887570026740235,64.11242997325976,Transportation
169435,57255,112180,33.79171953846608,66.20828046153392,Healthcare
24816,7470,17346,30.10154738878143,69.89845261121856,Housing
29908,6093,23815,20.372475591814897,79.6275244081851,Housing
206419,13125,193294,6.358426307655788,93.64157369234421,Entertainment
53107,15690,37417,29.544127892744836,70.45587210725517,Food
152651,51186,101465,33.53138859227912,66.46861140772089,Healthcare
120141,66640,53501,55.46815824739265,44.531841752607356,Healthcare
67053,17610,49443,26.262807033242357,73.73719296675763,Transportation
10945,1636,9309,14.947464595705801,85.05253540429419,Housing
247951,62075,185876,25.0351884041605,74.96481159583949,Entertainment
248801,34039,214762,13.68121510765632,86.31878489234369,Entertainment
207106,2641,204465,1.2751924135466863,98.72480758645331,Entertainment
166521,7104,159417,4.266128596393248,95.73387140360676,Healthcare
20541,2309,18232,11.240932768609122,88.75906723139087,Housing
138456,35139,103317,25.379181833940024,74.62081816605998,Healthcare
174222,25394,148828,14.575656346500443,85.42434365349956,Healthcare
21004,9814,11190,46.72443344124929,53.27556655875071,Housing
37549,3187,34362,8.48757623372127,91.51242376627873,Food
19390,3756,15634,19.370809695719444,80.62919030428056,Housing
28319,2799,25520,9.883823581341149,90.11617641865885,Housing
32484,17581,14903,54.12202930673562,45.87797069326437,Food
12575,4790,7785,38.09145129224652,61.908548707753475,Housing
57210,21115,36095,36.907883237196295,63.092116762803705,Food
108727,49044,59683,45.10747100536206,54.89252899463794,Transportation
199707,60008,139699,30.048020349812475,69.95197965018752,Entertainment
155664,50581,105083,32.49370438894028,67.50629561105971,Healthcare
47748,24887,22861,52.121554829521656,47.878445170478344,Food
152472,48264,104208,31.654336533920986,68.34566346607902,Healthcare
32513,5570,26943,17.13160889490358,82.86839110509644,Food
170416,38386,132030,22.52488029293024,77.47511970706977,Healthcare
158332,7903,150429,4.991410453982771,95.00858954601723,Healthcare
238389,12881,225508,5.403353342645843,94.59664665735416,Entertainment
22518,3815,18703,16.94200195399236,83.05799804600764,Housing
44989,24655,20334,54.802285003000726,45.19771499699927,Food
11536,2627,8909,22.772191400832178,77.22780859916783,Housing
74774,41174,33600,55.06459464519753,44.93540535480247,Transportation
203497,55376,148121,27.21219477437014,72.78780522562987,Entertainment
106646,53980,52666,50.61605686101682,49.38394313898318,Transportation
204474,67707,136767,33.112767393409435,66.88723260659057,Entertainment
98138,22386,75752,22.810735902504636,77.18926409749537,Transportation
54742,26960,27782,49.249205363340764,50.750794636659236,Food
161257,20859,140398,12.935252423150622,87.06474757684937,Healthcare
17304,4515,12789,26.09223300970874,73.90776699029125,Housing
174101,63697,110404,36.58623442714287,63.41376557285714,Healthcare
169705,2227,167478,1.3122771868831207,98.68772281311688,Healthcare
101538,12029,89509,11.846796273316395,88.1532037266836,Transportation
84746,15626,69120,18.438628371840558,81.56137162815943,Transportation
15034,1257,13777,8.36104829054144,91.63895170945857,Housing
109815,15526,94289,14.138323544142423,85.86167645585758,Transportation
185326,61735,123591,33.31156988226153,66.68843011773848,Entertainment
118178,51902,66276,43.91849582832676,56.08150417167324,Transportation
136801,55015,81786,40.21534930300217,59.78465069699783,Healthcare
193405,12467,180938,6.446058788552519,93.55394121144748,Entertainment
37567,10066,27501,26.79479330263263,73.20520669736737,Food
231578,1768,229810,0.7634576686904628,99.23654233130954,Entertainment
44500,16360,28140,36.764044943820224,63.23595505617977,Food
169465,50842,118623,30.00147523087363,69.99852476912636,Healthcare
10435,492,9943,4.714901772879731,95.28509822712027,Housing
226614,1611,225003,0.7109004739336493,99.28909952606635,Entertainment
103765,61402,42363,59.17409531152123,40.82590468847877,Transportation
53550,15219,38331,28.420168067226893,71.5798319327731,Food
151949,47225,104724,31.079506939828494,68.92049306017151,Healthcare
223964,35288,188676,15.756103659516707,84.24389634048329,Entertainment
210844,12575,198269,5.964125135171027,94.03587486482897,Entertainment
231734,1953,229781,0.8427766318278715,99.15722336817213,Entertainment
123453,53904,69549,43.66358047192049,56.3364195280795,Healthcare
245818,58825,186993,23.930306161469055,76.06969383853095,Entertainment
121984,37730,84254,30.93028593913956,69.06971406086045,Healthcare
24207,7404,16803,30.586194076093694,69.41380592390631,Housing
177708,14862,162846,8.363157539334189,91.63684246066582,Healthcare
109355,40579,68776,37.1075853870422,62.8924146129578,Transportation
22917,6621,16296,28.89121612776541,71.10878387223458,Housing
236448,39510,196938,16.709805115712545,83.29019488428744,Entertainment
144812,50246,94566,34.69740076789216,65.30259923210784,Healthcare
164591,46021,118570,27.960824103383537,72.03917589661646,Healthcare
71026,39626,31400,55.79083715822375,44.20916284177625,Transportation
60023,17825,42198,29.696949502690632,70.30305049730936,Transportation
24019,6917,17102,28.79803488904617,71.20196511095382,Housing
236062,58078,177984,24.602858571053368,75.39714142894664,Entertainment
217410,12577,204833,5.784922496665287,94.21507750333471,Entertainment
227056,24609,202447,10.838295398492003,89.16170460150799,Entertainment
245793,12719,233074,5.174679506739411,94.82532049326059,Entertainment
111683,28653,83030,25.65565036755818,74.34434963244182,Transportation
75702,33562,42140,44.3343636892024,55.66563631079761,Transportation
16484,39,16445,0.23659305993690852,99.76340694006309,Housing
72218,34197,38021,47.35246060538924,52.64753939461077,Transportation
11328,5785,5543,51.068149717514125,48.931850282485875,Housing
49438,9473,39965,19.1613738419839,80.8386261580161,Food
132323,64420,67903,48.68390226944673,51.31609773055327,Healthcare
160351,38058,122293,23.73418313574596,76.26581686425405,Healthcare
56902,1561,55341,2.7433130645671504,97.25668693543284,Food
120447,6732,113715,5.589180303369947,94.41081969663006,Healthcare
127706,11844,115862,9.274427199974943,90.72557280002506,Healthcare
197708,7073,190635,3.57749812855322,96.42250187144677,Entertainment
21365,10532,10833,49.295576878071614,50.704423121928386,Housing
213558,45362,168196,21.241068000262224,78.75893199973778,Entertainment
47450,8897,38553,18.75026343519494,81.24973656480505,Food
208589,28555,180034,13.689600122729386,86.31039987727061,Entertainment
228654,31346,197308,13.708922651692076,86.29107734830792,Entertainment
164006,35262,128744,21.50043291099106,78.49956708900893,Healthcare
52800,31428,21372,59.52272727272727,40.47727272727273,Food
37807,786,37021,2.078980083053403,97.92101991694659,Food
25771,2936,22835,11.392650653835707,88.60734934616428,Housing
235114,28214,206900,12.000136104187757,87.99986389581224,Entertainment
24020,8099,15921,33.71773522064946,66.28226477935054,Housing
41717,22528,19189,54.00196562552436,45.99803437447563,Food
198471,23353,175118,11.766454544996497,88.23354545500351,Entertainment
23064,1805,21259,7.826049254249046,92.17395074575096,Housing
19368,5237,14131,27.039446509706732,72.96055349029326,Housing
143808,16448,127360,11.437472185135737,88.56252781486427,Healthcare
45238,3412,41826,7.542331668066669,92.45766833193333,Food
106127,17597,88530,16.581077388411998,83.418922611588,Transportation
21019,7234,13785,34.416480327322894,65.5835196726771,Housing
45730,10946,34784,23.936146949486115,76.06385305051388,Food
246428,69353,177075,28.143311636664663,71.85668836333534,Entertainment
28846,2037,26809,7.061637662067531,92.93836233793246,Housing
56051,21917,34134,39.10188935076984,60.89811064923016,Food
51030,5552,45478,10.879874583578287,89.12012541642171,Food
225994,20358,205636,9.008203757621883,90.99179624237811,Entertainment
65598,2289,63309,3.489435653526022,96.51056434647398,Transportation
154060,17706,136354,11.492924834480073,88.50707516551994,Healthcare
113743,44357,69386,38.99756468529931,61.00243531470069,Transportation
187298,23341,163957,12.461959017181176,87.53804098281883,Entertainment
214915,59135,155780,27.51552939534234,72.48447060465766,Entertainment
18508,2940,15568,15.88502269288956,84.11497730711044,Housing
119830,19614,100216,16.368188266711176,83.63181173328883,Transportation
248685,1019,247666,0.40975531294609646,99.59024468705391,Entertainment
59391,33949,25442,57.1618595410079,42.8381404589921,Food
247959,60008,187951,24.200775128146184,75.79922487185381,Entertainment
205914,4232,201682,2.0552269394018863,97.94477306059811,Entertainment
209531,4545,204986,2.16913010485322,97.83086989514678,Entertainment
85400,27248,58152,31.906323185011708,68.09367681498829,Transportation
64324,30286,34038,47.08351470679684,52.916485293203166,Transportation
20395,183,20212,0.8972787447903897,99.10272125520962,Housing
187568,33575,153993,17.900174869913847,82.09982513008616,Entertainment
205730,67879,137851,32.99421571963253,67.00578428036748,Entertainment
157371,60899,96472,38.69772702721595,61.30227297278405,Healthcare
151458,67398,84060,44.49946519827279,55.500534801727206,Healthcare
143446,35570,107876,24.796787641342384,75.20321235865761,Healthcare
62284,30128,32156,48.37197354055616,51.628026459443845,Transportation
20714,6143,14571,29.656271120980982,70.34372887901903,Housing
247059,8521,238538,3.4489737269235285,96.55102627307647,Entertainment
171557,46740,124817,27.244589261877977,72.75541073812202,Healthcare
123439,38734,84705,31.379061722794255,68.62093827720574,Healthcare
216116,47585,168531,22.0182679672028,77.9817320327972,Entertainment
137277,28592,108685,20.827960983995865,79.17203901600413,Healthcare
69163,16433,52730,23.75981377326027,76.24018622673972,Transportation
24786,3131,21655,12.632131041717098,87.3678689582829,Housing
18521,6019,12502,32.49824523513849,67.50175476486152,Housing
92352,42831,49521,46.377988565488565,53.62201143451143,Transportation
158000,18185,139815,11.509493670886076,88.49050632911393,Healthcare
150932,46434,104498,30.764847746004826,69.23515225399518,Healthcare
131238,69240,61998,52.759109404288395,47.24089059571161,Healthcare
34292,10297,23995,30.027411641199116,69.97258835880089,Food
140306,31121,109185,22.180804812338746,77.81919518766125,Healthcare
173067,6390,166677,3.6922116868033767,96.30778831319662,Healthcare
165579,21870,143709,13.208196691609444,86.79180330839056,Healthcare
243817,48076,195741,19.718067238953804,80.28193276104619,Entertainment
123906,68397,55509,55.200716672316105,44.799283327683895,Healthcare
248725,35738,212987,14.36847924414514,85.63152075585487,Entertainment
199645,20990,178655,10.51366174960555,89.48633825039445,Entertainment
27852,109,27743,0.3913543013069079,99.60864569869308,Housing
53681,10185,43496,18.97319349490509,81.02680650509491,Food
33339,10082,23257,30.24085905396083,69.75914094603918,Food
107189,53920,53269,50.30366921978935,49.69633078021066,Transportation
21561,4855,16706,22.517508464356943,77.48249153564306,Housing
137247,68857,68390,50.170131223268996,49.829868776731004,Healthcare
69123,11577,57546,16.74840501714335,83.25159498285664,Transportation
98980,13532,85448,13.671448777530815,86.32855122246919,Transportation
14837,2915,11922,19.646828873761542,80.35317112623845,Housing
142457,204,142253,0.14320110629874278,99.85679889370125,Healthcare
22526,13056,9470,57.959691023705936,42.040308976294064,Housing
14390,1598,12792,11.104933981931897,88.8950660180681,Housing
30454,3407,27047,11.187364549812832,88.81263545018717,Food
20196,1752,18444,8.674985145573382,91.32501485442663,Housing
211786,16247,195539,7.671423040238731,92.32857695976126,Entertainment
21291,5772,15519,27.1100464985205,72.8899535014795,Housing
17832,2228,15604,12.494392104082548,87.50560789591745,Housing
222140,62789,159351,28.265508238048078,71.73449176195193,Entertainment
17942,719,17223,4.007357039349014,95.99264296065098,Housing
26475,9050,17425,34.183191690273844,65.81680830972616,Housing
51612,7599,44013,14.723320158102768,85.27667984189723,Food
33190,19647,13543,59.19554082554986,40.80445917445014,Food
179688,7605,172083,4.232336049151863,95.76766395084813,Healthcare
188673,59469,129204,31.519613299200206,68.4803867007998,Entertainment
133514,53650,79864,40.18305196458798,59.81694803541202,Healthcare
52078,15808,36270,30.354468297553673,69.64553170244633,Food
45604,6504,39100,14.26190685027629,85.73809314972371,Food
173442,67284,106158,38.79337184764936,61.20662815235064,Healthcare
133707,25729,107978,19.242821991369187,80.75717800863082,Healthcare
18473,3939,14534,21.323011963406053,78.67698803659395,Housing
157268,21216,136052,13.490347686751278,86.50965231324872,Healthcare
150112,21512,128600,14.330633127264974,85.66936687273503,Healthcare
228613,12596,216017,5.509747914598032,94.49025208540198,Entertainment
144945,15143,129802,10.44741108696402,89.55258891303598,Healthcare
216115,32435,183680,15.008213219813527,84.99178678018647,Entertainment
103266,20047,83219,19.412972323901382,80.58702767609861,Transportation
65045,38510,26535,59.20516565454685,40.79483434545315,Transportation
29268,3708,25560,12.669126691266912,87.33087330873309,Housing
19316,1048,18268,5.425553944916132,94.57444605508387,Housing
56291,5626,50665,9.99449290295074,90.00550709704926,Food
52556,27666,24890,52.640992465180005,47.35900753482,Food
152866,28575,124291,18.692842096999986,81.30715790300002,Healthcare
249431,1805,247626,0.7236470206189287,99.27635297938107,Entertainment
144854,33360,111494,23.030085465365126,76.96991453463488,Healthcare
201532,65956,135576,32.72730881448108,67.27269118551892,Entertainment
89179,36758,52421,41.218224021350316,58.781775978649684,Transportation
104505,30676,73829,29.35361944404574,70.64638055595425,Transportation
52728,7030,45698,13.332574723107268,86.66742527689273,Food
232540,48350,184190,20.79212178549927,79.20787821450072,Entertainment
45361,10131,35230,22.334163708912943,77.66583629108706,Food
39297,20732,18565,52.75720792935847,47.24279207064153,Food
233299,13438,219861,5.75999039858722,94.24000960141278,Entertainment
218509,53228,165281,24.359637360474853,75.64036263952515,Entertainment
59467,6405,53062,10.770679536549684,89.2293204634503,Food
84468,33124,51344,39.214850594307904,60.785149405692096,Transportation
27543,4195,23348,15.230730131067785,84.76926986893221,Housing
202791,12019,190772,5.926791622902397,94.0732083770976,Entertainment
18187,10742,7445,59.064166712486944,40.935833287513056,Housing
32856,7763,25093,23.627343559775994,76.372656440224,Food
61476,20116,41360,32.7217125382263,67.2782874617737,Transportation
21657,2171,19486,10.024472456942329,89.97552754305768,Housing
195991,23930,172061,12.209744324994515,87.79025567500548,Entertainment
140223,16481,123742,11.753421336014776,88.24657866398522,Healthcare
25275,1857,23418,7.347181008902077,92.65281899109792,Housing
132077,23306,108771,17.645767241836204,82.3542327581638,Healthcare
43036,25167,17869,58.47894785760759,41.52105214239242,Food
167245,30047,137198,17.965858471105264,82.03414152889474,Healthcare
48993,15766,33227,32.180107362276246,67.81989263772375,Food
24732,13898,10834,56.1944040109979,43.80559598900211,Housing
58426,31191,27235,53.38547906753842,46.61452093246157,Food
98416,7796,90620,7.921476182734515,92.07852381726549,Transportation
11331,5617,5714,49.57197069984997,50.42802930015004,Housing
66440,34058,32382,51.261288380493674,48.73871161950632,Transportation
154980,21304,133676,13.74628984385082,86.25371015614918,Healthcare
88524,34795,53729,39.30572500112964,60.69427499887037,Transportation
11670,6173,5497,52.89631533847472,47.10368466152528,Housing
221480,56339,165141,25.43751128770092,74.56248871229909,Entertainment
11605,962,10643,8.289530374838431,91.71046962516158,Housing
130658,44265,86393,33.878522555067434,66.12147744493258,Healthcare
42266,4690,37576,11.096389532957932,88.90361046704207,Food
32350,5699,26651,17.616692426584237,82.38330757341576,Food
205168,44364,160804,21.623255088512828,78.37674491148718,Entertainment
17427,1128,16299,6.47271475296953,93.52728524703046,Housing
123080,21174,101906,17.203444913877153,82.79655508612285,Healthcare
28763,1470,27293,5.110732538330494,94.8892674616695,Housing
167791,55254,112537,32.93025251652353,67.06974748347648,Healthcare
165373,52458,112915,31.721018545953694,68.2789814540463,Healthcare
51166,28074,23092,54.86846734159403,45.13153265840597,Food
67820,30684,37136,45.24329106458272,54.75670893541729,Transportation
25783,4193,21590,16.26265368653764,83.73734631346235,Housing
139809,55914,83895,39.993133489260345,60.006866510739655,Healthcare
36911,85,36826,0.23028365527891417,99.76971634472108,Food
123002,44057,78945,35.818116778588966,64.18188322141103,Healthcare
29519,8186,21333,27.731291710423793,72.2687082895762,Housing
69630,39372,30258,56.54459284791038,43.45540715208961,Transportation
40129,6190,33939,15.42525355727778,84.57474644272223,Food
21822,1218,20604,5.581523233434149,94.41847676656585,Housing
189899,45768,144131,24.101232760572724,75.89876723942727,Entertainment
40615,8635,31980,21.260617998276498,78.7393820017235,Food
49880,27733,22147,55.59943865276664,44.40056134723336,Food
13011,1529,11482,11.75159480439628,88.24840519560372,Housing
25303,12204,13099,48.231435007706594,51.768564992293406,Housing
132051,65443,66608,49.55888255295303,50.44111744704698,Healthcare
93443,29042,64401,31.079909677557442,68.92009032244256,Transportation
125518,49040,76478,39.07009353240173,60.92990646759827,Healthcare
73265,25540,47725,34.85975568143043,65.14024431856957,Transportation
131778,29393,102385,22.30493709116848,77.69506290883153,Healthcare
10359,1830,8529,17.665797856935995,82.334202143064,Housing
21586,12074,9512,55.934401927175024,44.06559807282498,Housing
19610,6628,12982,33.79908210096889,66.20091789903111,Housing
16451,8268,8183,50.2583429578749,49.7416570421251,Housing
28430,10960,17470,38.550826591628564,61.449173408371436,Housing
16641,3486,13155,20.948260320894178,79.05173967910582,Housing
35295,20869,14426,59.127355149454594,40.872644850545406,Food
201632,41212,160420,20.43921599746072,79.56078400253928,Entertainment
58412,16899,41513,28.930699171403134,71.06930082859687,Food
46750,16850,29900,36.0427807486631,63.957219251336895,Food
104324,56561,47763,54.216671139910275,45.783328860089725,Transportation
16163,1258,14905,7.783208562766814,92.2167914372332,Housing
34322,14081,20241,41.02616397645825,58.97383602354175,Food
139344,31727,107617,22.768831094270293,77.2311689057297,Healthcare
39522,331,39191,0.8375082232680532,99.16249177673194,Food
17319,8208,9111,47.39303654945435,52.60696345054564,Housing
15328,1145,14183,7.4699895615866385,92.53001043841336,Housing
146933,56296,90637,38.31406151102883,61.68593848897116,Healthcare
241693,52505,189188,21.72383974711721,78.27616025288279,Entertainment
232010,57962,174048,24.98254385586828,75.01745614413173,Entertainment
24737,5306,19431,21.44965032138093,78.55034967861907,Housing
57944,1456,56488,2.5127709512632888,97.48722904873671,Food
19285,6276,13009,32.54342753435313,67.45657246564689,Housing
15731,5461,10270,34.71489415803191,65.28510584196809,Housing
165153,40527,124626,24.539063777224754,75.46093622277525,Healthcare
46584,3462,43122,7.431736218444102,92.5682637815559,Food
13380,3427,9953,25.61285500747384,74.38714499252616,Housing
165296,3221,162075,1.94862549607976,98.05137450392024,Healthcare
174866,49869,124997,28.518408381274806,71.48159161872519,Healthcare
21689,5315,16374,24.505509705380607,75.49449029461938,Housing
126303,62054,64249,49.13105785294095,50.86894214705906,Healthcare
27730,15377,12353,55.45257843490804,44.54742156509196,Housing
228393,52012,176381,22.773027194353592,77.22697280564641,Entertainment
136934,55829,81105,40.770736267106784,59.22926373289322,Healthcare
44923,7278,37645,16.20105513879305,83.79894486120696,Food
225714,50734,174980,22.47711705964185,77.52288294035814,Entertainment
49034,24811,24223,50.59958396214871,49.400416037851286,Food
199746,23932,175814,11.981216144503518,88.01878385549648,Entertainment
42766,10568,32198,24.711219192816724,75.28878080718327,Food
16173,6182,9991,38.22420082854139,61.7757991714586,Housing
14822,6931,7891,46.76157063824045,53.23842936175954,Housing
54371,14146,40225,26.017546118335144,73.98245388166485,Food
212847,16666,196181,7.830037538701509,92.1699624612985,Entertainment
48295,394,47901,0.8158194430065223,99.18418055699347,Food
91627,21009,70618,22.928831021423814,77.07116897857618,Transportation
167733,33918,133815,20.22142333351219,79.77857666648781,Healthcare
195839,19165,176674,9.786099806473684,90.21390019352631,Entertainment
223280,45945,177335,20.577302042278752,79.42269795772124,Entertainment
242950,22033,220917,9.068944227207245,90.93105577279276,Entertainment
66864,18596,48268,27.811677434793015,72.18832256520699,Transportation
57664,11224,46440,19.464483906770255,80.53551609322975,Food
10636,5347,5289,50.272658894321175,49.727341105678825,Housing
217387,56275,161112,25.887012562848742,74.11298743715126,Entertainment
233892,48087,185805,20.559488994920734,79.44051100507927,Entertainment
21239,1132,20107,5.329817788031452,94.67018221196855,Housing
161181,54420,106761,33.763284754406534,66.23671524559346,Healthcare
240411,1024,239387,0.4259372491275357,99.57406275087246,Entertainment
234174,57755,176419,24.66328456617729,75.3367154338227,Entertainment
182163,37081,145082,20.355944950401565,79.64405504959844,Entertainment
14132,5959,8173,42.16671384092839,57.833286159071605,Housing
20750,6904,13846,33.272289156626506,66.72771084337349,Housing
50145,7698,42447,15.351480705952735,84.64851929404726,Food
20168,9944,10224,49.30583101943673,50.69416898056327,Housing
149666,7123,142543,4.7592639610866865,95.24073603891331,Healthcare
30637,8100,22537,26.438619969318143,73.56138003068186,Food
97167,1625,95542,1.6723784824065784,98.32762151759343,Transportation
104175,38031,66144,36.50683945284377,63.49316054715622,Transportation
142308,18040,124268,12.67672934761222,87.32327065238778,Healthcare
17965,5059,12906,28.16031171722794,71.83968828277204,Housing
163971,1389,162582,0.8471010117642754,99.15289898823573,Healthcare
56458,30023,26435,53.17758333628538,46.82241666371462,Food
26920,9288,17632,34.50222882615156,65.49777117384843,Housing
37014,18930,18084,51.14281082833523,48.85718917166478,Food
50067,20278,29789,40.501727684902235,59.498272315097765,Food
63837,14024,49813,21.968450898381818,78.03154910161818,Transportation
212074,67910,144164,32.02184143270745,67.97815856729255,Entertainment
166671,29651,137020,17.790137456426134,82.20986254357386,Healthcare
114492,7187,107305,6.277294483457359,93.72270551654263,Transportation
19419,9733,9686,50.12101550028323,49.87898449971677,Housing
39315,18703,20612,47.57217347068549,52.427826529314515,Food
206915,43979,162936,21.254621462919555,78.74537853708044,Entertainment
148201,24164,124037,16.30488323290666,83.69511676709334,Healthcare
188036,69852,118184,37.14820566274543,62.85179433725456,Entertainment
18226,1684,16542,9.239547898606386,90.76045210139362,Housing
53119,8044,45075,15.143357367420322,84.85664263257968,Food
27364,15380,11984,56.20523315304779,43.7947668469522,Housing
38098,5965,32133,15.656989868234552,84.34301013176545,Food
12470,23,12447,0.18444266238973536,99.81555733761026,Housing
169642,26634,143008,15.700121432192498,84.2998785678075,Healthcare
92877,38951,53926,41.93826243311046,58.06173756688954,Transportation
25445,8640,16805,33.95559048929063,66.04440951070939,Housing
75805,23306,52499,30.744673834179803,69.2553261658202,Transportation
177211,24801,152410,13.995180886062379,86.00481911393763,Healthcare
119078,43924,75154,36.88674650229262,63.11325349770739,Transportation
14113,8274,5839,58.62679798767094,41.37320201232906,Housing
37157,15296,21861,41.165863767257854,58.83413623274215,Food
54688,20693,33995,37.83828262141603,62.16171737858397,Food
73779,13427,60352,18.19894549939685,81.80105450060316,Transportation
50552,24524,26028,48.51242285171705,51.48757714828296,Food
56304,10738,45566,19.071469167377096,80.9285308326229,Food
25390,4333,21057,17.06577392674281,82.9342260732572,Housing
185154,22701,162453,12.260604685829094,87.7393953141709,Entertainment
27094,2478,24616,9.145936369675942,90.85406363032405,Housing
33606,5758,27848,17.133845146699993,82.86615485330002,Food
55982,31235,24747,55.79471973134221,44.20528026865778,Food
26646,14601,12045,54.79621706822788,45.203782931772125,Housing
141832,48708,93124,34.3420384680467,65.6579615319533,Healthcare
235693,57526,178167,24.407173738719436,75.59282626128056,Entertainment
43776,11831,31945,27.02622441520468,72.97377558479532,Food
164859,38029,126830,23.06759109299462,76.93240890700538,Healthcare
232225,50535,181690,21.761222951878565,78.23877704812143,Entertainment
218791,64125,154666,29.30879240919416,70.69120759080583,Entertainment
41986,9732,32254,23.179154956414042,76.82084504358596,Food
90214,18209,72005,20.1842286119671,79.8157713880329,Transportation
73202,28305,44897,38.66697631212262,61.33302368787737,Transportation
104144,43680,60464,41.94192656322016,58.05807343677984,Transportation
187209,39295,147914,20.989909673146055,79.01009032685394,Entertainment
29271,2209,27062,7.5467185951966105,92.45328140480339,Housing
107668,10362,97306,9.624029423784226,90.37597057621576,Transportation
120352,57581,62771,47.843824780643445,52.15617521935655,Healthcare
53358,1148,52210,2.1515049289703514,97.84849507102965,Food
175252,13316,161936,7.5982014470590915,92.4017985529409,Healthcare
93006,19158,73848,20.598671053480423,79.40132894651958,Transportation
193547,65873,127674,34.03462724816195,65.96537275183806,Entertainment
51237,3317,47920,6.473837266038214,93.52616273396178,Food
195359,55282,140077,28.297646896226947,71.70235310377305,Entertainment
14739,529,14210,3.589117307822783,96.41088269217721,Housing
131964,36114,95850,27.36655451486769,72.63344548513231,Healthcare
26144,1699,24445,6.498623011015912,93.50137698898409,Housing
193742,27652,166090,14.272589319817076,85.72741068018293,Entertainment
170185,36778,133407,21.610600229162383,78.38939977083761,Healthcare
23438,4309,19129,18.38467446027818,81.61532553972182,Housing
119425,15793,103632,13.224199288256228,86.77580071174377,Transportation
49653,9030,40623,18.18621231345538,81.81378768654461,Food
23549,9268,14281,39.356235933585296,60.643764066414704,Housing
19996,10460,9536,52.31046209241848,47.68953790758152,Housing
91776,9927,81849,10.816553347280335,89.18344665271967,Transportation
71991,18150,53841,25.21148476892945,74.78851523107055,Transportation
29651,4731,24920,15.95561701123065,84.04438298876936,Housing
103738,4192,99546,4.040949314619522,95.95905068538048,Transportation
210115,28059,182056,13.354115603360064,86.64588439663994,Entertainment
46877,19117,27760,40.78119333575101,59.21880666424899,Food
12655,1609,11046,12.7143421572501,87.2856578427499,Housing
68763,30507,38256,44.36542908250076,55.63457091749924,Transportation
21058,4885,16173,23.197834552189192,76.80216544781081,Housing
51334,6310,45024,12.292048155218763,87.70795184478123,Food
55046,21538,33508,39.12727536969081,60.87272463030919,Food
51107,23782,27325,46.53374293149666,53.46625706850333,Food
208120,43278,164842,20.794733807418798,79.2052661925812,Entertainment
47571,11482,36089,24.13655378276681,75.86344621723319,Food
243725,3031,240694,1.2436147297158684,98.75638527028413,Entertainment
114534,39189,75345,34.21604065168422,65.78395934831578,Transportation
47377,21830,25547,46.07721046077211,53.9227895392279,Food
29318,11055,18263,37.70721058735248,62.29278941264752,Housing
189481,903,188578,0.4765649326317678,99.52343506736823,Entertainment
96678,12179,84499,12.59748857030555,87.40251142969446,Transportation
49774,29181,20593,58.62699401293848,41.37300598706152,Food
39774,22330,17444,56.142203449489614,43.857796550510386,Food
106414,56625,49789,53.21198338564474,46.78801661435526,Transportation
40807,157,40650,0.3847379126130321,99.61526208738697,Food
15334,1679,13655,10.949523933742011,89.05047606625799,Housing
121893,11,121882,0.009024308204736941,99.99097569179526,Healthcare
15970,1817,14153,11.377582968065122,88.62241703193487,Housing
31585,11970,19615,37.89773626721545,62.10226373278454,Food
30159,10906,19253,36.1616764481581,63.8383235518419,Food
38830,1124,37706,2.894669070306464,97.10533092969354,Food
152377,6948,145429,4.559743268341022,95.44025673165898,Healthcare
61507,27428,34079,44.593298323768025,55.406701676231975,Transportation
28009,15940,12069,56.91027883894463,43.08972116105538,Housing
42686,23102,19584,54.120789017476454,45.879210982523546,Food
122586,14567,108019,11.883086159920381,88.11691384007962,Healthcare
13538,1598,11940,11.803811493573644,88.19618850642635,Housing
193780,16255,177525,8.38837857364021,91.61162142635979,Entertainment
41368,8504,32864,20.55695223361052,79.44304776638948,Food
49967,18601,31366,37.22656953589369,62.773430464106305,Food
28786,10140,18646,35.22545681928715,64.77454318071285,Housing
96403,40483,55920,41.99350642614856,58.00649357385144,Transportation
114331,47403,66928,41.46119600108457,58.538803998915434,Transportation
67032,5654,61378,8.434777419739826,91.56522258026017,Transportation
51477,20026,31451,38.9028109641199,61.097189035880106,Food
194174,44075,150099,22.698713524982747,77.30128647501725,Entertainment
109556,8574,100982,7.826134579575742,92.17386542042426,Transportation
48019,14290,33729,29.759053707907285,70.24094629209272,Food
67372,3833,63539,5.6893071305586895,94.31069286944131,Transportation
105799,8344,97455,7.8866529929394416,92.11334700706055,Transportation
19493,3174,16319,16.282768173190377,83.71723182680962,Housing
155375,52435,102940,33.74738535800483,66.25261464199518,Healthcare
25815,15315,10500,59.32597327135386,40.67402672864613,Housing
188304,34330,153974,18.231158127283543,81.76884187271646,Entertainment
103221,47678,55543,46.190213231803604,53.809786768196396,Transportation
203179,12177,191002,5.993237490094941,94.00676250990506,Entertainment
170868,62275,108593,36.44626261207482,63.55373738792518,Healthcare
19202,861,18341,4.4839079262576815,95.51609207374231,Housing
29027,3647,25380,12.564164398663314,87.43583560133669,Housing
11902,172,11730,1.4451352713829608,98.55486472861705,Housing
12495,4382,8113,35.07002801120448,64.92997198879551,Housing
96407,25647,70760,26.602840042735487,73.3971599572645,Transportation
26566,3337,23229,12.561168410750584,87.43883158924942,Housing
173439,38948,134491,22.456310287766883,77.54368971223312,Healthcare
111928,66499,45429,59.412300764777356,40.587699235222644,Transportation
158109,26241,131868,16.596778172020567,83.40322182797944,Healthcare
199957,56341,143616,28.17655795996139,71.82344204003861,Entertainment
210408,5827,204581,2.769381392342497,97.2306186076575,Entertainment
43288,18727,24561,43.261411938643505,56.738588061356495,Food
177621,14921,162700,8.400470665067756,91.59952933493224,Healthcare
13083,800,12283,6.1148054727508985,93.8851945272491,Housing
58754,1842,56912,3.1351056949314087,96.86489430506859,Food
21585,7097,14488,32.87931433866111,67.1206856613389,Housing
176647,15457,161190,8.750219364042412,91.24978063595759,Healthcare
222408,61252,161156,27.5403762454588,72.4596237545412,Entertainment
23808,8835,14973,37.109375,62.890625,Housing
37644,20866,16778,55.42981617256402,44.570183827435976,Food
121739,25765,95974,21.16412981871052,78.83587018128948,Healthcare
17811,5576,12235,31.30649598562686,68.69350401437315,Housing
40908,17006,23902,41.571330791043316,58.428669208956684,Food
18504,11071,7433,59.830306960657154,40.169693039342846,Housing
159113,35498,123615,22.309930678197258,77.69006932180275,Healthcare
18189,5127,13062,28.187365990433776,71.81263400956622,Housing
56684,2624,54060,4.629172253193141,95.37082774680687,Food
110401,34616,75785,31.35478845300314,68.64521154699685,Transportation
161883,20069,141814,12.397225156440145,87.60277484355984,Healthcare
76522,36392,40130,47.55756514466428,52.44243485533572,Transportation
164099,33156,130943,20.204876324657675,79.79512367534232,Healthcare
11337,6436,4901,56.76986857193261,43.230131428067395,Housing
209870,24611,185259,11.726783246771811,88.27321675322818,Entertainment
127618,69087,58531,54.13578021909136,45.86421978090865,Healthcare
24907,6322,18585,25.38242261211708,74.61757738788293,Housing
65066,24831,40235,38.162788553161406,61.837211446838594,Transportation
184145,60914,123231,33.07936680333433,66.92063319666566,Entertainment
134867,14783,120084,10.961169151831063,89.03883084816894,Healthcare
204939,43820,161119,21.381972196604842,78.61802780339515,Entertainment
83338,36707,46631,44.045933427728045,55.954066572271955,Transportation
35283,258,35025,0.7312303375563303,99.26876966244367,Food
234938,5435,229503,2.3133762950225165,97.68662370497748,Entertainment
217830,49591,168239,22.76591837671579,77.23408162328421,Entertainment
176863,2297,174566,1.2987453565754286,98.70125464342458,Healthcare
100991,22540,78451,22.31882048895446,77.68117951104554,Transportation
15722,7568,8154,48.136369418649025,51.863630581350975,Housing
171201,6042,165159,3.529184993078312,96.47081500692168,Healthcare
42561,20842,21719,48.969714057470455,51.03028594252954,Food
213818,35781,178037,16.734325454358377,83.26567454564162,Entertainment
14676,3900,10776,26.573998364677028,73.42600163532298,Housing
48959,8111,40848,16.56692334402255,83.43307665597744,Food
46643,3180,43463,6.8177432840940755,93.18225671590592,Food
76781,41794,34987,54.432737265729806,45.567262734270194,Transportation
57688,16787,40901,29.099639439744834,70.90036056025517,Food
195992,52658,143334,26.867423160128983,73.132576839871,Entertainment
240622,57853,182769,24.043104952996817,75.95689504700319,Entertainment
173681,7174,166507,4.130561201282812,95.86943879871718,Healthcare
95357,3792,91565,3.97663517098902,96.02336482901099,Transportation
14605,2962,11643,20.28072577884286,79.71927422115714,Housing
55636,8447,47189,15.182615572650802,84.8173844273492,Food
21933,9926,12007,45.256006930196506,54.74399306980349,Housing
216827,46420,170407,21.408772892674804,78.5912271073252,Entertainment
50155,1444,48711,2.8790748679094804,97.12092513209052,Food
205674,56780,148894,27.606795219619396,72.3932047803806,Entertainment
39092,4924,34168,12.595927555510078,87.40407244448993,Food
62083,27787,34296,44.75782420308297,55.242175796917024,Transportation
29963,5880,24083,19.624203183926845,80.37579681607315,Housing
58442,33926,24516,58.0507169501386,41.9492830498614,Food
212016,50459,161557,23.79961889668704,76.20038110331295,Entertainment
198767,68486,130281,34.45541764981109,65.54458235018892,Entertainment
126901,52140,74761,41.08714667339107,58.912853326608925,Healthcare
16825,4891,11934,29.069836552748885,70.93016344725112,Housing
231499,7993,223506,3.4527146985516137,96.54728530144838,Entertainment
133159,26363,106796,19.798136062902245,80.20186393709776,Healthcare
173678,49458,124220,28.47683644445468,71.52316355554532,Healthcare
198418,52969,145449,26.695662691892874,73.30433730810712,Entertainment
165470,14099,151371,8.520577748232308,91.4794222517677,Healthcare
95227,5871,89356,6.165268253751562,93.83473174624844,Transportation
54424,29248,25176,53.74099661913861,46.25900338086139,Food
18102,5009,13093,27.670975582808527,72.32902441719146,Housing
128183,47618,80565,37.14845182278461,62.85154817721539,Healthcare
57642,19452,38190,33.74622670969085,66.25377329030914,Food
163798,1066,162732,0.6508015970890975,99.3491984029109,Healthcare
39663,5093,34570,12.840682752187178,87.15931724781282,Food
178844,33148,145696,18.53458880365011,81.46541119634989,Healthcare
81887,17640,64247,21.541880884633702,78.4581191153663,Transportation
25845,11832,14013,45.78061520603598,54.21938479396402,Housing
232482,61865,170617,26.610662330847116,73.38933766915288,Entertainment
29357,4628,24729,15.764553598800967,84.23544640119903,Housing
95748,57174,38574,59.71299661611731,40.28700338388269,Transportation
33876,7445,26431,21.977211004841184,78.0227889951588,Food
51357,26796,24561,52.175944856592096,47.82405514340791,Food
73366,10311,63055,14.054194040836354,85.94580595916365,Transportation
44650,19733,24917,44.194848824188135,55.80515117581187,Food
164772,48722,116050,29.56934430607142,70.43065569392859,Healthcare
13730,6559,7171,47.771303714493804,52.228696285506196,Housing
19005,6565,12440,34.543541173375424,65.45645882662457,Housing
213558,22224,191334,10.406540611918073,89.59345938808192,Entertainment
60310,31343,28967,51.96982258331951,48.03017741668049,Transportation
179692,50048,129644,27.85210248647686,72.14789751352313,Healthcare
85485,50017,35468,58.50968006082938,41.49031993917062,Transportation
13035,2052,10983,15.74223245109321,84.2577675489068,Housing
186601,22959,163642,12.303792584176934,87.69620741582307,Entertainment
124411,8963,115448,7.2043468825103885,92.7956531174896,Healthcare
100374,21344,79030,21.264470878912867,78.73552912108714,Transportation
243256,2373,240883,0.9755155062978919,99.0244844937021,Entertainment
68794,39001,29793,56.69244410849783,43.30755589150216,Transportation
231608,42458,189150,18.33183655141446,81.66816344858555,Entertainment
209948,56966,152982,27.1333854097205,72.8666145902795,Entertainment
191185,62818,128367,32.85718021811335,67.14281978188666,Entertainment
202998,23930,179068,11.788293480723947,88.21170651927605,Entertainment
47038,15155,31883,32.21863174454696,67.78136825545303,Food
187972,33414,154558,17.776051752388653,82.22394824761135,Entertainment
134891,18116,116775,13.430102823761409,86.5698971762386,Healthcare
112836,57508,55328,50.96600375766599,49.033996242334005,Transportation
154870,19986,134884,12.90501711112546,87.09498288887454,Healthcare
43919,22735,21184,51.765750586306616,48.23424941369339,Food
99544,56413,43131,56.6714216828739,43.328578317126095,Transportation
14656,3590,11066,24.49508733624454,75.50491266375546,Housing
203887,19500,184387,9.56412130248618,90.43587869751381,Entertainment
246804,7742,239062,3.1369021571773557,96.86309784282264,Entertainment
26335,461,25874,1.7505221188532372,98.24947788114676,Housing
208957,36896,172061,17.65722134219002,82.34277865780997,Entertainment
24145,4894,19251,20.269206875129424,79.73079312487057,Housing
226127,62487,163640,27.633586435940867,72.36641356405914,Entertainment
160791,19460,141331,12.102667437854109,87.89733256214589,Healthcare
35925,13000,22925,36.18649965205289,63.81350034794712,Food
16871,6386,10485,37.851935273546324,62.148064726453676,Housing
201686,39549,162137,19.609194490445546,80.39080550955445,Entertainment
32929,1939,30990,5.888426614837985,94.11157338516202,Food
140339,26736,113603,19.05101219190674,80.94898780809326,Healthcare
99860,58758,41102,58.84037652713799,41.15962347286201,Transportation
32794,3926,28868,11.971702140635482,88.02829785936451,Food
153101,9978,143123,6.517266379710127,93.48273362028988,Healthcare
122905,11261,111644,9.162361173263903,90.8376388267361,Healthcare
67770,1067,66703,1.5744429688652795,98.42555703113473,Transportation
59754,29457,30297,49.29711818455668,50.70288181544331,Food
244580,39637,204943,16.20614931719683,83.79385068280317,Entertainment
74353,42213,32140,56.773768375183245,43.226231624816755,Transportation
185847,12435,173412,6.690987747986246,93.30901225201376,Entertainment
220845,15685,205160,7.102266295365528,92.89773370463448,Entertainment
178605,56832,121773,31.819937851683882,68.18006214831611,Healthcare
17549,6879,10670,39.19881474727905,60.801185252720956,Housing
28912,1401,27511,4.84573879358052,95.15426120641948,Housing
12352,4278,8074,34.634067357512954,65.36593264248705,Housing
73064,36297,36767,49.67836417387496,50.321635826125046,Transportation
111114,18366,92748,16.528970246773582,83.47102975322642,Transportation
39351,15323,24028,38.93928997992427,61.060710020075724,Food
41232,20504,20728,49.72836631742336,50.27163368257664,Food
27298,6466,20832,23.68671697560261,76.31328302439739,Housing
178937,67617,111320,37.788160078686914,62.211839921313086,Healthcare
18553,9297,9256,50.110494259688465,49.88950574031154,Housing
10201,1560,8641,15.292618370747965,84.70738162925203,Housing
145786,16685,129101,11.444857530901459,88.55514246909854,Healthcare
179204,20568,158636,11.477422378964755,88.52257762103525,Healthcare
129674,9133,120541,7.043046408686399,92.9569535913136,Healthcare
22053,9595,12458,43.50881966172403,56.49118033827597,Housing
177401,37754,139647,21.281728964323765,78.71827103567624,Healthcare
229762,40040,189722,17.42672852778092,82.57327147221908,Entertainment
159420,41471,117949,26.013674570317402,73.9863254296826,Healthcare
147972,43370,104602,29.30959911334577,70.69040088665423,Healthcare
69133,27873,41260,40.317937887839385,59.682062112160615,Transportation
52140,4391,47749,8.42155734560798,91.57844265439202,Food
164437,59837,104600,36.38901220528227,63.61098779471773,Healthcare
72338,25438,46900,35.16547319527773,64.83452680472229,Transportation
27600,15242,12358,55.224637681159415,44.77536231884058,Housing
242875,51319,191556,21.129799279464745,78.87020072053525,Entertainment
193649,48094,145555,24.835656264685074,75.16434373531492,Entertainment
188067,35978,152089,19.13041628781232,80.86958371218768,Entertainment
232883,5186,227697,2.2268692862939763,97.77313071370602,Entertainment
41876,9349,32527,22.325437004489444,77.67456299551056,Food
191443,39521,151922,20.64374252388439,79.35625747611562,Entertainment
112424,39146,73278,34.81996726677578,65.18003273322422,Transportation
223798,57749,166049,25.804073316115428,74.19592668388458,Entertainment
87916,706,87210,0.8030392647527186,99.19696073524729,Transportation
34507,2731,31776,7.91433622163619,92.08566377836381,Food
24486,830,23656,3.389692068937352,96.61030793106265,Housing
98366,4545,93821,4.620498952890227,95.37950104710977,Transportation
41561,23302,18259,56.066985876181995,43.933014123818005,Food
249132,18862,230270,7.571086813416181,92.42891318658381,Entertainment
39355,11480,27875,29.170372252572736,70.82962774742725,Food
215311,14534,200777,6.750235705560794,93.2497642944392,Entertainment
208392,24462,183930,11.738454451226534,88.26154554877347,Entertainment
36926,9458,27468,25.61338894004225,74.38661105995776,Food
51198,12752,38446,24.907222938396032,75.09277706160397,Food
222475,66388,156087,29.840656253511632,70.15934374648836,Entertainment
128258,28828,99430,22.476570662258887,77.5234293377411,Healthcare
191618,7143,184475,3.7277291277437405,96.27227087225626,Entertainment
85789,2565,83224,2.9898938092296214,97.01010619077037,Transportation
25061,3604,21457,14.380910578189217,85.61908942181078,Housing
180628,36329,144299,20.11260712624842,79.88739287375157,Entertainment
57958,4299,53659,7.417440215328341,92.58255978467166,Food
16413,7666,8747,46.706878693718394,53.29312130628161,Housing
212359,67693,144666,31.876680526843693,68.1233194731563,Entertainment
11147,4779,6368,42.87252175473221,57.12747824526778,Housing
141463,5469,135994,3.8660285728423687,96.13397142715763,Healthcare
63631,10573,53058,16.616114786817747,83.38388521318225,Transportation
175091,45970,129121,26.254918870758637,73.74508112924136,Healthcare
193411,36310,157101,18.773492717580694,81.2265072824193,Entertainment
94265,27500,66765,29.173075903039305,70.8269240969607,Transportation
226532,48492,178040,21.406247241007893,78.59375275899211,Entertainment
28947,8209,20738,28.35872456558538,71.64127543441462,Housing
238833,32875,205958,13.764848241239694,86.23515175876031,Entertainment
228145,52468,175677,22.997655000109578,77.00234499989041,Entertainment
59330,11893,47437,20.045508174616554,79.95449182538344,Food
38774,6916,31858,17.836694692319597,82.1633053076804,Food
18262,7286,10976,39.897053991895746,60.10294600810426,Housing
116561,48747,67814,41.82102075308208,58.178979246917926,Transportation
154679,28487,126192,18.416850380465352,81.58314961953465,Healthcare
18758,3127,15631,16.67022070583218,83.32977929416782,Housing
231905,18295,213610,7.889006274120868,92.11099372587913,Entertainment
216825,35567,181258,16.403551251008878,83.59644874899112,Entertainment
52447,11001,41446,20.975460941521916,79.02453905847808,Food
31077,9807,21270,31.557100106187857,68.44289989381215,Food
54372,30527,23845,56.14470683440006,43.85529316559994,Food
58977,28040,30937,47.543957814063106,52.456042185936894,Food
84849,32216,52633,37.96862661905267,62.03137338094733,Transportation
117568,25404,92164,21.607920522591183,78.39207947740881,Transportation
197832,32135,165697,16.24358041166242,83.75641958833758,Entertainment
39636,455,39181,1.14794631143405,98.85205368856596,Food
35718,17219,18499,48.20818634861974,51.79181365138026,Food
18616,3751,14865,20.149333906317146,79.85066609368286,Housing
235787,49957,185830,21.187342813641123,78.81265718635888,Entertainment
230677,14547,216130,6.30622038608097,93.69377961391902,Entertainment
125368,61065,64303,48.70860187607683,51.29139812392317,Healthcare
24097,9199,14898,38.174876540648214,61.825123459351786,Housing
11360,4052,7308,35.66901408450705,64.33098591549296,Housing
27437,1324,26113,4.8256004665233085,95.17439953347669,Housing
189307,39579,149728,20.907309291257057,79.09269070874294,Entertainment
68563,19301,49262,28.150751863249855,71.84924813675015,Transportation
198300,25271,173029,12.743822491174988,87.25617750882502,Entertainment
61962,8879,53083,14.329750492237178,85.67024950776282,Transportation
51834,17235,34599,33.250376200949184,66.74962379905082,Food
153321,19215,134106,12.532529790439668,87.46747020956033,Healthcare
140400,1819,138581,1.2955840455840455,98.70441595441596,Healthcare
182127,31087,151040,17.06885854376342,82.93114145623657,Entertainment
64436,25162,39274,39.049599602706564,60.950400397293436,Transportation
26885,1454,25431,5.408220197135949,94.59177980286405,Housing
34684,20392,14292,58.793680083035404,41.206319916964596,Food
58195,18669,39526,32.08007560787009,67.9199243921299,Food
63774,23964,39810,37.576441810142065,62.42355818985793,Transportation
31694,8116,23578,25.607370480217075,74.39262951978293,Food
70893,23746,47147,33.495549631134246,66.50445036886575,Transportation
128476,66410,62066,51.69058812540863,48.30941187459136,Healthcare
12104,4325,7779,35.73198942498348,64.26801057501652,Housing
17386,4060,13326,23.352122397331186,76.64787760266881,Housing
63078,29110,33968,46.14921208662291,53.85078791337708,Transportation
179315,30353,148962,16.92719515935644,83.07280484064356,Healthcare
219230,54292,164938,24.76485882406605,75.23514117593395,Entertainment
119623,43746,75877,36.56989040569121,63.43010959430879,Transportation
78669,19076,59593,24.248433309181507,75.75156669081849,Transportation
52164,26785,25379,51.34767272448432,48.65232727551568,Food
103774,40581,63193,39.10517085204386,60.89482914795613,Transportation
225660,14268,211392,6.322786492954001,93.67721350704599,Entertainment
191714,5652,186062,2.9481415024463526,97.05185849755364,Entertainment
45668,9567,36101,20.949023386178506,79.0509766138215,Food
37242,19305,17937,51.836636056065736,48.163363943934264,Food
162905,33957,128948,20.8446640680151,79.1553359319849,Healthcare
144121,13251,130870,9.194357519029149,90.80564248097085,Healthcare
148933,41636,107297,27.956195067580726,72.04380493241928,Healthcare
37929,17702,20227,46.6714123757547,53.3285876242453,Food
33163,5294,27869,15.963573862437052,84.03642613756294,Food
140040,16033,124007,11.448871750928307,88.5511282490717,Healthcare
237685,46680,191005,19.63943875297137,80.36056124702863,Entertainment
102823,14105,88718,13.717747974674927,86.28225202532506,Transportation
24494,10142,14352,41.40605862660243,58.59394137339756,Housing
44680,3039,41641,6.801700984780662,93.19829901521933,Food
176295,19101,157194,10.834680507104569,89.16531949289543,Healthcare
27894,321,27573,1.1507851150785116,98.8492148849215,Housing
49090,24931,24159,50.78631085760848,49.21368914239152,Food
133411,9454,123957,7.086372188200373,92.91362781179963,Healthcare
11530,3681,7849,31.9254119687771,68.07458803122289,Housing
68092,13922,54170,20.44586735593021,79.55413264406978,Transportation
247513,43506,204007,17.57725856823682,82.42274143176319,Entertainment
40177,5975,34202,14.871692759539041,85.12830724046097,Food
154878,32456,122422,20.95584911995248,79.04415088004752,Healthcare
100806,12249,88557,12.151062436759718,87.84893756324028,Transportation
92197,20678,71519,22.428061650596007,77.571938349404,Transportation
219073,5659,213414,2.583157212436037,97.41684278756397,Entertainment
64446,9705,54741,15.059119262638488,84.94088073736151,Transportation
164899,7636,157263,4.630713345744971,95.36928665425502,Healthcare
116189,66587,49602,57.309211715394746,42.690788284605254,Transportation
25968,13985,11983,53.85474430067776,46.14525569932224,Housing
45663,15380,30283,33.68153647373147,66.31846352626853,Food
218132,1012,217120,0.4639392661324336,99.53606073386757,Entertainment
138023,17037,120986,12.343594908095028,87.65640509190497,Healthcare
191562,25766,165796,13.45047556404715,86.54952443595285,Entertainment
118570,64735,53835,54.596440920974956,45.403559079025044,Transportation
38260,3176,35084,8.30109775222164,91.69890224777836,Food
53408,21759,31649,40.74108747753146,59.25891252246854,Food
249452,1911,247541,0.7660792457065888,99.23392075429341,Entertainment
15204,3737,11467,24.579058142594054,75.42094185740595,Housing
198865,48768,150097,24.52316898398411,75.4768310160159,Entertainment
41295,19073,22222,46.187189732413124,53.812810267586876,Food
15831,6454,9377,40.76811319562883,59.23188680437117,Housing
110068,16544,93524,15.030708289421085,84.96929171057891,Transportation
153574,65181,88393,42.44273119147772,57.55726880852228,Healthcare
100126,20682,79444,20.655973473423487,79.34402652657651,Transportation
235870,20927,214943,8.872260143299275,91.12773985670073,Entertainment
39894,18708,21186,46.89426981500978,53.10573018499022,Food
68736,15118,53618,21.994297020484172,78.00570297951583,Transportation
27295,7631,19664,27.957501373878003,72.042498626122,Housing
45227,3612,41615,7.986379817365733,92.01362018263427,Food
108813,32320,76493,29.70233336090357,70.29766663909643,Transportation
10361,5759,4602,55.583437892095354,44.416562107904646,Housing
201676,60433,141243,29.965390031535733,70.03460996846427,Entertainment
34476,16794,17682,48.712147580925865,51.28785241907414,Food
107109,3619,103490,3.378801034460223,96.62119896553978,Transportation
248946,19332,229614,7.765539514593526,92.23446048540647,Entertainment
167443,57516,109927,34.34959956522518,65.65040043477481,Healthcare
96433,31502,64931,32.66724046747483,67.33275953252517,Transportation
56552,26944,29608,47.64464563587495,52.35535436412505,Food
90241,35952,54289,39.83998404273002,60.16001595726998,Transportation
15705,2244,13461,14.28844317096466,85.71155682903535,Housing
11291,6269,5022,55.52209724559384,44.47790275440616,Housing
93885,54994,38891,58.57591734568888,41.42408265431112,Transportation
138715,50542,88173,36.43585769383268,63.56414230616733,Healthcare
37636,5164,32472,13.720905515995325,86.27909448400469,Food
161470,21719,139751,13.4507958134638,86.5492041865362,Healthcare
215419,56370,159049,26.16760824254128,73.83239175745871,Entertainment
242123,28031,214092,11.577173585326467,88.42282641467354,Entertainment
244095,57805,186290,23.681353571355416,76.31864642864458,Entertainment
189708,30350,159358,15.998271027052102,84.0017289729479,Entertainment
147289,18998,128291,12.898451343956438,87.10154865604356,Healthcare
20822,2572,18250,12.352319661896072,87.64768033810392,Housing
23643,1919,21724,8.11656727149685,91.88343272850315,Housing
231021,51207,179814,22.16551742049424,77.83448257950576,Entertainment
127365,32298,95067,25.358615004122008,74.64138499587798,Healthcare
111194,54079,57115,48.63481842545461,51.365181574545396,Transportation
161049,60176,100873,37.36502555122975,62.63497444877025,Healthcare
50384,16656,33728,33.058113686884724,66.94188631311528,Food
227236,52160,175076,22.954109384076464,77.04589061592353,Entertainment
171329,22021,149308,12.853048812518605,87.14695118748139,Healthcare
35768,3755,32013,10.498210691120555,89.50178930887944,Food
71373,26965,44408,37.780393145867485,62.219606854132515,Transportation
131095,14185,116910,10.820397421717075,89.17960257828292,Healthcare
118493,53172,65321,44.87353683339944,55.12646316660056,Transportation
71455,19300,52155,27.010006297669864,72.98999370233014,Transportation
23419,64,23355,0.2732823775566847,99.72671762244332,Housing
189227,53739,135488,28.399224212189594,71.6007757878104,Entertainment
38607,4465,34142,11.565260185976637,88.43473981402337,Food
57774,24225,33549,41.93062623325371,58.06937376674629,Food
23799,4605,19194,19.349552502205974,80.65044749779402,Housing
57225,14088,43137,24.618610747051115,75.38138925294888,Food
53044,860,52184,1.6212955282407058,98.37870447175929,Food
225545,4722,220823,2.093595513090514,97.90640448690948,Entertainment
20330,7405,12925,36.424003935071326,63.575996064928674,Housing
47861,18834,29027,39.35145525584505,60.648544744154954,Food
51587,13526,38061,26.219784054122165,73.78021594587784,Food
127747,13869,113878,10.856615028141562,89.14338497185844,Healthcare
220079,12566,207513,5.709767856088041,94.29023214391195,Entertainment
83640,28805,54835,34.43926351028217,65.56073648971784,Transportation
149482,54182,95300,36.24650459587107,63.75349540412893,Healthcare
210479,17588,192891,8.356178051016967,91.64382194898303,Entertainment
189506,15641,173865,8.253564530938334,91.74643546906167,Entertainment
15338,544,14794,3.5467466423262484,96.45325335767374,Housing
100315,43467,56848,43.33050889697453,56.66949110302547,Transportation
50670,20092,30578,39.65265443062956,60.34734556937044,Food
114894,43275,71619,37.665152227270355,62.33484777272965,Transportation
167044,939,166105,0.5621273436938771,99.43787265630613,Healthcare
59027,31519,27508,53.397597709522756,46.602402290477244,Food
27109,2002,25107,7.3850012910841425,92.61499870891586,Housing
130530,17956,112574,13.7562246226921,86.2437753773079,Healthcare
22168,7059,15109,31.84319740166005,68.15680259833995,Housing
146111,57172,88939,39.12915523129675,60.87084476870325,Healthcare
54659,29594,25065,54.14295907352861,45.85704092647139,Food
230075,21802,208273,9.476040421601652,90.52395957839835,Entertainment
17835,17,17818,0.09531819456125595,99.90468180543874,Housing
20165,6694,13471,33.196131911728244,66.80386808827176,Housing
134426,43034,91392,32.01315221757696,67.98684778242304,Healthcare
71265,29790,41475,41.80172595243107,58.19827404756893,Transportation
54132,29728,24404,54.91760880809872,45.08239119190128,Food
24219,1749,22470,7.221602873776786,92.77839712622321,Housing
179139,63794,115345,35.611452559185885,64.38854744081411,Healthcare
59309,1991,57318,3.3569947225547554,96.64300527744525,Food
20552,10812,9740,52.60801868431296,47.39198131568704,Housing
107053,27902,79151,26.063725444406042,73.93627455559397,Transportation
47896,20930,26966,43.698847502923,56.301152497077,Food
31644,14981,16663,47.34230817848565,52.657691821514355,Food
48434,21586,26848,44.567865548994504,55.43213445100549,Food
195842,35397,160445,18.074263947467855,81.92573605253214,Entertainment
39463,3355,36108,8.501634442389074,91.49836555761092,Food
172599,66725,105874,38.65897253170644,61.34102746829356,Healthcare
144801,18327,126474,12.656680547786273,87.34331945221373,Healthcare
204787,28250,176537,13.794820960314864,86.20517903968513,Entertainment
171864,36178,135686,21.050365405204115,78.94963459479588,Healthcare
158057,21478,136579,13.58876860879303,86.41123139120697,Healthcare
20187,2175,18012,10.774260662802794,89.22573933719721,Housing
60632,19048,41584,31.41575405726349,68.58424594273652,Transportation
43492,20347,23145,46.78331647199485,53.21668352800515,Food
43844,9220,34624,21.02910318401606,78.97089681598395,Food
95758,15571,80187,16.260782388938782,83.7392176110612,Transportation
59626,33946,25680,56.93153993224433,43.06846006775567,Food
10049,2463,7586,24.509901482734602,75.49009851726541,Housing
11966,6184,5782,51.679759318067866,48.32024068193214,Housing
32034,10785,21249,33.667353436973215,66.33264656302678,Food
20627,99,20528,0.47995345905851555,99.5200465409415,Housing
26740,2409,24331,9.008975317875842,90.99102468212415,Housing
195077,14566,180511,7.466795162935662,92.53320483706435,Entertainment
104953,20055,84898,19.108553352453004,80.891446647547,Transportation
63438,5518,57920,8.698256565465494,91.30174343453452,Transportation
108523,4329,104194,3.989016153257835,96.01098384674216,Transportation
142138,40277,101861,28.336546173437082,71.66345382656291,Healthcare
72749,26861,45888,36.9228443002653,63.077155699734696,Transportation
231784,25901,205883,11.174628102026023,88.82537189797397,Entertainment
27637,11342,16295,41.03918659767703,58.96081340232298,Housing
79483,41783,37700,52.568473761684885,47.431526238315115,Transportation
188894,7083,181811,3.749722066344087,96.25027793365591,Entertainment
28600,14340,14260,50.13986013986014,49.86013986013986,Housing
100114,53888,46226,53.82663763309827,46.173362366901735,Transportation
35991,9338,26653,25.945375232697067,74.05462476730294,Food
19719,11378,8341,57.70069476139764,42.299305238602365,Housing
118080,46247,71833,39.16581978319783,60.83418021680217,Transportation
29979,4078,25901,13.602855332065781,86.39714466793423,Housing
48527,19807,28720,40.81645269643703,59.18354730356297,Food
52514,3261,49253,6.209772632060022,93.79022736793998,Food
30466,5793,24673,19.014639270005908,80.9853607299941,Food
61348,14704,46644,23.968181521810003,76.03181847818999,Transportation
67754,1633,66121,2.410189804291998,97.589810195708,Transportation
99870,14117,85753,14.13537598878542,85.86462401121457,Transportation
151524,56487,95037,37.279242892215095,62.720757107784905,Healthcare
124153,13542,110611,10.907509282900937,89.09249071709905,Healthcare
138441,17032,121409,12.302713791434618,87.69728620856539,Healthcare
46073,20226,25847,43.899897987975606,56.1001020120244,Food
29956,13711,16245,45.77046334624115,54.22953665375885,Housing
10868,5259,5609,48.389768126610235,51.610231873389765,Housing
66918,14664,52254,21.91338653277145,78.08661346722855,Transportation
127126,59641,67485,46.91487185941507,53.085128140584935,Healthcare
20849,10802,10047,51.810638399923256,48.189361600076744,Housing
166006,46533,119473,28.030914545257403,71.9690854547426,Healthcare
46596,25521,21075,54.7707957764615,45.2292042235385,Food
62574,28453,34121,45.470962380541444,54.52903761945856,Transportation
192056,40130,151926,20.894947307035448,79.10505269296455,Entertainment
172923,32422,140501,18.749385564673293,81.25061443532671,Healthcare
239801,18877,220924,7.8719438200841525,92.12805617991584,Entertainment
215404,3960,211444,1.8384059720339456,98.16159402796606,Entertainment
69031,36895,32136,53.44700207153308,46.55299792846692,Transportation
72764,14653,58111,20.137705458743334,79.86229454125666,Transportation
47587,14275,33312,29.99768844432303,70.00231155567697,Food
95750,780,94970,0.814621409921671,99.18537859007833,Transportation
49900,6450,43450,12.925851703406813,87.0741482965932,Food
203545,7420,196125,3.6453855412807976,96.3546144587192,Entertainment
37238,21948,15290,58.93979268489178,41.06020731510822,Food
111037,39386,71651,35.471059196484056,64.52894080351595,Transportation
46207,4415,41792,9.554829354859654,90.44517064514035,Food
223354,580,222774,0.2596774626825577,99.74032253731744,Entertainment
14731,5245,9486,35.60518634172833,64.39481365827167,Housing
10268,874,9394,8.511881573821583,91.48811842617842,Housing
23809,8420,15389,35.36477802511655,64.63522197488345,Housing
123797,51142,72655,41.311178784623216,58.688821215376784,Healthcare
49443,18045,31398,36.49657180996299,63.50342819003701,Food
29226,11635,17591,39.81044275644974,60.18955724355026,Housing
33448,19154,14294,57.265008371203066,42.734991628796934,Food
211604,2872,208732,1.357252225855844,98.64274777414415,Entertainment
11760,1199,10561,10.195578231292517,89.80442176870748,Housing
243523,8899,234624,3.6542749555483462,96.34572504445165,Entertainment
21300,8908,12392,41.821596244131456,58.178403755868544,Housing
101770,54448,47322,53.50103173823327,46.49896826176673,Transportation
37897,5839,32058,15.407552048974853,84.59244795102515,Food
227508,27813,199695,12.225064613112506,87.77493538688749,Entertainment
50344,4491,45853,8.920626092483712,91.0793739075163,Food
171440,15093,156347,8.803663089127392,91.19633691087262,Healthcare
26965,11181,15784,41.464861857964024,58.53513814203597,Housing
205893,14659,191234,7.119717523179515,92.88028247682048,Entertainment
238858,44306,194552,18.549096115683795,81.4509038843162,Entertainment
38526,21505,17021,55.81944660748586,44.18055339251414,Food
51912,2068,49844,3.9836646632763135,96.01633533672369,Food
177148,47677,129471,26.913654119719105,73.08634588028089,Healthcare
91958,34905,57053,37.957545836142586,62.04245416385741,Transportation
29068,16093,12975,55.36328608779414,44.63671391220586,Housing
16286,899,15387,5.520078595112366,94.47992140488763,Housing
134122,40025,94097,29.842233190677142,70.15776680932285,Healthcare
182461,50135,132326,27.477104696346068,72.52289530365394,Entertainment
172778,43141,129637,24.96903540960076,75.03096459039924,Healthcare
98408,42176,56232,42.85830420291033,57.14169579708967,Transportation
23428,2201,21227,9.394741335154515,90.6052586648455,Housing
224582,41804,182778,18.614136484669295,81.3858635153307,Entertainment
162381,50043,112338,30.818260757108284,69.18173924289171,Healthcare
192559,56869,135690,29.533285901983287,70.46671409801671,Entertainment
20246,6275,13971,30.993776548454015,69.00622345154599,Housing
67739,40153,27586,59.276044819085016,40.723955180914984,Transportation
72011,9219,62792,12.80221077335407,87.19778922664592,Transportation
47932,1997,45935,4.166318951848452,95.83368104815155,Food
12621,5992,6629,47.47642817526345,52.52357182473655,Housing
238378,29681,208697,12.451232915789209,87.5487670842108,Entertainment
112120,21488,90632,19.16518016410988,80.83481983589012,Transportation
194716,7295,187421,3.7464820559173364,96.25351794408267,Entertainment
183558,10754,172804,5.858638686409745,94.14136131359025,Entertainment
157904,48479,109425,30.701565508156854,69.29843449184314,Healthcare
10111,3481,6630,34.427850855503905,65.5721491444961,Housing
107360,13332,94028,12.418032786885245,87.58196721311475,Transportation
240015,51402,188613,21.416161489906884,78.58383851009312,Entertainment
88576,24062,64514,27.165372109826592,72.83462789017341,Transportation
17103,9212,7891,53.86189557387593,46.13810442612407,Housing
41769,16979,24790,40.649764179175946,59.35023582082406,Food
248099,58068,190031,23.405172934997722,76.59482706500228,Entertainment
47245,18657,28588,39.48989311038205,60.51010688961795,Food
51477,2914,48563,5.660780542766672,94.33921945723333,Food
125348,13272,112076,10.588122666496474,89.41187733350353,Healthcare
139766,16811,122955,12.027961020562941,87.97203897943706,Healthcare
66391,11854,54537,17.854829720895903,82.1451702791041,Transportation
23410,10354,13056,44.22896198205895,55.77103801794105,Housing
16943,10057,6886,59.35784689842413,40.64215310157587,Housing
248784,2107,246677,0.8469194160396166,99.15308058396039,Entertainment
51353,12108,39245,23.57797986485697,76.42202013514303,Food
233235,31259,201976,13.402362424164469,86.59763757583553,Entertainment
18441,8009,10432,43.43039965294724,56.56960034705276,Housing
61555,23772,37783,38.619121111201366,61.38087888879864,Transportation
58508,21430,37078,36.627469747726806,63.372530252273194,Food
47258,6946,40312,14.69804054340006,85.30195945659995,Food
178613,60617,117996,33.937619322221785,66.06238067777821,Healthcare
125609,10248,115361,8.158651052074294,91.84134894792571,Healthcare
175361,19277,156084,10.992752094251287,89.00724790574871,Healthcare
63444,31932,31512,50.33100056742954,49.66899943257045,Transportation
146651,15978,130673,10.895254720390588,89.1047452796094,Healthcare
29715,10580,19135,35.604913343429246,64.39508665657075,Housing
192604,5679,186925,2.9485368943531807,97.05146310564682,Entertainment
144631,21865,122766,15.117782494762533,84.88221750523746,Healthcare
149807,2120,147687,1.4151541650256663,98.58484583497433,Healthcare
54807,2525,52282,4.607075738500557,95.39292426149945,Food
134660,27778,106882,20.62824892321402,79.37175107678598,Healthcare
113794,15710,98084,13.805648803979121,86.19435119602088,Transportation
11771,6895,4876,58.576161753461896,41.423838246538104,Housing
131995,65963,66032,49.97386264631236,50.02613735368764,Healthcare
149325,23330,125995,15.623639712037502,84.3763602879625,Healthcare
22198,3088,19110,13.91116316785296,86.08883683214704,Housing
18091,6274,11817,34.68022773754906,65.31977226245094,Housing
224246,69266,154980,30.888399347145544,69.11160065285445,Entertainment
239315,18529,220786,7.742515095167457,92.25748490483254,Entertainment
99952,47004,52948,47.02657275492236,52.973427245077644,Transportation
240355,15598,224757,6.489567514717813,93.5104324852822,Entertainment
55438,1694,53744,3.05566578880912,96.94433421119088,Food
211193,2252,208941,1.0663232209400881,98.93367677905991,Entertainment
159509,16200,143309,10.156166736673166,89.84383326332683,Healthcare
214027,27163,186864,12.6913894041406,87.3086105958594,Entertainment
173846,10076,163770,5.79593433268525,94.20406566731475,Healthcare
46453,5326,41127,11.465352076292167,88.53464792370784,Food
224890,14954,209936,6.64947307572591,93.35052692427409,Entertainment
189702,41616,148086,21.937565233893157,78.06243476610683,Entertainment
118978,69650,49328,58.54023432903562,41.45976567096438,Transportation
125773,38267,87506,30.42544902324028,69.57455097675972,Healthcare
57674,5075,52599,8.799459028331658,91.20054097166835,Food
23845,1935,21910,8.114908785908996,91.885091214091,Housing
15683,8951,6732,57.07453931008097,42.92546068991902,Housing
118796,26135,92661,21.99989898649786,78.00010101350215,Transportation
100732,26210,74522,26.019536989238773,73.98046301076123,Transportation
73502,13839,59663,18.828059100432643,81.17194089956736,Transportation
155331,60760,94571,39.11646741474657,60.883532585253434,Healthcare
23262,2239,21023,9.625139712836384,90.37486028716361,Housing
35280,2059,33221,5.836167800453515,94.16383219954648,Food
217974,48566,169408,22.280638975290632,77.71936102470937,Entertainment
229243,23707,205536,10.341428091588401,89.6585719084116,Entertainment
14862,1996,12866,13.430224734221504,86.56977526577849,Housing
25106,1241,23865,4.9430415040229425,95.05695849597706,Housing
26880,7677,19203,28.560267857142858,71.43973214285714,Housing
93393,30839,62554,33.02067606779951,66.97932393220049,Transportation
20075,9698,10377,48.308841843088416,51.69115815691158,Housing
91957,51643,40314,56.15994432180258,43.84005567819742,Transportation
45354,20508,24846,45.21762137848922,54.78237862151079,Food
77502,15608,61894,20.138835126835435,79.86116487316455,Transportation
35969,12551,23418,34.89393644527232,65.10606355472768,Food
145473,9446,136027,6.493301162415019,93.50669883758498,Healthcare
67813,31591,36222,46.58546296432837,53.41453703567163,Transportation
249424,25305,224119,10.145374943870678,89.85462505612932,Entertainment
162661,64351,98310,39.56141914779818,60.43858085220182,Healthcare
130742,40781,89961,31.19196585641951,68.80803414358049,Healthcare
32446,14323,18123,44.14411637798188,55.85588362201812,Food
34389,11451,22938,33.29843845415685,66.70156154584315,Food
28093,10417,17676,37.08041149040686,62.91958850959314,Housing
127446,42624,84822,33.444753071889274,66.55524692811073,Healthcare
140797,11819,128978,8.394354993359233,91.60564500664077,Healthcare
149788,42096,107692,28.10371992415948,71.89628007584052,Healthcare
36511,2830,33681,7.751088712990606,92.24891128700939,Food
227837,23275,204562,10.215636617406304,89.7843633825937,Entertainment
99711,41030,58681,41.14892037989791,58.8510796201021,Transportation
213831,2735,211096,1.2790474720690639,98.72095252793093,Entertainment
168072,62469,105603,37.16799942881622,62.83200057118378,Healthcare
129595,18451,111144,14.237431999691347,85.76256800030866,Healthcare
147464,1813,145651,1.2294526121629685,98.77054738783703,Healthcare
13217,4666,8551,35.303018839373536,64.69698116062646,Housing
104745,54268,50477,51.80963291803905,48.19036708196096,Transportation
10473,2841,7632,27.126897737038096,72.8731022629619,Housing
37896,17023,20873,44.92030821194849,55.07969178805151,Food
26234,10234,16000,39.01044446138599,60.98955553861401,Housing
234428,57819,176609,24.663862678519628,75.33613732148036,Entertainment
187314,61879,125435,33.03490395805973,66.96509604194027,Entertainment
141582,23141,118441,16.34459182664463,83.65540817335537,Healthcare
120080,40462,79618,33.69586942038641,66.3041305796136,Healthcare
175016,42279,132737,24.157219911322393,75.84278008867761,Healthcare
154853,1384,153469,0.8937508475780256,99.10624915242198,Healthcare
144345,6626,137719,4.590391076933735,95.40960892306627,Healthcare
124808,29166,95642,23.36869431446702,76.63130568553298,Healthcare
22143,5260,16883,23.754685453642235,76.24531454635776,Housing
129575,64575,65000,49.83600231526143,50.16399768473857,Healthcare
21074,10745,10329,50.986998196830214,49.01300180316978,Housing
53671,18780,34891,34.990963462577554,65.00903653742245,Food
152261,30581,121680,20.084591589441814,79.91540841055819,Healthcare
107433,11806,95627,10.989174648385506,89.0108253516145,Transportation
76104,24920,51184,32.74466519499632,67.25533480500367,Transportation
126848,53081,73767,41.8461465691221,58.1538534308779,Healthcare
96829,42689,54140,44.086998729719404,55.913001270280596,Transportation
104651,17067,87584,16.308492035432053,83.69150796456795,Transportation
51296,2113,49183,4.11922956955708,95.88077043044292,Food
48596,12441,36155,25.60087249979422,74.39912750020578,Food
112373,50184,62189,44.65841438779778,55.341585612202216,Transportation
44144,17188,26956,38.93620877129395,61.06379122870605,Food
169295,3018,166277,1.7826870256061902,98.2173129743938,Healthcare
29485,8485,21000,28.777344412413093,71.22265558758691,Housing
166459,53359,113100,32.05534095482972,67.94465904517028,Healthcare
76367,21196,55171,27.755444105438215,72.24455589456178,Transportation
31359,13914,17445,44.3700373098632,55.6299626901368,Food
160743,59647,101096,37.1070590943307,62.892940905669306,Healthcare
52765,28767,23998,54.51909409646546,45.48090590353454,Food
96662,8406,88256,8.696281889470526,91.30371811052947,Transportation
63016,2576,60440,4.087850704582963,95.91214929541704,Transportation
61047,18333,42714,30.030959752321984,69.96904024767801,Transportation
132760,50333,82427,37.9127749322085,62.08722506779151,Healthcare
83901,23038,60863,27.458552341450044,72.54144765854996,Transportation
29473,17617,11856,59.773351881382965,40.226648118617035,Housing
164782,19303,145479,11.714264907574856,88.28573509242514,Healthcare
167947,16110,151837,9.592311860289259,90.40768813971074,Healthcare
242279,48736,193543,20.115651789878612,79.88434821012139,Entertainment
173377,58200,115177,33.5684664055786,66.43153359442141,Healthcare
181232,51750,129482,28.554559901121213,71.44544009887879,Entertainment
125117,34491,90626,27.56699729053606,72.43300270946395,Healthcare
79835,12699,67136,15.906557274378406,84.09344272562159,Transportation
86421,42752,43669,49.46945765496812,50.53054234503188,Transportation
128581,11695,116886,9.09543400657951,90.90456599342049,Healthcare
16035,751,15284,4.683504833177424,95.31649516682258,Housing
34886,20884,14002,59.86355558103538,40.13644441896463,Food
57457,31417,26040,54.67915136536888,45.32084863463112,Food
65294,21316,43978,32.646184948080986,67.35381505191901,Transportation
156252,67273,88979,43.054168906638,56.94583109336201,Healthcare
98412,29859,68553,30.340812096085845,69.65918790391416,Transportation
121729,15506,106223,12.738131423079135,87.26186857692086,Healthcare
206979,29893,177086,14.442527985930939,85.55747201406906,Entertainment
227092,42280,184812,18.618005037605904,81.3819949623941,Entertainment
14416,26,14390,0.18035516093229745,99.8196448390677,Housing
61646,29667,31979,48.1247769522759,51.875223047724106,Transportation
23793,522,23271,2.193922582272097,97.8060774177279,Housing
229738,64930,164808,28.26262960415778,71.73737039584222,Entertainment
20670,11650,9020,56.361877116594094,43.6381228834059,Housing
127511,59352,68159,46.54657245257272,53.45342754742728,Healthcare
43363,125,43238,0.2882641883633512,99.71173581163664,Food
115428,2741,112687,2.374640468517171,97.62535953148283,Transportation
68005,7243,60762,10.650687449452247,89.34931255054775,Transportation
94219,12555,81664,13.325337776881522,86.67466222311847,Transportation
156911,9911,147000,6.316319442231584,93.68368055776841,Healthcare
24537,10370,14167,42.262705302196686,57.73729469780332,Housing
197879,43983,153896,22.22721966454247,77.77278033545753,Entertainment
46067,15310,30757,33.23420235743591,66.7657976425641,Food
119194,27482,91712,23.056529691091836,76.94347030890818,Transportation
130219,42051,88168,32.29252259654889,67.70747740345111,Healthcare
143758,12383,131375,8.61378149389947,91.38621850610052,Healthcare
76491,26192,50299,34.24193695990378,65.75806304009622,Transportation
95588,20096,75492,21.02355944260786,78.97644055739214,Transportation
242288,18246,224042,7.530707257478703,92.46929274252129,Entertainment
143111,59276,83835,41.4195973754638,58.5804026245362,Healthcare
149991,55296,94695,36.86621197271837,63.13378802728163,Healthcare
29733,9767,19966,32.84902297110954,67.15097702889045,Housing
82976,49286,33690,59.397898187427685,40.602101812572315,Transportation
54494,30087,24407,55.21158292656072,44.78841707343928,Food
247381,31271,216110,12.64082528569292,87.35917471430709,Entertainment
28651,12134,16517,42.35105231929078,57.64894768070923,Housing
19549,1348,18201,6.895493375620236,93.10450662437977,Housing
182150,51177,130973,28.09607466373868,71.90392533626132,Entertainment
216258,51614,164644,23.86686272877766,76.13313727122234,Entertainment
28248,16259,11989,57.55805720758992,42.44194279241008,Housing
248825,2668,246157,1.0722395257711241,98.92776047422888,Entertainment
106521,30149,76372,28.303339247660087,71.69666075233991,Transportation
233707,2833,230874,1.2122016028617029,98.78779839713829,Entertainment
156713,4671,152042,2.9806078627810075,97.019392137219,Healthcare
59808,2356,57452,3.939272338148743,96.06072766185125,Food
62975,33363,29612,52.97816593886463,47.02183406113537,Transportation
172483,36065,136418,20.909307004168525,79.09069299583147,Healthcare
210310,54534,155776,25.930293376444297,74.0697066235557,Entertainment
30126,13303,16823,44.15787027816504,55.84212972183495,Food
26109,5785,20324,22.157110574897544,77.84288942510246,Housing
117057,21357,95700,18.244957584766397,81.7550424152336,Transportation
121943,57138,64805,46.856318115841006,53.14368188415899,Healthcare
157507,38462,119045,24.419232161110298,75.5807678388897,Healthcare
219469,41457,178012,18.88968373665529,81.1103162633447,Entertainment
34982,16504,18478,47.17854896804071,52.821451031959285,Food
17985,1847,16138,10.269669168751737,89.73033083124827,Housing
14867,3115,11752,20.95244501244367,79.04755498755634,Housing
96122,13846,82276,14.40461080709931,85.59538919290068,Transportation
12533,4310,8223,34.389212479055296,65.6107875209447,Housing
122403,35746,86657,29.203532593155394,70.7964674068446,Healthcare
75934,19358,56576,25.49319145573788,74.50680854426213,Transportation
57992,6579,51413,11.344668230100703,88.65533176989929,Food
173527,61262,112265,35.30401608971515,64.69598391028487,Healthcare
23473,12256,11217,52.213181101691305,47.786818898308695,Housing
24914,5985,18929,24.02263787428755,75.97736212571246,Housing
49332,20369,28963,41.28962944944458,58.710370550555425,Food
176756,40426,136330,22.87107651225418,77.12892348774581,Healthcare
139915,17933,121982,12.817067505271057,87.18293249472893,Healthcare
74862,28527,46335,38.1061152520638,61.8938847479362,Transportation
162505,53678,108827,33.03159902772222,66.96840097227778,Healthcare
125410,12012,113398,9.57818355792999,90.42181644207001,Healthcare
154815,46899,107916,30.293576203856215,69.70642379614378,Healthcare
46424,5762,40662,12.411683611924866,87.58831638807514,Food
92615,50189,42426,54.19100577660206,45.80899422339794,Transportation
118815,47259,71556,39.7752808988764,60.22471910112359,Transportation
29328,13379,15949,45.618521549372616,54.381478450627384,Housing
150714,44149,106565,29.293230887641492,70.7067691123585,Healthcare
48703,4618,44085,9.481962096790753,90.51803790320925,Food
42577,4904,37673,11.517955703783734,88.48204429621627,Food
140508,15909,124599,11.322486975830557,88.67751302416944,Healthcare
200651,6096,194555,3.0381109488614557,96.96188905113854,Entertainment
109686,54618,55068,49.794868989661396,50.2051310103386,Transportation
29819,13440,16379,45.071934001810924,54.928065998189076,Housing
129682,58609,71073,45.19439860582039,54.805601394179604,Healthcare
200389,62521,137868,31.199816357185274,68.80018364281473,Entertainment
84461,11805,72656,13.97686506198127,86.02313493801873,Transportation
12854,6370,6484,49.55655826979928,50.44344173020071,Housing
163932,54714,109218,33.37603396530269,66.62396603469732,Healthcare
232485,37621,194864,16.182119276512463,83.81788072348753,Entertainment
181455,11583,169872,6.38340084318426,93.61659915681574,Entertainment
56983,32309,24674,56.699366477721426,43.300633522278574,Food
39099,5716,33383,14.619299726335713,85.38070027366429,Food
213435,59372,154063,27.817368285426475,72.18263171457352,Entertainment
53574,27808,25766,51.90577518945757,48.09422481054243,Food
201415,14635,186780,7.266092396296204,92.73390760370378,Entertainment
86202,12463,73739,14.457901208788659,85.54209879121134,Transportation
38009,21651,16358,56.96282459417507,43.03717540582493,Food
15360,1713,13647,11.15234375,88.84765625,Housing
129720,54011,75709,41.636601911810054,58.363398088189946,Healthcare
64540,29461,35079,45.647660365664706,54.3523396343353,Transportation
75509,5125,70384,6.787270391608947,93.21272960839106,Transportation
73526,1816,71710,2.469874602181541,97.53012539781845,Transportation
22206,7212,14994,32.47770872737098,67.52229127262902,Housing
121736,15285,106451,12.555858579220608,87.44414142077939,Healthcare
190069,25714,164355,13.528771130484193,86.4712288695158,Entertainment
52440,22754,29686,43.3905415713196,56.60945842868039,Food
18522,2543,15979,13.729618831659648,86.27038116834035,Housing
113786,4122,109664,3.622589773785879,96.37741022621412,Transportation
14494,2261,12233,15.599558437974334,84.40044156202566,Housing
16666,6347,10319,38.08352334093364,61.91647665906637,Housing
144159,3797,140362,2.6338972939601413,97.36610270603985,Healthcare
14829,2187,12642,14.748128666801538,85.25187133319847,Housing
29457,5699,23758,19.346844553077368,80.65315544692263,Housing
29854,1937,27917,6.488242781536813,93.51175721846319,Housing
148244,55294,92950,37.29931734167993,62.70068265832006,Healthcare
45108,14120,30988,31.30265141438326,68.69734858561675,Food
213466,33453,180013,15.671348130381418,84.32865186961858,Entertainment
219046,3349,215697,1.5289026049322973,98.4710973950677,Entertainment
136803,67996,68807,49.70358837160004,50.29641162839996,Healthcare
244378,22027,222351,9.013495486500421,90.98650451349958,Entertainment
56095,503,55592,0.8966931099028433,99.10330689009716,Food
99171,52218,46953,52.65450585352573,47.34549414647427,Transportation
105755,39175,66580,37.04316580776323,62.95683419223678,Transportation
111621,49628,61993,44.46116770141819,55.53883229858181,Transportation
192931,36376,156555,18.854409089259892,81.14559091074011,Entertainment
236534,22006,214528,9.303525074619294,90.69647492538071,Entertainment
63520,19344,44176,30.45340050377834,69.54659949622166,Transportation
117839,32623,85216,27.68438292925093,72.31561707074907,Transportation
49373,21463,27910,43.47112794442307,56.52887205557694,Food
140625,67398,73227,47.92746666666667,52.07253333333334,Healthcare
27348,3837,23511,14.030276437033788,85.96972356296621,Housing
47291,13515,33776,28.578376435262527,71.42162356473747,Food
133240,65159,68081,48.903482437706394,51.096517562293606,Healthcare
32895,10541,22354,32.04438364493084,67.95561635506915,Food
210292,11611,198681,5.521370285127347,94.47862971487265,Entertainment
17298,2800,14498,16.186842409527113,83.81315759047288,Housing
74682,4834,69848,6.472777911678852,93.52722208832115,Transportation
136796,14873,121923,10.872393929647066,89.12760607035294,Healthcare
244313,46559,197754,19.057111164776334,80.94288883522367,Entertainment
201586,28079,173507,13.929042691456747,86.07095730854326,Entertainment
189320,36738,152582,19.405239805620113,80.59476019437989,Entertainment
86264,24073,62191,27.906194936474076,72.09380506352592,Transportation
140604,65625,74979,46.673636596398396,53.326363403601604,Healthcare
27036,8638,18398,31.949992602455985,68.05000739754401,Housing
209544,65266,144278,31.14668041079678,68.85331958920322,Entertainment
39182,16739,22443,42.72114746567301,57.27885253432699,Food
213526,33207,180319,15.551736088345214,84.44826391165479,Entertainment
148073,44277,103796,29.902142861966734,70.09785713803328,Healthcare
10001,508,9493,5.07949205079492,94.92050794920507,Housing
64257,5046,59211,7.852840935617909,92.1471590643821,Transportation
23044,10223,12821,44.362957819822945,55.637042180177055,Housing
126991,37103,89888,29.217031128190186,70.78296887180981,Healthcare
41956,23505,18451,56.02297645152065,43.97702354847936,Food
24942,2434,22508,9.758640044904178,90.24135995509582,Housing
177228,12545,164683,7.078452614710994,92.921547385289,Healthcare
142257,67703,74554,47.59203413540283,52.40796586459717,Healthcare
81377,394,80983,0.4841662877717291,99.51583371222827,Transportation
136552,45253,91299,33.13975628332064,66.86024371667936,Healthcare
215848,31523,184325,14.604258552314592,85.39574144768541,Entertainment
78631,45723,32908,58.1488217115387,41.85117828846129,Transportation
187714,36302,151412,19.338994427693194,80.6610055723068,Entertainment
60132,24708,35424,41.08960287367791,58.91039712632209,Transportation
137557,17659,119898,12.837587327435172,87.16241267256483,Healthcare
183684,7762,175922,4.225735502275647,95.77426449772435,Entertainment
78197,20262,57935,25.911479980050384,74.08852001994961,Transportation
148698,47966,100732,32.25732693109524,67.74267306890476,Healthcare
99327,2216,97111,2.231014729127025,97.76898527087297,Transportation
81212,7383,73829,9.091021031374675,90.90897896862533,Transportation
145550,4924,140626,3.383029886636894,96.61697011336311,Healthcare
46701,6339,40362,13.573585148069633,86.42641485193036,Food
17182,9726,7456,56.60575020370155,43.39424979629845,Housing
17631,932,16699,5.286143724122285,94.71385627587772,Housing
48144,17278,30866,35.88816882685278,64.11183117314722,Food
132668,61839,70829,46.6118430970543,53.388156902945695,Healthcare
110563,6420,104143,5.806644175718821,94.19335582428118,Transportation
158706,23120,135586,14.567817221781155,85.43218277821884,Healthcare
103864,5833,98031,5.61599784333359,94.38400215666641,Transportation
124491,31907,92584,25.6299652183692,74.3700347816308,Healthcare
96441,3042,93399,3.1542601175848444,96.84573988241516,Transportation
209190,53030,156160,25.350160141498158,74.64983985850185,Entertainment
226326,27651,198675,12.217332520346757,87.78266747965324,Entertainment
100300,42993,57307,42.86440677966102,57.13559322033899,Transportation
37429,16039,21390,42.85179940687702,57.14820059312298,Food
22366,12105,10261,54.12232853438255,45.87767146561745,Housing
40903,8783,32120,21.47275260983302,78.52724739016698,Food
86208,1553,84655,1.8014569413511508,98.19854305864885,Transportation
88691,19508,69183,21.99546740932,78.00453259068,Transportation
205122,66479,138643,32.409492887159836,67.59050711284016,Entertainment
190675,34121,156554,17.894847253179496,82.10515274682051,Entertainment
28166,11028,17138,39.153589434069445,60.846410565930555,Housing
168537,15201,153336,9.019384467505652,90.98061553249434,Healthcare
244749,54881,189868,22.423380687970123,77.57661931202988,Entertainment
67549,21656,45893,32.05969000281277,67.94030999718723,Transportation
10419,2562,7857,24.58969190901238,75.41030809098763,Housing
202957,28732,174225,14.156693289711614,85.84330671028837,Entertainment
207411,13420,193991,6.470245068969341,93.52975493103067,Entertainment
69192,27473,41719,39.70545727829807,60.29454272170193,Transportation
112698,56611,56087,50.23247972457364,49.767520275426364,Transportation
50063,8540,41523,17.058506282084572,82.94149371791542,Food
104139,54990,49149,52.80442485524155,47.19557514475845,Transportation
53433,7924,45509,14.829786835850504,85.1702131641495,Food
39965,15788,24177,39.504566495683726,60.495433504316274,Food
163968,67463,96505,41.14400370804059,58.855996291959414,Healthcare
124186,54021,70165,43.50007247193726,56.49992752806274,Healthcare
54646,23627,31019,43.236467445009694,56.763532554990306,Food
94596,34474,60122,36.443401412321876,63.556598587678124,Transportation
105948,30319,75629,28.616868652546536,71.38313134745347,Transportation
17480,10338,7142,59.141876430205954,40.85812356979405,Housing
104876,46166,58710,44.019604103894125,55.980395896105875,Transportation
24398,14367,10031,58.88597426018526,41.11402573981474,Housing
33018,2359,30659,7.144587800593616,92.85541219940639,Food
37172,3287,33885,8.842677283977189,91.15732271602282,Food
47469,16645,30824,35.064989782805625,64.93501021719437,Food
60529,33467,27062,55.29085231872326,44.70914768127675,Transportation
193898,1289,192609,0.6647825145179425,99.33521748548205,Entertainment
136809,12223,124586,8.934353734037966,91.06564626596203,Healthcare
19341,10308,9033,53.29610671630216,46.703893283697845,Housing
132069,12614,119455,9.551068002332114,90.44893199766788,Healthcare
152049,61801,90248,40.64544982209682,59.35455017790318,Healthcare
22286,9069,13217,40.693709055012114,59.306290944987886,Housing
88479,24916,63563,28.16035443438556,71.83964556561445,Transportation
140626,55011,85615,39.11865515623,60.88134484377,Healthcare
23050,1047,22003,4.542299349240781,95.45770065075921,Housing
36800,5627,31173,15.290760869565217,84.70923913043478,Food
30570,4086,26484,13.366045142296368,86.63395485770363,Food
198349,6190,192159,3.120761889396972,96.87923811060303,Entertainment
215066,48467,166599,22.535872708842867,77.46412729115714,Entertainment
18634,7991,10643,42.88397552860363,57.11602447139638,Housing
157846,32432,125414,20.54660871989154,79.45339128010846,Healthcare
201748,6535,195213,3.2391894839106214,96.76081051608938,Entertainment
51032,6418,44614,12.576422636776924,87.42357736322307,Food
194447,49081,145366,25.24132539972332,74.75867460027669,Entertainment
43830,20196,23634,46.078028747433265,53.921971252566735,Food
96573,30647,65926,31.734542781108594,68.26545721889141,Transportation
66173,36765,29408,55.55891375636589,44.44108624363411,Transportation
111223,15278,95945,13.736367477949704,86.26363252205029,Transportation
131719,31703,100016,24.068661316894296,75.9313386831057,Healthcare
18245,975,17270,5.34392984379282,94.65607015620718,Housing
37134,6446,30688,17.358754779985997,82.641245220014,Food
96931,43345,53586,44.71737627797093,55.282623722029065,Transportation
244016,17638,226378,7.228214543308635,92.77178545669138,Entertainment
67635,36532,31103,54.013454572336805,45.986545427663195,Transportation
71648,30076,41572,41.97744528807503,58.02255471192497,Transportation
57207,12318,44889,21.532329959620323,78.46767004037967,Food
113417,15167,98250,13.372774804482573,86.62722519551743,Transportation
84714,45627,39087,53.860046745520215,46.13995325447978,Transportation
32462,5575,26887,17.173926437064875,82.82607356293512,Food
162628,58634,103994,36.05406203113855,63.94593796886146,Healthcare
29502,6368,23134,21.584977289675276,78.41502271032472,Housing
14308,8564,5744,59.85462678221973,40.14537321778026,Housing
170826,39682,131144,23.229484973013477,76.77051502698652,Healthcare
195629,37498,158131,19.16791477746142,80.83208522253858,Entertainment
89039,42070,46969,47.24895832163434,52.75104167836566,Transportation
245116,21904,223212,8.936177156937939,91.06382284306206,Entertainment
39816,1386,38430,3.481012658227848,96.51898734177216,Food
69888,22122,47766,31.653502747252748,68.34649725274726,Transportation
224884,11649,213235,5.180003913128546,94.81999608687146,Entertainment
208148,65632,142516,31.531410342640815,68.46858965735919,Entertainment
38789,11456,27333,29.534146278584135,70.46585372141585,Food
128155,61985,66170,48.36721157972767,51.63278842027233,Healthcare
174603,4703,169900,2.6935390571754207,97.30646094282459,Healthcare
57205,27785,29420,48.570929114587884,51.42907088541211,Food
170027,14794,155233,8.700971022249407,91.2990289777506,Healthcare
61808,7238,54570,11.71045819311416,88.28954180688584,Transportation
80185,31922,48263,39.81043836128952,60.18956163871049,Transportation
140579,53939,86640,38.36917320510176,61.63082679489824,Healthcare
179672,8025,171647,4.466472238300904,95.5335277616991,Healthcare
36084,9034,27050,25.036027047999116,74.96397295200089,Food
147052,62323,84729,42.3816065065419,57.6183934934581,Healthcare
56903,21106,35797,37.091190271163214,62.908809728836786,Food
65427,24096,41331,36.82883213352286,63.17116786647714,Transportation
224188,11474,212714,5.118025942512534,94.88197405748747,Entertainment
39291,8857,30434,22.542057977653915,77.45794202234609,Food
165121,21089,144032,12.771846100738246,87.22815389926176,Healthcare
54622,29672,24950,54.32243418402841,45.67756581597159,Food
13795,4423,9372,32.06234142805364,67.93765857194636,Housing
92731,22199,70532,23.939135779836302,76.06086422016371,Transportation
39393,16145,23248,40.984438859695885,59.015561140304115,Food
210915,7105,203810,3.368655619562383,96.63134438043761,Entertainment
149410,49994,99416,33.460946389130584,66.53905361086942,Healthcare
12483,106,12377,0.8491548505968116,99.15084514940318,Housing
104756,36057,68699,34.41998549009126,65.58001450990874,Transportation
33737,11806,21931,34.99421999585025,65.00578000414976,Food
120764,40080,80684,33.18869861879368,66.81130138120632,Healthcare
51232,20921,30311,40.8358057464085,59.1641942535915,Food
25851,12779,13072,49.43329078178794,50.56670921821206,Housing
97368,43731,53637,44.91311313778654,55.08688686221346,Transportation
127172,66537,60635,52.32047935080048,47.67952064919951,Healthcare
17453,2043,15410,11.70572394430757,88.29427605569244,Housing
22739,8593,14146,37.7897005145345,62.210299485465505,Housing
26144,6902,19242,26.399938800489597,73.6000611995104,Housing
216423,57456,158967,26.548010146795857,73.45198985320415,Entertainment
21103,8992,12111,42.61005544235417,57.38994455764583,Housing
248388,23524,224864,9.470666859912717,90.52933314008729,Entertainment
10170,1657,8513,16.293018682399214,83.70698131760078,Housing
50377,24294,26083,48.22438811362328,51.775611886376716,Food
91852,6558,85294,7.139746548795889,92.86025345120412,Transportation
195310,45291,150019,23.189288822896934,76.81071117710306,Entertainment
249470,4595,244875,1.841904838257105,98.15809516174289,Entertainment
223961,22661,201300,10.118279521881043,89.88172047811895,Entertainment
73804,25327,48477,34.31656820768522,65.68343179231478,Transportation
14035,3981,10054,28.36480228001425,71.63519771998575,Housing
231684,40214,191470,17.35726247820307,82.64273752179693,Entertainment
65598,37095,28503,56.548980151833895,43.4510198481661,Transportation
247815,50885,196930,20.533462461917157,79.46653753808285,Entertainment
10624,321,10303,3.021460843373494,96.97853915662651,Housing
95208,54472,40736,57.21367952272918,42.78632047727082,Transportation
178603,27876,150727,15.607800540864375,84.39219945913563,Healthcare
179969,17166,162803,9.538309375503559,90.46169062449644,Healthcare
140224,52954,87270,37.7638635326335,62.2361364673665,Healthcare
178274,55930,122344,31.373054960341946,68.62694503965805,Healthcare
97142,15038,82104,15.480430709682732,84.51956929031726,Transportation
170410,55275,115135,32.436476732586115,67.56352326741388,Healthcare
238832,14433,224399,6.043160045555034,93.95683995444497,Entertainment
18851,3065,15786,16.25908439870564,83.74091560129436,Housing
102040,34574,67466,33.8827910623285,66.1172089376715,Transportation
100531,58931,41600,58.61972923774756,41.380270762252444,Transportation
72313,29139,43174,40.295659148424214,59.704340851575786,Transportation
15664,942,14722,6.0137895812053115,93.98621041879468,Housing
38065,20087,17978,52.77026139498226,47.22973860501774,Food
64493,35769,28724,55.46183306715457,44.53816693284543,Transportation
40867,20302,20565,49.67822448430274,50.32177551569726,Food
46182,1634,44548,3.5381750465549344,96.46182495344506,Food
52395,17467,34928,33.33715049145911,66.66284950854089,Food
85110,17473,67637,20.52990247914464,79.47009752085536,Transportation
122559,55221,67338,45.056666585073316,54.943333414926684,Healthcare
149941,29855,120086,19.91116505825625,80.08883494174374,Healthcare
147703,11967,135736,8.102069693912785,91.89793030608722,Healthcare
24446,2076,22370,8.49218686083613,91.50781313916387,Housing
17853,4386,13467,24.567299613510336,75.43270038648967,Housing
36656,14937,21719,40.7491270187691,59.250872981230906,Food
68950,37777,31173,54.78897751994198,45.21102248005801,Transportation
24285,9702,14583,39.95058678196418,60.04941321803583,Housing
109770,30341,79429,27.64052108955088,72.35947891044911,Transportation
231984,10705,221279,4.614542382233258,95.38545761776675,Entertainment
121347,33970,87377,27.994099565708257,72.00590043429173,Healthcare
129265,41660,87605,32.22836808107376,67.77163191892623,Healthcare
245744,64682,181062,26.320886776482844,73.67911322351716,Entertainment
83756,48257,35499,57.61617078179474,42.383829218205264,Transportation
210645,667,209978,0.31664649054095756,99.68335350945904,Entertainment
159842,20483,139359,12.814529347730886,87.18547065226912,Healthcare
52696,727,51969,1.3796113557006224,98.62038864429937,Food
96025,27216,68809,28.342619109606876,71.65738089039313,Transportation
160630,23270,137360,14.486708584946772,85.51329141505323,Healthcare
52176,11050,41126,21.17831953388531,78.82168046611469,Food
94800,7989,86811,8.427215189873417,91.57278481012658,Transportation
123078,13441,109637,10.920716943726742,89.07928305627325,Healthcare
191695,49140,142555,25.634471425963117,74.36552857403687,Entertainment
22059,11439,10620,51.856385148918804,48.14361485108119,Housing
99227,16028,83199,16.152861620325112,83.84713837967489,Transportation
26100,2888,23212,11.065134099616857,88.93486590038314,Housing
40602,3823,36779,9.415792325501208,90.5842076744988,Food
86389,27898,58491,32.29346328815011,67.70653671184988,Transportation
65619,23978,41641,36.54124567579512,63.45875432420488,Transportation
154968,6834,148134,4.409942697847297,95.5900573021527,Healthcare
136502,65085,71417,47.68062006417488,52.31937993582512,Healthcare
162415,45323,117092,27.905673737031677,72.09432626296832,Healthcare
207166,56239,150927,27.146829112885317,72.85317088711469,Entertainment
28902,87,28815,0.3010172306414781,99.69898276935852,Housing
15846,2848,12998,17.972990029029408,82.02700997097058,Housing
20462,9619,10843,47.00909002052585,52.99090997947415,Housing
134734,22565,112169,16.74781421170603,83.25218578829397,Healthcare
49027,2914,46113,5.943663695514716,94.05633630448528,Food
23285,667,22618,2.8645050461670603,97.13549495383293,Housing
75735,30065,45670,39.697629893708324,60.30237010629167,Transportation
152990,52876,100114,34.56173606118047,65.43826393881953,Healthcare
41672,20343,21329,48.81695143021693,51.18304856978306,Food
33194,10092,23102,30.403084894860516,69.59691510513947,Food
10005,860,9145,8.595702148925536,91.40429785107446,Housing
96543,16069,80474,16.64439679728204,83.35560320271796,Transportation
12887,5124,7763,39.76099945681695,60.23900054318305,Housing
152841,46821,106020,30.633795905548904,69.3662040944511,Healthcare
104193,909,103284,0.8724194523624428,99.12758054763756,Transportation
25134,4159,20975,16.547306437495028,83.45269356250498,Housing
223293,12538,210755,5.615043910915255,94.38495608908475,Entertainment
54921,18006,36915,32.78527339269132,67.21472660730868,Food
43859,127,43732,0.28956428555142616,99.71043571444858,Food
207155,64199,142956,30.990803987352468,69.00919601264754,Entertainment
137572,52849,84723,38.415520600122115,61.58447939987788,Healthcare
55219,9035,46184,16.362121733461308,83.63787826653869,Food
25227,14528,10699,57.58909105323661,42.410908946763385,Housing
20080,9449,10631,47.05677290836653,52.943227091633474,Housing
221179,36554,184625,16.526885463809858,83.47311453619014,Entertainment
65081,24947,40134,38.33223214148523,61.66776785851478,Transportation
29325,7518,21807,25.636828644501282,74.36317135549872,Housing
197155,58481,138674,29.66244832745809,70.3375516725419,Entertainment
10037,2819,7218,28.086081498455712,71.91391850154429,Housing
26112,8013,18099,30.68704044117647,69.31295955882352,Housing
55133,1459,53674,2.6463279705439575,97.35367202945604,Food
195797,68231,127566,34.847827086216846,65.15217291378316,Entertainment
26906,1700,25206,6.318293317475655,93.68170668252435,Housing
31244,8038,23206,25.72653949558315,74.27346050441685,Food
14328,3243,11085,22.634003350083752,77.36599664991624,Housing
33152,19099,14053,57.61040057915058,42.38959942084942,Food
227276,34504,192772,15.181541385804046,84.81845861419596,Entertainment
146742,60036,86706,40.91262215316679,59.08737784683322,Healthcare
236556,34010,202546,14.377145369383992,85.622854630616,Entertainment
161457,46533,114924,28.820676712685113,71.17932328731489,Healthcare
74252,33350,40902,44.91461509454291,55.08538490545709,Transportation
125341,41588,83753,33.179885272975326,66.82011472702469,Healthcare
194153,23998,170155,12.360354977775259,87.63964502222474,Entertainment
169976,10152,159824,5.972607897585541,94.02739210241445,Healthcare
96392,27091,69301,28.10502946302598,71.89497053697403,Transportation
194730,60481,134249,31.058902069532174,68.94109793046783,Entertainment
156069,14052,142017,9.003709897545315,90.99629010245468,Healthcare
80517,45872,34645,56.971819615733324,43.028180384266676,Transportation
10126,2566,7560,25.34070709065771,74.65929290934228,Housing
57136,34137,22999,59.74691963035564,40.25308036964436,Food
117534,22476,95058,19.12297718107101,80.87702281892899,Transportation
202871,31236,171635,15.396976403724535,84.60302359627546,Entertainment
45990,17468,28522,37.98217003696456,62.01782996303544,Food
13799,4203,9596,30.458728893398074,69.54127110660193,Housing
178764,13545,165219,7.577028931999731,92.42297106800027,Healthcare
23910,5264,18646,22.01589293182769,77.98410706817232,Housing
31630,3452,28178,10.913689535251343,89.08631046474865,Food
218159,3772,214387,1.7290141593975037,98.27098584060249,Entertainment
242653,64930,177723,26.758375128269584,73.24162487173041,Entertainment
180169,58265,121904,32.33908164001576,67.66091835998424,Entertainment
82161,26794,55367,32.61157970326554,67.38842029673447,Transportation
72372,31102,41270,42.975183772729785,57.024816227270215,Transportation
11768,38,11730,0.3229095853161115,99.67709041468389,Housing
162771,58002,104769,35.63411172751903,64.36588827248097,Healthcare
239395,21605,217790,9.024833434282254,90.97516656571774,Entertainment
56216,13470,42746,23.961149850576348,76.03885014942365,Food
94525,3965,90560,4.194657498016398,95.8053425019836,Transportation
241031,30117,210914,12.49507324783949,87.5049267521605,Entertainment
87199,38846,48353,44.5486760169268,55.451323983073195,Transportation
169823,40981,128842,24.131595838019585,75.86840416198042,Healthcare
63739,32961,30778,51.71245234471831,48.28754765528169,Transportation
186773,54858,131915,29.371483030202437,70.62851696979756,Entertainment
25710,12637,13073,49.15208090237262,50.84791909762738,Housing
43511,21804,21707,50.111466066052266,49.888533933947734,Food
117489,49587,67902,42.205653295202104,57.794346704797896,Transportation
81277,24447,56830,30.078620027806146,69.92137997219385,Transportation
57829,20155,37674,34.85275553787892,65.14724446212108,Food
56759,1919,54840,3.3809616096125725,96.61903839038743,Food
21515,5660,15855,26.307227515686733,73.69277248431328,Housing
186443,56386,130057,30.243023336891167,69.75697666310883,Entertainment
42256,21672,20584,51.28739113971981,48.7126088602802,Food
230522,66624,163898,28.901362993553757,71.09863700644624,Entertainment
109976,846,109130,0.769258747363061,99.23074125263693,Transportation
215745,19660,196085,9.112609793969732,90.88739020603028,Entertainment
61647,32576,29071,52.842798514120716,47.15720148587928,Transportation
17104,6617,10487,38.68685687558466,61.31314312441533,Housing
171902,26161,145741,15.218554757943478,84.78144524205652,Healthcare
120947,34782,86165,28.758051047152883,71.24194895284711,Healthcare
78166,34584,43582,44.244300591049814,55.755699408950186,Transportation
29768,9244,20524,31.053480247245364,68.94651975275463,Housing
48676,15022,33654,30.861204700468402,69.1387952995316,Food
55181,1728,53453,3.131512658342545,96.86848734165746,Food
150304,16014,134290,10.654407068341493,89.3455929316585,Healthcare
139149,62107,77042,44.63345047395238,55.36654952604761,Healthcare
30509,5407,25102,17.722639221213413,82.27736077878659,Food
87810,42188,45622,48.04464184033709,51.955358159662914,Transportation
91260,25764,65496,28.231426692965155,71.76857330703484,Transportation
56193,32740,23453,58.26348477568381,41.73651522431619,Food
231206,49546,181660,21.429374670207523,78.57062532979248,Entertainment
223013,48422,174591,21.71263558626627,78.28736441373373,Entertainment
204243,23354,180889,11.434418805050846,88.56558119494915,Entertainment
19848,10232,9616,51.55179363160016,48.44820636839984,Housing
107722,19103,88619,17.73361059022298,82.26638940977702,Transportation
63073,16327,46746,25.88587826803862,74.11412173196138,Transportation
146119,66676,79443,45.63130051533339,54.36869948466661,Healthcare
219006,58458,160548,26.692419385770254,73.30758061422975,Entertainment
236495,60220,176275,25.463540455400747,74.53645954459925,Entertainment
23166,5324,17842,22.981956315289647,77.01804368471035,Housing
74587,18121,56466,24.295118452277205,75.70488154772279,Transportation
43808,14713,29095,33.58518991964938,66.41481008035062,Food
124502,16622,107880,13.350789545549468,86.64921045445053,Healthcare
73484,38735,34749,52.71215502694464,47.28784497305536,Transportation
29797,8736,21061,29.31838775715676,70.68161224284324,Housing
55322,13715,41607,24.791222298543076,75.20877770145692,Food
218352,10564,207788,4.838059646808823,95.16194035319117,Entertainment
24798,7101,17697,28.635373820469397,71.3646261795306,Housing
23337,8054,15283,34.511719586922055,65.48828041307794,Housing
59708,19861,39847,33.26354927312923,66.73645072687077,Food
181004,12474,168530,6.891560407504807,93.1084395924952,Entertainment
22084,7298,14786,33.04654953812715,66.95345046187285,Housing
240000,4856,235144,2.0233333333333334,97.97666666666667,Entertainment
132218,36375,95843,27.511382716422876,72.48861728357713,Healthcare
120141,34084,86057,28.369998584995965,71.63000141500405,Healthcare
51123,4569,46554,8.937268939616219,91.06273106038378,Food
16427,8627,7800,52.51719729713277,47.48280270286723,Housing
52743,3415,49328,6.474792863507954,93.52520713649206,Food
96089,1886,94203,1.9627636878310732,98.03723631216893,Transportation
196219,66534,129685,33.90803133233785,66.09196866766214,Entertainment
184944,41570,143374,22.477074141361708,77.52292585863829,Entertainment
131639,50952,80687,38.70585464793868,61.29414535206132,Healthcare
26257,2468,23789,9.399398255703241,90.60060174429677,Housing
155005,41922,113083,27.045579174865324,72.95442082513468,Healthcare
11326,3121,8205,27.556065689563837,72.44393431043616,Housing
159690,29335,130355,18.369966810695722,81.63003318930427,Healthcare
55616,30453,25163,54.75582566168009,45.24417433831991,Food
223540,8870,214670,3.967969938266082,96.03203006173392,Entertainment
33087,1639,31448,4.953607156889412,95.04639284311058,Food
109793,51499,58294,46.90554042607452,53.09445957392548,Transportation
180565,61636,118929,34.135076011408636,65.86492398859136,Entertainment
89253,11189,78064,12.53627329053365,87.46372670946634,Transportation
14591,3665,10926,25.118223562470014,74.88177643752998,Housing
30190,15914,14276,52.71281881417688,47.287181185823115,Food
92724,6512,86212,7.022992968379276,92.97700703162073,Transportation
96845,32387,64458,33.44209819815169,66.55790180184832,Transportation
61414,36215,25199,58.96863907252418,41.031360927475816,Transportation
28942,14625,14317,50.53209868011885,49.46790131988114,Housing
80052,18348,61704,22.920101933743066,77.07989806625693,Transportation
79652,4552,75100,5.714859639431527,94.28514036056848,Transportation
132319,17510,114809,13.233171351053135,86.76682864894686,Healthcare
249448,36681,212767,14.704868349315289,85.29513165068471,Entertainment
81942,47872,34070,58.421810548924846,41.57818945107515,Transportation
203856,19288,184568,9.461580723648066,90.53841927635193,Entertainment
14669,4392,10277,29.94069125366419,70.05930874633582,Housing
70748,21192,49556,29.954203652400068,70.04579634759993,Transportation
23786,13155,10631,55.30564197427058,44.69435802572942,Housing
39789,226,39563,0.567996179848702,99.4320038201513,Food
26459,10737,15722,40.57976491930912,59.42023508069087,Housing
128123,23940,104183,18.685169719722456,81.31483028027755,Healthcare
139137,24460,114677,17.579795453402042,82.42020454659796,Healthcare
55538,10245,45293,18.446829198026578,81.55317080197342,Food
29896,1359,28537,4.545758629917046,95.45424137008295,Housing
169493,56028,113465,33.05623241077802,66.94376758922196,Healthcare
23235,2142,21093,9.21885087153002,90.78114912846999,Housing
114159,1167,112992,1.0222584290331906,98.9777415709668,Transportation
46184,8066,38118,17.464922917027543,82.53507708297246,Food
39165,11242,27923,28.70420017873101,71.29579982126899,Food
26959,16166,10793,59.96513223784265,40.03486776215735,Housing
142228,27500,114728,19.335152009449615,80.66484799055038,Healthcare
24805,14254,10551,57.46422092320097,42.53577907679904,Housing
24384,12622,11762,51.76345144356955,48.23654855643045,Housing
36597,21252,15345,58.07033363390441,41.92966636609558,Food
108450,52445,56005,48.358690640848316,51.64130935915169,Transportation
97589,53879,43710,55.21011589420939,44.78988410579061,Transportation
69107,37121,31986,53.71525315814606,46.28474684185394,Transportation
206359,13764,192595,6.669929588726443,93.33007041127355,Entertainment
125281,58281,67000,46.52022253973069,53.47977746026932,Healthcare
244093,24121,219972,9.881889279905609,90.11811072009439,Entertainment
99621,5712,93909,5.733730839883157,94.26626916011685,Transportation
162710,18369,144341,11.289410607829883,88.7105893921701,Healthcare
14016,1165,12851,8.311929223744292,91.6880707762557,Housing
169917,60717,109200,35.733328625152275,64.26667137484772,Healthcare
68360,17179,51181,25.13019309537741,74.86980690462258,Transportation
215151,17352,197799,8.065033395150383,91.93496660484962,Entertainment
22375,2047,20328,9.148603351955307,90.8513966480447,Housing
72010,39942,32068,55.467296208859885,44.53270379114012,Transportation
233439,14051,219388,6.0191313362377326,93.98086866376227,Entertainment
51903,20001,31902,38.53534477775851,61.46465522224149,Food
58688,22864,35824,38.95856052344602,61.04143947655398,Food
211162,57850,153312,27.39602769437683,72.60397230562316,Entertainment
91949,24505,67444,26.65064329138979,73.3493567086102,Transportation
35487,20559,14928,57.93389128413222,42.066108715867784,Food
156866,4869,151997,3.103923093595808,96.89607690640419,Healthcare
29432,14688,14744,49.90486545256863,50.095134547431364,Housing
100263,17202,83061,17.156877412405375,82.84312258759464,Transportation
31804,15218,16586,47.84932712866306,52.15067287133694,Food
22768,10225,12543,44.909522136331695,55.090477863668305,Housing
140572,42113,98459,29.958313177588707,70.0416868224113,Healthcare
153530,65740,87790,42.818993030678044,57.181006969321956,Healthcare
151276,32328,118948,21.370210740633013,78.62978925936699,Healthcare
29262,13329,15933,45.55054336682387,54.449456633176126,Housing
134933,17335,117598,12.847116717185566,87.15288328281443,Healthcare
90838,5400,85438,5.944648715295361,94.05535128470464,Transportation
188802,22318,166484,11.820849355409372,88.17915064459064,Entertainment
162362,69321,93041,42.695335115359505,57.3046648846405,Healthcare
34562,1470,33092,4.2532260864533304,95.74677391354666,Food
20485,2344,18141,11.442518916280205,88.5574810837198,Housing
139188,56275,82913,40.43092795355921,59.56907204644079,Healthcare
14821,4200,10621,28.33816881451994,71.66183118548007,Housing
122086,52648,69438,43.12369968710581,56.87630031289419,Healthcare
159414,4711,154703,2.9551984141919783,97.04480158580803,Healthcare
81711,13210,68501,16.166733977065512,83.8332660229345,Transportation
80195,24360,55835,30.37595860091028,69.62404139908972,Transportation
13892,2174,11718,15.649294558019003,84.350705441981,Housing
85068,32726,52342,38.47040015046786,61.52959984953213,Transportation
129889,5324,124565,4.098884432092017,95.90111556790798,Healthcare
201457,68318,133139,33.91195143380473,66.08804856619527,Entertainment
179738,52134,127604,29.005552526455176,70.99444747354482,Healthcare
16034,1307,14727,8.151428215043035,91.84857178495697,Housing
140459,46752,93707,33.28515794644701,66.71484205355299,Healthcare
15074,2444,12630,16.21334748573703,83.78665251426297,Housing
58327,16107,42220,27.614998199804553,72.38500180019545,Food
188003,34926,153077,18.57736312718414,81.42263687281586,Entertainment
70765,15114,55651,21.358015968345935,78.64198403165406,Transportation
204553,2240,202313,1.0950707151691739,98.90492928483083,Entertainment
212429,17855,194574,8.405161253877766,91.59483874612224,Entertainment
33948,17642,16306,51.967715329327206,48.032284670672794,Food
248337,65829,182508,26.507930755384816,73.49206924461518,Entertainment
40806,3503,37303,8.584521884036661,91.41547811596334,Food
127354,21599,105755,16.959812805251502,83.0401871947485,Healthcare
47140,12918,34222,27.403478998727195,72.5965210012728,Food
196342,46816,149526,23.84410874901957,76.15589125098043,Entertainment
152169,69351,82818,45.57498570668139,54.42501429331861,Healthcare
38588,7743,30845,20.065823572094953,79.93417642790504,Food
170308,36473,133835,21.4159053009841,78.5840946990159,Healthcare
41793,16445,25348,39.348694757495274,60.651305242504726,Food
91921,44015,47906,47.883508665049334,52.116491334950666,Transportation
13997,5418,8579,38.70829463456455,61.291705365435455,Housing
173547,51863,121684,29.88412360916639,70.1158763908336,Healthcare
104516,18245,86271,17.456657353897967,82.54334264610203,Transportation
102308,32750,69558,32.01118192125738,67.98881807874263,Transportation
189475,52709,136766,27.818445705238158,72.18155429476184,Entertainment
30444,11073,19371,36.37169885691762,63.628301143082375,Food
33692,13894,19798,41.23827614864063,58.76172385135937,Food
62445,4256,58189,6.815597725998879,93.18440227400112,Transportation
33347,8178,25169,24.523945182475185,75.47605481752481,Food
248941,69645,179296,27.976508489963486,72.02349151003652,Entertainment
25566,4486,21080,17.54674176640851,82.45325823359148,Housing
30483,13780,16703,45.205524390643966,54.79447560935603,Food
74015,43907,30108,59.321759102884556,40.678240897115444,Transportation
158099,75,158024,0.04743863022536512,99.95256136977464,Healthcare
206581,2208,204373,1.0688301441081223,98.93116985589188,Entertainment
223290,49515,173775,22.17519817277979,77.8248018272202,Entertainment
158220,15828,142392,10.003792188092529,89.99620781190747,Healthcare
113631,21776,91855,19.163784530629847,80.83621546937016,Transportation
78502,335,78167,0.4267407199816565,99.57325928001835,Transportation
223579,39592,183987,17.70828208373774,82.29171791626226,Entertainment
26431,9032,17399,34.171995005864325,65.82800499413567,Housing
224779,27153,197626,12.079865111954408,87.92013488804558,Entertainment
177795,38921,138874,21.890941815011672,78.10905818498833,Healthcare
149966,45165,104801,30.11682648066895,69.88317351933104,Healthcare
120951,32954,87997,27.24574414432291,72.7542558556771,Healthcare
128744,35437,93307,27.52516622133847,72.47483377866153,Healthcare
144312,53410,90902,37.01008925106713,62.989910748932864,Healthcare
27871,4954,22917,17.774747945893584,82.22525205410642,Housing
226327,48363,177964,21.36863918136148,78.63136081863851,Entertainment
159105,30492,128613,19.164702554916566,80.83529744508343,Healthcare
21280,9575,11705,44.9953007518797,55.0046992481203,Housing
69029,33757,35272,48.90263512436802,51.09736487563198,Transportation
23139,9986,13153,43.15657547862916,56.84342452137084,Housing
78469,16387,62082,20.883406185882322,79.11659381411768,Transportation
135057,22398,112659,16.584108931784357,83.41589106821564,Healthcare
212263,58920,153343,27.758017176804245,72.24198282319576,Entertainment
152380,763,151617,0.500721879511747,99.49927812048826,Healthcare
35685,7653,28032,21.44598570828079,78.55401429171921,Food
12603,6882,5721,54.60604617948107,45.393953820518924,Housing
59986,14804,45182,24.679091788083888,75.32090821191612,Food
130400,36838,93562,28.249999999999996,71.75,Healthcare
55018,19059,35959,34.641390090515834,65.35860990948417,Food
15084,2362,12722,15.658976398833202,84.3410236011668,Housing
31462,7520,23942,23.901849850613438,76.09815014938656,Food
232751,33091,199660,14.21733956030264,85.78266043969735,Entertainment
11339,5562,5777,49.051944615927326,50.94805538407267,Housing
224694,8567,216127,3.8127408831566485,96.18725911684335,Entertainment
160827,54210,106617,33.70702680520062,66.29297319479937,Healthcare
89168,12926,76242,14.496231832047371,85.50376816795263,Transportation
165917,60143,105774,36.24884731522388,63.75115268477612,Healthcare
243256,55637,187619,22.87178939060085,77.12821060939915,Entertainment
156535,7023,149512,4.486536557319449,95.51346344268055,Healthcare
48416,3378,45038,6.977032385988104,93.0229676140119,Food
125062,33132,91930,26.492459739968975,73.50754026003102,Healthcare
229425,62307,167118,27.157894736842103,72.84210526315789,Entertainment
236550,43173,193377,18.251109701965756,81.74889029803424,Entertainment
115987,3478,112509,2.9986119134040883,97.00138808659591,Transportation
194797,10858,183939,5.5740078132620114,94.42599218673799,Entertainment
37384,11554,25830,30.90627006205863,69.09372993794136,Food
41306,22719,18587,55.00169466905535,44.99830533094465,Food
24948,8624,16324,34.5679012345679,65.4320987654321,Housing
14507,117,14390,0.8065072034190391,99.19349279658095,Housing
137121,40687,96434,29.672333194769585,70.32766680523042,Healthcare
10909,6129,4780,56.18296819140159,43.81703180859841,Housing
72540,1714,70826,2.362834298318169,97.63716570168182,Transportation
53329,30206,23123,56.64085206923063,43.359147930769375,Food
55089,5825,49264,10.573798762003305,89.4262012379967,Food
20114,7391,12723,36.74555036293129,63.25444963706871,Housing
242764,33020,209744,13.601687235339671,86.39831276466032,Entertainment
58062,27983,30079,48.195032895869936,51.80496710413007,Food
47519,21472,26047,45.186136071887034,54.81386392811296,Food
169394,3121,166273,1.8424501458139013,98.1575498541861,Healthcare
54184,19783,34401,36.51077808947291,63.48922191052709,Food
243960,32357,211603,13.263239875389408,86.73676012461058,Entertainment
188847,30554,158293,16.17923504212405,83.82076495787595,Entertainment
172168,61379,110789,35.65064355745551,64.34935644254449,Healthcare
51474,15227,36247,29.581924855266738,70.41807514473327,Food
109509,52219,57290,47.6846651873362,52.31533481266379,Transportation
20488,562,19926,2.7430691136274894,97.2569308863725,Housing
129290,69601,59689,53.83324309691392,46.16675690308609,Healthcare
73315,31634,41681,43.148059742208275,56.851940257791725,Transportation
90657,44014,46643,48.55002923105772,51.44997076894228,Transportation
57338,29100,28238,50.7516830025463,49.24831699745369,Food
127122,40412,86710,31.789934079073646,68.21006592092635,Healthcare
28565,16309,12256,57.09434622790128,42.905653772098724,Housing
20043,4199,15844,20.949957591178965,79.05004240882103,Housing
248030,57646,190384,23.241543361690116,76.75845663830988,Entertainment
119422,28419,91003,23.797122808192796,76.2028771918072,Transportation
81113,10223,70890,12.603405126181993,87.39659487381802,Transportation
29743,3315,26428,11.145479608647413,88.8545203913526,Housing
150784,7161,143623,4.749177631578947,95.25082236842105,Healthcare
111423,22805,88618,20.467048993475316,79.53295100652468,Transportation
101916,24462,77454,24.002119392440836,75.99788060755917,Transportation
87259,11382,75877,13.043926700970673,86.95607329902933,Transportation
25965,13829,12136,53.26015790487194,46.73984209512806,Housing
126853,49790,77063,39.25015569202147,60.74984430797853,Healthcare
