Income,Savings,Expenses,Saving Percentage,Expense Percentage,Expense Category,Expense Category Numeric,Predicted Expense Category Numeric
171095,25868,145227,15.11908589,84.88091411,Healthcare,2,0
85679,19851,65828,23.16903792,76.83096208,Transportation,4,4
16618,4182,12436,25.16548321,74.83451679,Housing,3,3
82603,25216,57387,30.52673632,69.47326368,Transportation,4,4
91940,32571,59369,35.42636502,64.57363498,Transportation,4,4
144858,16878,127980,11.65141035,88.34858965,Healthcare,2,2
19697,8994,10703,45.6617759,54.3382241,Housing,3,3
68888,16775,52113,24.35112066,75.64887934,Transportation,4,4
153847,15527,138320,10.09249449,89.90750551,Healthcare,2,0
13444,1214,12230,9.03005058,90.96994942,Housing,3,3
48578,12258,36320,25.23364486,74.76635514,Food,1,1
163121,41628,121493,25.51970623,74.48029377,Healthcare,2,0
74534,10165,64369,13.63807122,86.36192878,Transportation,4,4
67031,27516,39515,41.04966359,58.95033641,Transportation,4,4
33557,16467,17090,49.0717287,50.9282713,Food,1,1
135283,14462,120821,10.6901828,89.3098172,Healthcare,2,2
24857,9373,15484,37.70768798,62.29231202,Housing,3,3
227673,65944,161729,28.96434799,71.03565201,Entertainment,0,0
131641,21390,110251,16.2487371,83.7512629,Healthcare,2,2
231493,53132,178361,22.95188191,77.04811809,Entertainment,0,0
199154,43046,156108,21.61442903,78.38557097,Entertainment,0,0
54887,17131,37756,31.21139796,68.78860204,Food,1,4
101544,53328,48216,52.51713543,47.48286457,Transportation,4,4
184565,7289,177276,3.949286159,96.05071384,Entertainment,0,0
80544,1774,78770,2.202522845,97.79747716,Transportation,4,4
184037,52819,131218,28.70020702,71.29979298,Entertainment,0,0
19545,6180,13365,31.61933998,68.38066002,Housing,3,3
223919,50076,173843,22.36344392,77.63655608,Entertainment,0,0
179817,27616,152201,15.35783602,84.64216398,Healthcare,2,0
225012,548,224464,0.243542567,99.75645743,Entertainment,0,0
13119,4534,8585,34.56056102,65.43943898,Housing,3,3
38063,21321,16742,56.01502772,43.98497228,Food,1,1
110429,5568,104861,5.042153782,94.95784622,Transportation,4,2
118639,25651,92988,21.6210521,78.3789479,Transportation,4,2
239213,64903,174310,27.13188664,72.86811336,Entertainment,0,0
53062,25461,27601,47.98349101,52.01650899,Food,1,4
107137,58858,48279,54.93713656,45.06286344,Transportation,4,4
29740,3796,25944,12.76395427,87.23604573,Housing,3,1
56424,27693,28731,49.08017865,50.91982135,Food,1,4
130277,6593,123684,5.06075516,94.93924484,Healthcare,2,2
119518,45894,73624,38.39923694,61.60076306,Transportation,4,2
12521,3687,8834,29.44652983,70.55347017,Housing,3,3
206678,58232,148446,28.1752291,71.8247709,Entertainment,0,0
29013,3919,25094,13.50773791,86.49226209,Housing,3,1
242438,68650,173788,28.31651804,71.68348196,Entertainment,0,0
27495,9230,18265,33.56973995,66.43026005,Housing,3,1
90147,12438,77709,13.79746414,86.20253586,Transportation,4,4
46937,23516,23421,50.10119948,49.89880052,Food,1,1
25631,2195,23436,8.563848465,91.43615154,Housing,3,1
59265,26806,32459,45.23074327,54.76925673,Food,1,4
39240,19564,19676,49.85728848,50.14271152,Food,1,1
243905,24281,219624,9.955105471,90.04489453,Entertainment,0,0
87796,10653,77143,12.1338102,87.8661898,Transportation,4,4
192255,30845,161410,16.043796,83.956204,Entertainment,0,0
47882,19385,28497,40.48494215,59.51505785,Food,1,1
170206,49931,120275,29.33562859,70.66437141,Healthcare,2,0
47107,15788,31319,33.51518883,66.48481117,Food,1,1
231069,59898,171171,25.92212716,74.07787284,Entertainment,0,0
32612,8605,24007,26.38599289,73.61400711,Food,1,1
59130,20448,38682,34.58143075,65.41856925,Food,1,4
25985,14573,11412,56.0823552,43.9176448,Housing,3,1
138728,39177,99551,28.24015339,71.75984661,Healthcare,2,2
159375,17104,142271,10.73192157,89.26807843,Healthcare,2,0
29466,17141,12325,58.17213059,41.82786941,Housing,3,1
15510,8462,7048,54.55834945,45.44165055,Housing,3,3
191545,59541,132004,31.08460153,68.91539847,Entertainment,0,0
45674,11541,34133,25.26820511,74.73179489,Food,1,1
226010,51895,174115,22.96137339,77.03862661,Entertainment,0,0
132378,53090,79288,40.10485126,59.89514874,Healthcare,2,2
48350,26831,21519,55.49327818,44.50672182,Food,1,1
62916,19524,43392,31.03185199,68.96814801,Transportation,4,4
28693,15907,12786,55.43860872,44.56139128,Housing,3,1
55598,10717,44881,19.27587323,80.72412677,Food,1,4
38817,18875,19942,48.62560218,51.37439782,Food,1,1
38657,20264,18393,52.42000155,47.57999845,Food,1,1
240314,35931,204383,14.95168821,85.04831179,Entertainment,0,0
22498,12091,10407,53.74255489,46.25744511,Housing,3,3
120298,38842,81456,32.28815109,67.71184891,Healthcare,2,2
187462,10662,176800,5.687552677,94.31244732,Entertainment,0,0
38293,18120,20173,47.31935341,52.68064659,Food,1,1
217555,24335,193220,11.18567719,88.81432281,Entertainment,0,0
11570,623,10947,5.384615385,94.61538462,Housing,3,3
93601,40351,53250,43.10958216,56.89041784,Transportation,4,4
32512,9044,23468,27.81742126,72.18257874,Food,1,1
70008,19181,50827,27.39829734,72.60170266,Transportation,4,4
57462,30232,27230,52.61216108,47.38783892,Food,1,4
42939,17454,25485,40.64836163,59.35163837,Food,1,1
34860,11845,23015,33.97877223,66.02122777,Food,1,1
182339,13818,168521,7.578192268,92.42180773,Entertainment,0,0
137343,22352,114991,16.27458261,83.72541739,Healthcare,2,2
122284,61377,60907,50.19217559,49.80782441,Healthcare,2,4
168322,28741,139581,17.07501099,82.92498901,Healthcare,2,0
227869,61336,166533,26.91721998,73.08278002,Entertainment,0,0
13595,7196,6399,52.93122471,47.06877529,Housing,3,3
54182,14958,39224,27.60695434,72.39304566,Food,1,4
58430,28153,30277,48.18244053,51.81755947,Food,1,4
188525,46185,142340,24.49807718,75.50192282,Entertainment,0,0
145334,7062,138272,4.859152022,95.14084798,Healthcare,2,2
124316,9791,114525,7.875896908,92.12410309,Healthcare,2,2
131762,42482,89280,32.24146567,67.75853433,Healthcare,2,2
29824,6406,23418,21.47934549,78.52065451,Housing,3,1
91640,42724,48916,46.62156264,53.37843736,Transportation,4,4
64458,38525,25933,59.76760061,40.23239939,Transportation,4,4
245072,36462,208610,14.87807665,85.12192335,Entertainment,0,0
160859,38991,121868,24.23924058,75.76075942,Healthcare,2,0
59165,9944,49221,16.80723401,83.19276599,Food,1,4
23666,1169,22497,4.939575763,95.06042424,Housing,3,3
158585,16135,142450,10.17435445,89.82564555,Healthcare,2,0
183757,44898,138859,24.43335492,75.56664508,Entertainment,0,0
56303,8023,48280,14.24968474,85.75031526,Food,1,4
114647,15377,99270,13.41247481,86.58752519,Transportation,4,2
125473,51864,73609,41.33478916,58.66521084,Healthcare,2,2
70648,36590,34058,51.79198279,48.20801721,Transportation,4,4
16131,7811,8320,48.42229248,51.57770752,Housing,3,3
227579,39844,187735,17.50776653,82.49223347,Entertainment,0,0
69051,29743,39308,43.07395983,56.92604017,Transportation,4,4
167621,46262,121359,27.59916717,72.40083283,Healthcare,2,0
26542,8680,17862,32.70288599,67.29711401,Housing,3,1
47958,4136,43822,8.624212853,91.37578715,Food,1,4
117255,54947,62308,46.86111466,53.13888534,Transportation,4,4
162301,42757,119544,26.34426159,73.65573841,Healthcare,2,0
102156,41565,60591,40.68777164,59.31222836,Transportation,4,4
174878,69942,104936,39.99473919,60.00526081,Healthcare,2,0
101213,32767,68446,32.37429974,67.62570026,Transportation,4,2
42768,1274,41494,2.978862701,97.0211373,Food,1,4
115263,38662,76601,33.54242038,66.45757962,Transportation,4,2
56998,32498,24500,57.01603565,42.98396435,Food,1,4
72524,26747,45777,36.88020517,63.11979483,Transportation,4,4
210196,15659,194537,7.449713601,92.5502864,Entertainment,0,0
16764,4177,12587,24.91648771,75.08351229,Housing,3,3
150895,22210,128685,14.71884423,85.28115577,Healthcare,2,0
46523,8818,37705,18.95406573,81.04593427,Food,1,1
29926,13104,16822,43.78801043,56.21198957,Housing,3,1
118382,40214,78168,33.96969134,66.03030866,Transportation,4,2
216610,11186,205424,5.164119847,94.83588015,Entertainment,0,0
196076,36029,160047,18.37501785,81.62498215,Entertainment,0,0
20913,5189,15724,24.8123177,75.1876823,Housing,3,3
140039,4423,135616,3.158405873,96.84159413,Healthcare,2,2
15784,9152,6632,57.98276736,42.01723264,Housing,3,3
214025,357,213668,0.166802944,99.83319706,Entertainment,0,0
22023,11278,10745,51.21009853,48.78990147,Housing,3,3
128385,44683,83702,34.80391011,65.19608989,Healthcare,2,2
130123,61744,68379,47.45048915,52.54951085,Healthcare,2,4
19729,5036,14693,25.52587561,74.47412439,Housing,3,3
128303,69993,58310,54.55289432,45.44710568,Healthcare,2,4
175748,2540,173208,1.445251155,98.55474884,Healthcare,2,0
85952,4629,81323,5.385564036,94.61443596,Transportation,4,4
16747,2529,14218,15.10121216,84.89878784,Housing,3,3
22980,6444,16536,28.04177546,71.95822454,Housing,3,3
96270,34696,61574,36.04030331,63.95969669,Transportation,4,4
121372,56359,65013,46.43492733,53.56507267,Healthcare,2,4
132075,44767,87308,33.89513534,66.10486466,Healthcare,2,2
59679,19394,40285,32.49719332,67.50280668,Food,1,4
203849,61616,142233,30.22629495,69.77370505,Entertainment,0,0
100439,4860,95579,4.838757853,95.16124215,Transportation,4,2
120120,9326,110794,7.763902764,92.23609724,Healthcare,2,2
117163,48577,68586,41.46104146,58.53895854,Transportation,4,4
20196,7992,12204,39.57219251,60.42780749,Housing,3,3
111613,7752,103861,6.945427504,93.0545725,Transportation,4,2
65794,9837,55957,14.95121136,85.04878864,Transportation,4,4
13258,1381,11877,10.41635239,89.58364761,Housing,3,3
84142,1467,82675,1.743481258,98.25651874,Transportation,4,4
120816,42556,78260,35.22381142,64.77618858,Healthcare,2,2
13620,811,12809,5.954478708,94.04552129,Housing,3,3
49115,20249,28866,41.22773084,58.77226916,Food,1,1
10194,5421,4773,53.1783402,46.8216598,Housing,3,3
233292,37748,195544,16.18058056,83.81941944,Entertainment,0,0
211725,52425,159300,24.76089267,75.23910733,Entertainment,0,0
218034,58071,159963,26.63391948,73.36608052,Entertainment,0,0
46414,4667,41747,10.05515577,89.94484423,Food,1,4
20011,3270,16741,16.34101244,83.65898756,Housing,3,3
196213,66465,129748,33.87390234,66.12609766,Entertainment,0,0
156971,67086,89885,42.73783055,57.26216945,Healthcare,2,0
134194,9860,124334,7.347571426,92.65242857,Healthcare,2,2
27777,4434,23343,15.96284696,84.03715304,Housing,3,1
26814,1539,25275,5.739539047,94.26046095,Housing,3,1
32403,3088,29315,9.529981792,90.47001821,Food,1,1
188797,11938,176859,6.323193695,93.67680631,Entertainment,0,0
106411,57262,49149,53.81210589,46.18789411,Transportation,4,4
97837,39554,58283,40.42846776,59.57153224,Transportation,4,4
221185,8900,212285,4.023780998,95.976219,Entertainment,0,0
37207,2025,35182,5.442524256,94.55747574,Food,1,1
119528,32781,86747,27.42537313,72.57462687,Transportation,4,2
36795,21030,15765,57.15450469,42.84549531,Food,1,1
76498,27706,48792,36.21794034,63.78205966,Transportation,4,4
163467,57351,106116,35.08414542,64.91585458,Healthcare,2,0
11345,5468,5877,48.19744381,51.80255619,Housing,3,3
155324,61635,93689,39.68156885,60.31843115,Healthcare,2,0
43396,12861,30535,29.63637202,70.36362798,Food,1,1
27892,15846,12046,56.8119891,43.1880109,Housing,3,1
180167,64915,115252,36.03046063,63.96953937,Entertainment,0,0
44171,14678,29493,33.22994725,66.77005275,Food,1,1
77683,25722,51961,33.11149157,66.88850843,Transportation,4,4
31759,12346,19413,38.87401996,61.12598004,Food,1,1
206649,3826,202823,1.851448592,98.14855141,Entertainment,0,0
111996,25051,86945,22.36776313,77.63223687,Transportation,4,2
19993,11552,8441,57.78022308,42.21977692,Housing,3,3
53120,12835,40285,24.1622741,75.8377259,Food,1,4
19132,8199,10933,42.85490278,57.14509722,Housing,3,3
49489,2877,46612,5.813413082,94.18658692,Food,1,4
92529,13630,78899,14.73051692,85.26948308,Transportation,4,4
207925,60367,147558,29.03306481,70.96693519,Entertainment,0,0
15000,1104,13896,7.36,92.64,Housing,3,3
38681,15549,23132,40.19803004,59.80196996,Food,1,1
213555,4666,208889,2.184917234,97.81508277,Entertainment,0,0
17355,9720,7635,56.00691443,43.99308557,Housing,3,3
166700,62958,103742,37.76724655,62.23275345,Healthcare,2,0
28018,13800,14218,49.25405097,50.74594903,Housing,3,1
182040,28083,153957,15.42682927,84.57317073,Entertainment,0,0
29697,16583,13114,55.84065731,44.15934269,Housing,3,1
39352,5962,33390,15.15043708,84.84956292,Food,1,1
141627,49433,92194,34.90365538,65.09634462,Healthcare,2,2
136546,67140,69406,49.170243,50.829757,Healthcare,2,4
205486,42924,162562,20.88901434,79.11098566,Entertainment,0,0
98751,43108,55643,43.65322883,56.34677117,Transportation,4,4
194232,59952,134280,30.86618065,69.13381935,Entertainment,0,0
125020,58915,66105,47.12446009,52.87553991,Healthcare,2,4
125966,9330,116636,7.406760554,92.59323945,Healthcare,2,2
154956,11070,143886,7.143963448,92.85603655,Healthcare,2,0
31107,2775,28332,8.92082168,91.07917832,Food,1,1
151623,69876,81747,46.08535644,53.91464356,Healthcare,2,0
138231,34947,103284,25.28159385,74.71840615,Healthcare,2,2
247140,33578,213562,13.58663106,86.41336894,Entertainment,0,0
22133,12140,9993,54.85022365,45.14977635,Housing,3,3
195180,18221,176959,9.335485193,90.66451481,Entertainment,0,0
94778,15347,79431,16.19257634,83.80742366,Transportation,4,4
243327,28081,215246,11.54043735,88.45956265,Entertainment,0,0
151730,4157,147573,2.739735056,97.26026494,Healthcare,2,0
52629,30980,21649,58.86488438,41.13511562,Food,1,1
70940,14416,56524,20.32139836,79.67860164,Transportation,4,4
13447,456,12991,3.39109095,96.60890905,Housing,3,3
28303,5762,22541,20.35826591,79.64173409,Housing,3,1
67634,29598,38036,43.76201319,56.23798681,Transportation,4,4
163072,62611,100461,38.39469682,61.60530318,Healthcare,2,0
80065,13954,66111,17.42833947,82.57166053,Transportation,4,4
83579,34777,48802,41.6097345,58.3902655,Transportation,4,4
19291,10464,8827,54.2429112,45.7570888,Housing,3,3
32767,8173,24594,24.94277779,75.05722221,Food,1,1
154630,36521,118109,23.61831469,76.38168531,Healthcare,2,0
241971,8551,233420,3.533894558,96.46610544,Entertainment,0,0
148162,50292,97870,33.94392624,66.05607376,Healthcare,2,2
55624,15221,40403,27.36408744,72.63591256,Food,1,4
15650,8878,6772,56.7284345,43.2715655,Housing,3,3
106163,49419,56744,46.55011633,53.44988367,Transportation,4,4
15406,2451,12955,15.90938595,84.09061405,Housing,3,3
21828,1008,20820,4.617921935,95.38207806,Housing,3,3
131202,38965,92237,29.69848021,70.30151979,Healthcare,2,2
35499,9572,25927,26.96413983,73.03586017,Food,1,1
37443,10803,26640,28.85185482,71.14814518,Food,1,1
95335,55195,40140,57.89584098,42.10415902,Transportation,4,4
149287,64223,85064,43.01982088,56.98017912,Healthcare,2,2
26996,7044,19952,26.09275448,73.90724552,Housing,3,1
221448,68818,152630,31.07637007,68.92362993,Entertainment,0,0
176091,37396,138695,21.23674691,78.76325309,Healthcare,2,0
73357,18103,55254,24.67794485,75.32205515,Transportation,4,4
171334,58153,113181,33.94130762,66.05869238,Healthcare,2,0
38112,8506,29606,22.31842989,77.68157011,Food,1,1
247343,26668,220675,10.78178885,89.21821115,Entertainment,0,0
91511,52313,39198,57.1658052,42.8341948,Transportation,4,4
31004,14699,16305,47.41001161,52.58998839,Food,1,1
86186,39135,47051,45.4076068,54.5923932,Transportation,4,4
131946,67559,64387,51.20200688,48.79799312,Healthcare,2,4
191679,38594,153085,20.13470438,79.86529562,Entertainment,0,0
36889,15982,20907,43.3245683,56.6754317,Food,1,1
18882,4246,14636,22.48702468,77.51297532,Housing,3,3
70815,21392,49423,30.2082892,69.7917108,Transportation,4,4
246411,60410,186001,24.51595099,75.48404901,Entertainment,0,0
111704,64407,47297,57.65863353,42.34136647,Transportation,4,4
41796,19164,22632,45.85127763,54.14872237,Food,1,1
13742,2997,10745,21.80905254,78.19094746,Housing,3,3
102058,26973,75085,26.42908934,73.57091066,Transportation,4,2
182050,66909,115141,36.75308981,63.24691019,Entertainment,0,0
226229,63434,162795,28.03972965,71.96027035,Entertainment,0,0
184440,46582,137858,25.25590978,74.74409022,Entertainment,0,0
27092,4416,22676,16.30001476,83.69998524,Housing,3,1
69276,22900,46376,33.05618107,66.94381893,Transportation,4,4
174712,46345,128367,26.5265122,73.4734878,Healthcare,2,0
10153,570,9583,5.614104206,94.38589579,Housing,3,3
156983,39226,117757,24.98741902,75.01258098,Healthcare,2,0
103940,45493,58447,43.7685203,56.2314797,Transportation,4,4
173694,26274,147420,15.12660196,84.87339804,Healthcare,2,0
14718,4355,10363,29.58961815,70.41038185,Housing,3,3
220856,50467,170389,22.85063571,77.14936429,Entertainment,0,0
229730,20721,209009,9.0197188,90.9802812,Entertainment,0,0
192465,7292,185173,3.78874081,96.21125919,Entertainment,0,0
122292,16913,105379,13.83001341,86.16998659,Healthcare,2,2
36018,7908,28110,21.95568882,78.04431118,Food,1,1
45638,15736,29902,34.48003856,65.51996144,Food,1,1
30501,12204,18297,40.01180289,59.98819711,Food,1,1
88839,39385,49454,44.3330069,55.6669931,Transportation,4,4
74218,29766,44452,40.1061737,59.8938263,Transportation,4,4
179155,32650,146505,18.22444252,81.77555748,Healthcare,2,0
218675,7626,211049,3.487367097,96.5126329,Entertainment,0,0
38109,16498,21611,43.29161091,56.70838909,Food,1,1
153970,44406,109564,28.84068325,71.15931675,Healthcare,2,0
138965,27125,111840,19.51930342,80.48069658,Healthcare,2,2
172882,15796,157086,9.136867921,90.86313208,Healthcare,2,0
157741,39033,118708,24.74499338,75.25500662,Healthcare,2,0
24346,5263,19083,21.61751417,78.38248583,Housing,3,3
179836,6187,173649,3.44035677,96.55964323,Healthcare,2,0
137501,65805,71696,47.85783376,52.14216624,Healthcare,2,2
28075,13102,14973,46.66785396,53.33214604,Housing,3,1
177870,14084,163786,7.918142464,92.08185754,Healthcare,2,0
49827,2826,47001,5.671623818,94.32837618,Food,1,4
27689,11843,15846,42.77149771,57.22850229,Housing,3,1
106197,39936,66261,37.60558208,62.39441792,Transportation,4,2
211639,27453,184186,12.97161676,87.02838324,Entertainment,0,0
121286,23663,97623,19.5100836,80.4899164,Healthcare,2,2
28305,10989,17316,38.82352941,61.17647059,Housing,3,1
62557,9339,53218,14.92878495,85.07121505,Transportation,4,4
217524,4292,213232,1.97311561,98.02688439,Entertainment,0,0
247223,55128,192095,22.29889614,77.70110386,Entertainment,0,0
203333,66040,137293,32.47874177,67.52125823,Entertainment,0,0
140896,21907,118989,15.54834772,84.45165228,Healthcare,2,2
16017,4220,11797,26.34700631,73.65299369,Housing,3,3
157665,65667,91998,41.64970031,58.35029969,Healthcare,2,0
86844,47976,38868,55.24388559,44.75611441,Transportation,4,4
132519,50097,82422,37.80363571,62.19636429,Healthcare,2,2
147934,10839,137095,7.326916057,92.67308394,Healthcare,2,2
92322,44595,47727,48.30376292,51.69623708,Transportation,4,4
157956,24943,133013,15.79110638,84.20889362,Healthcare,2,0
78851,3677,75174,4.663225577,95.33677442,Transportation,4,4
74643,26167,48476,35.05620085,64.94379915,Transportation,4,4
231571,63158,168413,27.27370871,72.72629129,Entertainment,0,0
160766,4718,156048,2.934700123,97.06529988,Healthcare,2,0
121841,53211,68630,43.6724912,56.3275088,Healthcare,2,4
92266,54127,38139,58.66407994,41.33592006,Transportation,4,4
131357,49027,82330,37.32347724,62.67652276,Healthcare,2,2
179084,45391,133693,25.34620625,74.65379375,Healthcare,2,0
70116,5963,64153,8.504478293,91.49552171,Transportation,4,4
29624,6593,23031,22.25560356,77.74439644,Housing,3,1
90551,17516,73035,19.34379521,80.65620479,Transportation,4,4
27876,15500,12376,55.60338643,44.39661357,Housing,3,1
35378,7507,27871,21.21940189,78.78059811,Food,1,1
236692,13782,222910,5.822757001,94.177243,Entertainment,0,0
114132,27200,86932,23.83205411,76.16794589,Transportation,4,2
42594,1526,41068,3.582664225,96.41733577,Food,1,4
144240,6947,137293,4.816278425,95.18372158,Healthcare,2,2
128699,10120,118579,7.863308961,92.13669104,Healthcare,2,2
104012,19977,84035,19.20643772,80.79356228,Transportation,4,2
116678,16133,100545,13.82694253,86.17305747,Transportation,4,2
232193,31797,200396,13.69421128,86.30578872,Entertainment,0,0
85181,15320,69861,17.98523145,82.01476855,Transportation,4,4
149016,5678,143338,3.810329092,96.18967091,Healthcare,2,2
237196,54134,183062,22.82247593,77.17752407,Entertainment,0,0
26569,12086,14483,45.48910384,54.51089616,Housing,3,1
118651,18258,100393,15.38798662,84.61201338,Transportation,4,2
197265,22608,174657,11.46072542,88.53927458,Entertainment,0,0
123675,69541,54134,56.22882555,43.77117445,Healthcare,2,4
161255,2582,158673,1.601190661,98.39880934,Healthcare,2,0
135503,9447,126056,6.971801362,93.02819864,Healthcare,2,2
56318,27751,28567,49.27554246,50.72445754,Food,1,4
21219,10976,10243,51.7272256,48.2727744,Housing,3,3
17034,8727,8307,51.23282846,48.76717154,Housing,3,3
181878,19349,162529,10.63844995,89.36155005,Entertainment,0,0
65210,33056,32154,50.69161172,49.30838828,Transportation,4,4
81896,27142,54754,33.1420338,66.8579662,Transportation,4,4
54177,23530,30647,43.43171457,56.56828543,Food,1,4
182677,1752,180925,0.959069834,99.04093017,Entertainment,0,0
47085,15488,31597,32.89370288,67.10629712,Food,1,1
36583,19591,16992,53.55219638,46.44780362,Food,1,1
99441,44764,54677,45.01563741,54.98436259,Transportation,4,4
61244,19699,41545,32.16478349,67.83521651,Transportation,4,4
177464,24527,152937,13.82083127,86.17916873,Healthcare,2,0
106853,1961,104892,1.83523158,98.16476842,Transportation,4,2
171840,69737,102103,40.58251862,59.41748138,Healthcare,2,0
152346,36343,116003,23.85556562,76.14443438,Healthcare,2,0
205838,26264,179574,12.75954877,87.24045123,Entertainment,0,0
109182,19292,89890,17.66957923,82.33042077,Transportation,4,2
30165,1781,28384,5.904193602,94.0958064,Food,1,1
42122,7033,35089,16.69673805,83.30326195,Food,1,1
159341,9548,149793,5.992180293,94.00781971,Healthcare,2,0
51035,115,50920,0.225335554,99.77466445,Food,1,4
17901,1901,16000,10.61951846,89.38048154,Housing,3,3
57254,31406,25848,54.85380934,45.14619066,Food,1,4
235361,58947,176414,25.04535586,74.95464414,Entertainment,0,0
123460,44667,78793,36.17932934,63.82067066,Healthcare,2,2
44465,14289,30176,32.13538738,67.86461262,Food,1,1
16312,8091,8221,49.60152035,50.39847965,Housing,3,3
18704,1940,16764,10.37211292,89.62788708,Housing,3,3
136763,6959,129804,5.088364543,94.91163546,Healthcare,2,2
145889,31508,114381,21.59724174,78.40275826,Healthcare,2,2
32411,6109,26302,18.84853908,81.15146092,Food,1,1
35375,21139,14236,59.75689046,40.24310954,Food,1,1
25933,2016,23917,7.773878842,92.22612116,Housing,3,1
173733,53089,120644,30.55780997,69.44219003,Healthcare,2,0
190378,22918,167460,12.03815567,87.96184433,Entertainment,0,0
33971,14917,19054,43.9109829,56.0890171,Food,1,1
97483,57579,39904,59.06568325,40.93431675,Transportation,4,4
30808,15316,15492,49.71435991,50.28564009,Food,1,1
136265,6183,130082,4.537482112,95.46251789,Healthcare,2,2
238594,37052,201542,15.5293092,84.4706908,Entertainment,0,0
34793,18296,16497,52.58529014,47.41470986,Food,1,1
39940,19757,20183,49.46670005,50.53329995,Food,1,1
80646,33958,46688,42.10748208,57.89251792,Transportation,4,4
96240,36463,59777,37.88757273,62.11242727,Transportation,4,4
75771,20310,55461,26.80445025,73.19554975,Transportation,4,4
30018,17934,12084,59.74415351,40.25584649,Food,1,1
20105,10577,9528,52.60880378,47.39119622,Housing,3,3
12428,3252,9176,26.16672031,73.83327969,Housing,3,3
57524,21575,35949,37.50608442,62.49391558,Food,1,4
162427,65584,96843,40.37752344,59.62247656,Healthcare,2,0
244932,9810,235122,4.005193278,95.99480672,Entertainment,0,0
245634,898,244736,0.365584569,99.63441543,Entertainment,0,0
100174,7543,92631,7.529897978,92.47010202,Transportation,4,2
15905,1706,14199,10.72618673,89.27381327,Housing,3,3
81469,24958,56511,30.63496545,69.36503455,Transportation,4,4
160195,9156,151039,5.715534193,94.28446581,Healthcare,2,0
39718,7020,32698,17.67460597,82.32539403,Food,1,1
22027,6155,15872,27.94297907,72.05702093,Housing,3,3
129786,18363,111423,14.14867551,85.85132449,Healthcare,2,2
81420,23501,57919,28.8639155,71.1360845,Transportation,4,4
34352,8927,25425,25.98684211,74.01315789,Food,1,1
163692,68186,95506,41.6550595,58.3449405,Healthcare,2,0
200012,53505,146507,26.75089495,73.24910505,Entertainment,0,0
232863,26371,206492,11.32468447,88.67531553,Entertainment,0,0
16884,6084,10800,36.03411514,63.96588486,Housing,3,3
96953,38667,58286,39.88221097,60.11778903,Transportation,4,4
195390,63454,131936,32.4755617,67.5244383,Entertainment,0,0
249778,61539,188239,24.63747808,75.36252192,Entertainment,0,0
118927,20556,98371,17.28455271,82.71544729,Transportation,4,2
24986,10503,14483,42.0355399,57.9644601,Housing,3,3
63997,13902,50095,21.72289326,78.27710674,Transportation,4,4
130060,41268,88792,31.72997078,68.27002922,Healthcare,2,2
234172,50403,183769,21.52392259,78.47607741,Entertainment,0,0
233130,55267,177863,23.70651568,76.29348432,Entertainment,0,0
128706,69841,58865,54.26398148,45.73601852,Healthcare,2,4
12172,5399,6773,44.35589878,55.64410122,Housing,3,3
248479,21048,227431,8.470735958,91.52926404,Entertainment,0,0
237903,67874,170029,28.53011522,71.46988478,Entertainment,0,0
55524,33294,22230,59.96325913,40.03674087,Food,1,1
104210,44423,59787,42.62834661,57.37165339,Transportation,4,4
25520,3295,22225,12.91144201,87.08855799,Housing,3,1
113891,24338,89553,21.3695551,78.6304449,Transportation,4,2
186796,11708,175088,6.267800167,93.73219983,Entertainment,0,0
62253,7289,54964,11.70867267,88.29132733,Transportation,4,4
175256,727,174529,0.414821746,99.58517825,Healthcare,2,0
47021,24223,22798,51.51528041,48.48471959,Food,1,1
27729,3832,23897,13.81946698,86.18053302,Housing,3,1
112294,4247,108047,3.78203644,96.21796356,Transportation,4,2
63472,13931,49541,21.94826065,78.05173935,Transportation,4,4
146911,43310,103601,29.48043373,70.51956627,Healthcare,2,2
210084,68504,141580,32.60790922,67.39209078,Entertainment,0,0
24818,8543,16275,34.4225965,65.5774035,Housing,3,3
24505,9178,15327,37.4535809,62.5464191,Housing,3,3
96347,54355,41992,56.4158718,43.5841282,Transportation,4,4
112124,52269,59855,46.61713817,53.38286183,Transportation,4,4
90745,8695,82050,9.58179514,90.41820486,Transportation,4,4
20024,11966,8058,59.75829005,40.24170995,Housing,3,3
33031,238,32793,0.720535255,99.27946475,Food,1,1
24030,175,23855,0.728256346,99.27174365,Housing,3,3
235410,29698,205712,12.6154369,87.3845631,Entertainment,0,0
46622,26465,20157,56.76504654,43.23495346,Food,1,1
179486,26522,152964,14.77663996,85.22336004,Healthcare,2,0
14862,2313,12549,15.56318127,84.43681873,Housing,3,3
26131,15127,11004,57.88909724,42.11090276,Housing,3,1
46450,15764,30686,33.93756728,66.06243272,Food,1,1
165646,51151,114495,30.87970733,69.12029267,Healthcare,2,0
16043,3017,13026,18.80570966,81.19429034,Housing,3,3
29671,12485,17186,42.07812342,57.92187658,Housing,3,1
140159,44090,96069,31.45713083,68.54286917,Healthcare,2,2
223807,68218,155589,30.4807267,69.5192733,Entertainment,0,0
24557,6326,18231,25.76047563,74.23952437,Housing,3,3
160291,36170,124121,22.56520953,77.43479047,Healthcare,2,0
238960,9513,229447,3.981001004,96.018999,Entertainment,0,0
201443,24839,176604,12.33053519,87.66946481,Entertainment,0,0
195884,40281,155603,20.56370097,79.43629903,Entertainment,0,0
13152,4689,8463,35.65237226,64.34762774,Housing,3,3
53699,27667,26032,51.52237472,48.47762528,Food,1,4
25930,11365,14565,43.82954107,56.17045893,Housing,3,1
33894,19452,14442,57.39068862,42.60931138,Food,1,1
22129,1705,20424,7.704821727,92.29517827,Housing,3,3
63600,24888,38712,39.13207547,60.86792453,Transportation,4,4
245775,33355,212420,13.57135591,86.42864409,Entertainment,0,0
23306,2817,20489,12.08701622,87.91298378,Housing,3,3
105875,53650,52225,50.6729634,49.3270366,Transportation,4,4
156277,13789,142488,8.82343531,91.17656469,Healthcare,2,0
218225,3901,214324,1.787604537,98.21239546,Entertainment,0,0
118533,19746,98787,16.65865202,83.34134798,Transportation,4,2
149745,18577,131168,12.40575645,87.59424355,Healthcare,2,2
41619,18954,22665,45.5416997,54.4583003,Food,1,1
10096,4143,5953,41.03605388,58.96394612,Housing,3,3
40254,6921,33333,17.1933224,82.8066776,Food,1,1
93265,11229,82036,12.03988635,87.96011365,Transportation,4,4
15482,9218,6264,59.5401111,40.4598889,Housing,3,3
133685,23445,110240,17.53749486,82.46250514,Healthcare,2,2
93576,30296,63280,32.37582286,67.62417714,Transportation,4,4
28878,15667,13211,54.25237205,45.74762795,Housing,3,1
26725,8737,17988,32.69223573,67.30776427,Housing,3,1
51017,9404,41613,18.43307133,81.56692867,Food,1,4
25445,1622,23823,6.374533307,93.62546669,Housing,3,1
181086,49335,131751,27.24396143,72.75603857,Entertainment,0,0
225520,40551,184969,17.98111032,82.01888968,Entertainment,0,0
244852,16938,227914,6.917648212,93.08235179,Entertainment,0,0
16959,4807,12152,28.34483165,71.65516835,Housing,3,3
98218,17063,81155,17.37257936,82.62742064,Transportation,4,4
134055,2038,132017,1.52027153,98.47972847,Healthcare,2,2
58193,27242,30951,46.81319059,53.18680941,Food,1,4
41726,20979,20747,50.27800412,49.72199588,Food,1,1
132994,10283,122711,7.731927756,92.26807224,Healthcare,2,2
120527,32878,87649,27.2785351,72.7214649,Healthcare,2,2
142275,6592,135683,4.633280619,95.36671938,Healthcare,2,2
124147,22042,102105,17.75475847,82.24524153,Healthcare,2,2
160252,37809,122443,23.59346529,76.40653471,Healthcare,2,0
24356,3921,20435,16.09870258,83.90129742,Housing,3,3
24830,13928,10902,56.09343536,43.90656464,Housing,3,3
138958,1755,137203,1.262971545,98.73702845,Healthcare,2,2
183321,53706,129615,29.29615265,70.70384735,Entertainment,0,0
24686,12871,11815,52.13886413,47.86113587,Housing,3,3
19423,2356,17067,12.12994903,87.87005097,Housing,3,3
36514,8082,28432,22.13397601,77.86602399,Food,1,1
53148,17543,35605,33.0078272,66.9921728,Food,1,4
228659,42828,185831,18.73007404,81.26992596,Entertainment,0,0
135373,1369,134004,1.011279945,98.98872005,Healthcare,2,2
124217,69997,54220,56.35058003,43.64941997,Healthcare,2,4
93156,27381,65775,29.39263171,70.60736829,Transportation,4,4
105863,31471,74392,29.72804474,70.27195526,Transportation,4,2
61709,22971,38738,37.22471601,62.77528399,Transportation,4,4
119863,1780,118083,1.485028741,98.51497126,Transportation,4,2
169839,32375,137464,19.06217064,80.93782936,Healthcare,2,0
127921,10920,117001,8.536518633,91.46348137,Healthcare,2,2
69613,9413,60200,13.52189965,86.47810035,Transportation,4,4
12103,3839,8264,31.71940841,68.28059159,Housing,3,3
74673,27209,47464,36.43753432,63.56246568,Transportation,4,4
76763,9441,67322,12.298894,87.701106,Transportation,4,4
67111,19649,47462,29.27835973,70.72164027,Transportation,4,4
50355,27667,22688,54.94389832,45.05610168,Food,1,4
173838,40956,132882,23.55986608,76.44013392,Healthcare,2,0
16671,2074,14597,12.4407654,87.5592346,Housing,3,3
94925,41491,53434,43.70924414,56.29075586,Transportation,4,4
42145,9650,32495,22.89714082,77.10285918,Food,1,1
172886,25682,147204,14.85487547,85.14512453,Healthcare,2,0
25330,318,25012,1.255428346,98.74457165,Housing,3,1
225841,25571,200270,11.32256765,88.67743235,Entertainment,0,0
36028,10455,25573,29.01909626,70.98090374,Food,1,1
238968,59048,179920,24.70958455,75.29041545,Entertainment,0,0
202075,49699,152376,24.59433379,75.40566621,Entertainment,0,0
15165,8866,6299,58.46356742,41.53643258,Housing,3,3
19840,9343,10497,47.09173387,52.90826613,Housing,3,3
217959,68544,149415,31.44811639,68.55188361,Entertainment,0,0
237027,44365,192662,18.71727693,81.28272307,Entertainment,0,0
42158,14683,27475,34.8285023,65.1714977,Food,1,1
240927,46585,194342,19.3357324,80.6642676,Entertainment,0,0
68028,28301,39727,41.60198742,58.39801258,Transportation,4,4
160126,59620,100506,37.23317887,62.76682113,Healthcare,2,0
238754,34717,204037,14.54090822,85.45909178,Entertainment,0,0
96858,24441,72417,25.23384749,74.76615251,Transportation,4,4
248929,26933,221996,10.81955096,89.18044904,Entertainment,0,0
190968,51075,139893,26.74531859,73.25468141,Entertainment,0,0
21253,5949,15304,27.9913424,72.0086576,Housing,3,3
47644,20992,26652,44.0601125,55.9398875,Food,1,1
225532,32125,193407,14.2440984,85.7559016,Entertainment,0,0
45220,23946,21274,52.95444494,47.04555506,Food,1,1
70085,17646,52439,25.17799815,74.82200185,Transportation,4,4
221448,31383,190065,14.17172429,85.82827571,Entertainment,0,0
156653,38186,118467,24.37616898,75.62383102,Healthcare,2,0
108154,3986,104168,3.685485511,96.31451449,Transportation,4,2
246837,13198,233639,5.346848325,94.65315167,Entertainment,0,0
189266,3045,186221,1.608846808,98.39115319,Entertainment,0,0
93366,9883,83483,10.58522374,89.41477626,Transportation,4,4
238512,64551,173961,27.06404709,72.93595291,Entertainment,0,0
121828,49851,71977,40.91916472,59.08083528,Healthcare,2,2
54525,19927,34598,36.54653829,63.45346171,Food,1,4
192340,10872,181468,5.652490382,94.34750962,Entertainment,0,0
229618,40377,189241,17.58442282,82.41557718,Entertainment,0,0
40317,11734,28583,29.10434804,70.89565196,Food,1,1
99787,17742,82045,17.77987113,82.22012887,Transportation,4,4
87187,30918,56269,35.46170874,64.53829126,Transportation,4,4
53132,31471,21661,59.23172476,40.76827524,Food,1,1
18656,3084,15572,16.53087479,83.46912521,Housing,3,3
90206,36368,53838,40.31660865,59.68339135,Transportation,4,4
245544,56300,189244,22.92868081,77.07131919,Entertainment,0,0
186762,15830,170932,8.476028314,91.52397169,Entertainment,0,0
69859,4136,65723,5.920497001,94.079503,Transportation,4,4
199913,48407,151506,24.2140331,75.7859669,Entertainment,0,0
124772,9619,115153,7.709261693,92.29073831,Healthcare,2,2
244851,52870,191981,21.59272374,78.40727626,Entertainment,0,0
236705,15597,221108,6.589214423,93.41078558,Entertainment,0,0
127441,2336,125105,1.833005077,98.16699492,Healthcare,2,2
238957,54639,184318,22.86562017,77.13437983,Entertainment,0,0
172748,65191,107557,37.73762938,62.26237062,Healthcare,2,0
47613,2543,45070,5.340978304,94.6590217,Food,1,4
165110,51248,113862,31.03870147,68.96129853,Healthcare,2,0
40130,3278,36852,8.168452529,91.83154747,Food,1,1
23512,14092,9420,59.93535216,40.06464784,Housing,3,3
101558,20043,81515,19.73552059,80.26447941,Transportation,4,2
78182,23388,54794,29.91481415,70.08518585,Transportation,4,4
68292,11433,56859,16.74134598,83.25865402,Transportation,4,4
68605,26461,42144,38.57007507,61.42992493,Transportation,4,4
22134,7998,14136,36.13445378,63.86554622,Housing,3,3
22133,3888,18245,17.56652962,82.43347038,Housing,3,3
130029,62591,67438,48.136185,51.863815,Healthcare,2,4
163151,37780,125371,23.15646242,76.84353758,Healthcare,2,0
231055,52201,178854,22.59245634,77.40754366,Entertainment,0,0
69256,3565,65691,5.147568442,94.85243156,Transportation,4,4
193711,49100,144611,25.3470376,74.6529624,Entertainment,0,0
71786,1204,70582,1.677207255,98.32279275,Transportation,4,4
29966,15725,14241,52.47613962,47.52386038,Housing,3,1
21327,7532,13795,35.31673466,64.68326534,Housing,3,3
14098,6752,7346,47.8933182,52.1066818,Housing,3,3
26656,4266,22390,16.00390156,83.99609844,Housing,3,1
166895,21594,145301,12.93867402,87.06132598,Healthcare,2,0
226405,29645,196760,13.0937921,86.9062079,Entertainment,0,0
37685,18135,19550,48.1225952,51.8774048,Food,1,1
35155,8963,26192,25.49566207,74.50433793,Food,1,1
28449,3700,24749,13.00572955,86.99427045,Housing,3,1
40506,15333,25173,37.85365131,62.14634869,Food,1,1
120532,57585,62947,47.77569442,52.22430558,Healthcare,2,4
191223,55466,135757,29.00592502,70.99407498,Entertainment,0,0
144970,36641,108329,25.27488446,74.72511554,Healthcare,2,2
122118,63352,58766,51.87769207,48.12230793,Healthcare,2,4
59672,10694,48978,17.92130312,82.07869688,Food,1,4
17341,2838,14503,16.36583819,83.63416181,Housing,3,3
30152,8000,22152,26.53223667,73.46776333,Food,1,1
15188,2944,12244,19.38372399,80.61627601,Housing,3,3
156338,54068,102270,34.58404227,65.41595773,Healthcare,2,0
93302,9619,83683,10.30953249,89.69046751,Transportation,4,4
68692,25056,43636,36.47586327,63.52413673,Transportation,4,4
107355,54823,52532,51.06702063,48.93297937,Transportation,4,4
15962,5301,10661,33.21012404,66.78987596,Housing,3,3
61866,17247,44619,27.87799437,72.12200563,Transportation,4,4
10622,2307,8315,21.71907362,78.28092638,Housing,3,3
189000,41755,147245,22.09259259,77.90740741,Entertainment,0,0
75311,42761,32550,56.77922216,43.22077784,Transportation,4,4
11821,453,11368,3.8321631,96.1678369,Housing,3,3
219797,66176,153621,30.10778127,69.89221873,Entertainment,0,0
47518,5343,42175,11.24416011,88.75583989,Food,1,4
49792,1801,47991,3.617046915,96.38295308,Food,1,4
38641,21281,17360,55.07362646,44.92637354,Food,1,1
60399,15340,45059,25.39777149,74.60222851,Transportation,4,4
33359,15700,17659,47.0637609,52.9362391,Food,1,1
35773,19737,16036,55.17289576,44.82710424,Food,1,1
160277,50674,109603,31.61651391,68.38348609,Healthcare,2,0
50252,11982,38270,23.84382711,76.15617289,Food,1,4
235889,47619,188270,20.18703712,79.81296288,Entertainment,0,0
247229,23916,223313,9.673622431,90.32637757,Entertainment,0,0
44231,21200,23031,47.93018471,52.06981529,Food,1,1
94872,8230,86642,8.674846108,91.32515389,Transportation,4,4
79186,5720,73466,7.223499103,92.7765009,Transportation,4,4
10177,2349,7828,23.08145819,76.91854181,Housing,3,3
10821,3348,7473,30.9398392,69.0601608,Housing,3,3
68619,33099,35520,48.23591134,51.76408866,Transportation,4,4
249005,54259,194746,21.7903255,78.2096745,Entertainment,0,0
46688,9694,36994,20.76336532,79.23663468,Food,1,1
22854,7779,15075,34.0378052,65.9621948,Housing,3,3
172022,67386,104636,39.17289649,60.82710351,Healthcare,2,0
184679,18414,166265,9.970814224,90.02918578,Entertainment,0,0
47815,18336,29479,38.34779881,61.65220119,Food,1,1
62071,29532,32539,47.57777384,52.42222616,Transportation,4,4
77803,15532,62271,19.96324049,80.03675951,Transportation,4,4
27009,13460,13549,49.83524011,50.16475989,Housing,3,1
211141,20132,191009,9.534860591,90.46513941,Entertainment,0,0
20827,4267,16560,20.4878283,79.5121717,Housing,3,3
47788,9290,38498,19.44002678,80.55997322,Food,1,1
236445,46349,190096,19.60244454,80.39755546,Entertainment,0,0
194079,54772,139307,28.22149743,71.77850257,Entertainment,0,0
16520,4598,11922,27.83292978,72.16707022,Housing,3,3
216615,28621,187994,13.21284306,86.78715694,Entertainment,0,0
178065,69673,108392,39.12784657,60.87215343,Healthcare,2,0
26662,1095,25567,4.10696872,95.89303128,Housing,3,1
29749,4951,24798,16.64257622,83.35742378,Housing,3,1
107403,1831,105572,1.704794093,98.29520591,Transportation,4,2
25435,4971,20464,19.54393552,80.45606448,Housing,3,1
19647,6667,12980,33.93393393,66.06606607,Housing,3,3
113147,54570,58577,48.22929463,51.77070537,Transportation,4,4
11757,4158,7599,35.36616484,64.63383516,Housing,3,3
146302,43064,103238,29.43500431,70.56499569,Healthcare,2,2
24790,13552,11238,54.66720452,45.33279548,Housing,3,3
10906,5919,4987,54.27287732,45.72712268,Housing,3,3
164966,8886,156080,5.386564504,94.6134355,Healthcare,2,0
234810,39484,195326,16.81529747,83.18470253,Entertainment,0,0
188793,13419,175374,7.107784717,92.89221528,Entertainment,0,0
156213,48699,107514,31.17474218,68.82525782,Healthcare,2,0
165357,52120,113237,31.51968166,68.48031834,Healthcare,2,0
237441,47856,189585,20.15490164,79.84509836,Entertainment,0,0
249921,31512,218409,12.60878438,87.39121562,Entertainment,0,0
16422,6871,9551,41.84021435,58.15978565,Housing,3,3
115838,7291,108547,6.294134913,93.70586509,Transportation,4,2
53860,11592,42268,21.52246565,78.47753435,Food,1,4
35890,16918,18972,47.13847868,52.86152132,Food,1,1
15012,5929,9083,39.49507061,60.50492939,Housing,3,3
24944,1092,23852,4.377806286,95.62219371,Housing,3,3
162803,52225,110578,32.0786472,67.9213528,Healthcare,2,0
121375,26043,95332,21.45664264,78.54335736,Healthcare,2,2
65981,28819,37162,43.67772541,56.32227459,Transportation,4,4
199796,11679,188117,5.845462372,94.15453763,Entertainment,0,0
148242,63082,85160,42.55339243,57.44660757,Healthcare,2,2
29010,4738,24272,16.33229921,83.66770079,Housing,3,1
232045,15112,216933,6.512529897,93.4874701,Entertainment,0,0
26694,6912,19782,25.8934592,74.1065408,Housing,3,1
193555,7319,186236,3.781354137,96.21864586,Entertainment,0,0
118626,55150,63476,46.49065129,53.50934871,Transportation,4,4
16962,4054,12908,23.90048343,76.09951657,Housing,3,3
131946,33107,98839,25.09132524,74.90867476,Healthcare,2,2
229746,10806,218940,4.70345512,95.29654488,Entertainment,0,0
34965,19846,15119,56.75961676,43.24038324,Food,1,1
91575,28792,62783,31.44089544,68.55910456,Transportation,4,4
37165,10227,26938,27.51782591,72.48217409,Food,1,1
229625,5329,224296,2.320740338,97.67925966,Entertainment,0,0
17326,1245,16081,7.185732425,92.81426757,Housing,3,3
157359,8952,148407,5.688902446,94.31109755,Healthcare,2,0
210696,69640,141056,33.0523598,66.9476402,Entertainment,0,0
138705,63063,75642,45.4655564,54.5344436,Healthcare,2,2
236348,34040,202308,14.40249124,85.59750876,Entertainment,0,0
99287,43505,55782,43.81741819,56.18258181,Transportation,4,4
184519,35471,149048,19.2234946,80.7765054,Entertainment,0,0
130196,5376,124820,4.129159114,95.87084089,Healthcare,2,2
104537,44547,59990,42.61362006,57.38637994,Transportation,4,4
27043,13452,13591,49.74300189,50.25699811,Housing,3,1
151765,38759,113006,25.53882648,74.46117352,Healthcare,2,0
222630,43809,178821,19.67794098,80.32205902,Entertainment,0,0
14817,4283,10534,28.90598637,71.09401363,Housing,3,3
150709,45045,105664,29.88872596,70.11127404,Healthcare,2,0
19705,5474,14231,27.77975133,72.22024867,Housing,3,3
144868,1889,142979,1.303945661,98.69605434,Healthcare,2,2
146282,60991,85291,41.69412505,58.30587495,Healthcare,2,2
115609,35583,80026,30.7787456,69.2212544,Transportation,4,2
161005,41522,119483,25.7892612,74.2107388,Healthcare,2,0
169510,28631,140879,16.89044894,83.10955106,Healthcare,2,0
213553,22077,191476,10.33794889,89.66205111,Entertainment,0,0
215851,41796,174055,19.36335713,80.63664287,Entertainment,0,0
173509,39622,133887,22.83570305,77.16429695,Healthcare,2,0
86597,38115,48482,44.01422682,55.98577318,Transportation,4,4
27910,15796,12114,56.59620208,43.40379792,Housing,3,1
228836,46714,182122,20.41374609,79.58625391,Entertainment,0,0
102373,36504,65869,35.65783947,64.34216053,Transportation,4,2
146135,9697,136438,6.635645123,93.36435488,Healthcare,2,2
85133,32361,52772,38.01228666,61.98771334,Transportation,4,4
43185,6814,36371,15.77862684,84.22137316,Food,1,1
100392,99,100293,0.098613435,99.90138656,Transportation,4,2
201879,26066,175813,12.91169463,87.08830537,Entertainment,0,0
128907,59465,69442,46.13015585,53.86984415,Healthcare,2,4
23528,3664,19864,15.57293438,84.42706562,Housing,3,3
224932,52158,172774,23.18834137,76.81165863,Entertainment,0,0
80876,24704,56172,30.54552648,69.45447352,Transportation,4,4
44981,21008,23973,46.70416398,53.29583602,Food,1,1
26127,2632,23495,10.07386994,89.92613006,Housing,3,1
45364,3026,42338,6.670487611,93.32951239,Food,1,4
36677,7429,29248,20.25520081,79.74479919,Food,1,1
226793,18329,208464,8.081819104,91.9181809,Entertainment,0,0
108948,38950,69998,35.75100048,64.24899952,Transportation,4,2
13500,3981,9519,29.48888889,70.51111111,Housing,3,3
11669,6504,5165,55.73742394,44.26257606,Housing,3,3
55810,25192,30618,45.138864,54.861136,Food,1,4
13253,1990,11263,15.0154682,84.9845318,Housing,3,3
42607,10652,31955,25.00058676,74.99941324,Food,1,1
97517,32071,65446,32.88759909,67.11240091,Transportation,4,4
58066,9155,48911,15.76654152,84.23345848,Food,1,4
59318,11235,48083,18.94028794,81.05971206,Food,1,4
223251,56914,166337,25.49327887,74.50672113,Entertainment,0,0
236359,51690,184669,21.86927513,78.13072487,Entertainment,0,0
26083,8101,17982,31.05854388,68.94145612,Housing,3,1
64431,28923,35508,44.8898822,55.1101178,Transportation,4,4
219715,24190,195525,11.00971713,88.99028287,Entertainment,0,0
57331,19064,38267,33.25251609,66.74748391,Food,1,4
162104,58938,103166,36.35814045,63.64185955,Healthcare,2,0
56971,6264,50707,10.99506767,89.00493233,Food,1,4
179070,25739,153331,14.37370861,85.62629139,Healthcare,2,0
22109,1427,20682,6.454385092,93.54561491,Housing,3,3
208879,16511,192368,7.904576334,92.09542367,Entertainment,0,0
44957,1869,43088,4.15730587,95.84269413,Food,1,4
58425,21636,36789,37.03209243,62.96790757,Food,1,4
59158,24436,34722,41.3063322,58.6936678,Food,1,4
150311,57623,92688,38.33585034,61.66414966,Healthcare,2,0
19084,9453,9631,49.53364075,50.46635925,Housing,3,3
219191,36045,183146,16.44456205,83.55543795,Entertainment,0,0
11180,2925,8255,26.1627907,73.8372093,Housing,3,3
140673,3453,137220,2.45462882,97.54537118,Healthcare,2,2
44356,3088,41268,6.96185409,93.03814591,Food,1,4
117976,51226,66750,43.42069573,56.57930427,Transportation,4,4
231138,65974,165164,28.54312143,71.45687857,Entertainment,0,0
104975,21941,83034,20.90116694,79.09883306,Transportation,4,2
195632,31025,164607,15.85885745,84.14114255,Entertainment,0,0
14683,4152,10531,28.27759995,71.72240005,Housing,3,3
71135,24598,46537,34.57932101,65.42067899,Transportation,4,4
149884,16978,132906,11.32742654,88.67257346,Healthcare,2,2
46630,12220,34410,26.20630495,73.79369505,Food,1,1
49642,11813,37829,23.7963821,76.2036179,Food,1,1
198694,43125,155569,21.70422861,78.29577139,Entertainment,0,0
152494,51563,100931,33.81313363,66.18686637,Healthcare,2,0
33351,9282,24069,27.83124944,72.16875056,Food,1,1
164453,55129,109324,33.52264781,66.47735219,Healthcare,2,0
239596,42311,197285,17.65930984,82.34069016,Entertainment,0,0
89999,44806,45193,49.78499761,50.21500239,Transportation,4,4
248906,27132,221774,10.90050059,89.09949941,Entertainment,0,0
117228,32065,85163,27.35268025,72.64731975,Transportation,4,2
211551,11862,199689,5.607158558,94.39284144,Entertainment,0,0
138734,2254,136480,1.624691856,98.37530814,Healthcare,2,2
26533,11252,15281,42.40756793,57.59243207,Housing,3,1
64494,29027,35467,45.0072875,54.9927125,Transportation,4,4
178448,15226,163222,8.532457635,91.46754237,Healthcare,2,0
219921,50485,169436,22.95597055,77.04402945,Entertainment,0,0
208155,46879,161276,22.52119815,77.47880185,Entertainment,0,0
50683,12611,38072,24.88211037,75.11788963,Food,1,4
19838,2635,17203,13.28258897,86.71741103,Housing,3,3
44868,19949,24919,44.4615316,55.5384684,Food,1,1
174756,42497,132259,24.31790611,75.68209389,Healthcare,2,0
233492,44287,189205,18.96724513,81.03275487,Entertainment,0,0
23488,634,22854,2.699250681,97.30074932,Housing,3,3
11431,2159,9272,18.88723646,81.11276354,Housing,3,3
122898,61297,61601,49.8763202,50.1236798,Healthcare,2,4
233272,27661,205611,11.8578312,88.1421688,Entertainment,0,0
127512,67049,60463,52.58250204,47.41749796,Healthcare,2,4
47474,13440,34034,28.31023297,71.68976703,Food,1,1
115547,54317,61230,47.0085766,52.9914234,Transportation,4,4
47291,23352,23939,49.37937451,50.62062549,Food,1,1
32195,6094,26101,18.92840503,81.07159497,Food,1,1
172752,38603,134149,22.34590627,77.65409373,Healthcare,2,0
81183,12323,68860,15.1792863,84.8207137,Transportation,4,4
19981,8172,11809,40.89885391,59.10114609,Housing,3,3
20669,876,19793,4.238231167,95.76176883,Housing,3,3
21032,4801,16231,22.82712058,77.17287942,Housing,3,3
35656,9956,25700,27.92236931,72.07763069,Food,1,1
230925,6192,224733,2.681390062,97.31860994,Entertainment,0,0
247563,20063,227500,8.104199739,91.89580026,Entertainment,0,0
15046,6068,8978,40.32965572,59.67034428,Housing,3,3
61424,4746,56678,7.726621516,92.27337848,Transportation,4,4
82147,5562,76585,6.770788952,93.22921105,Transportation,4,4
227202,36073,191129,15.87706094,84.12293906,Entertainment,0,0
21002,3004,17998,14.30339968,85.69660032,Housing,3,3
29505,5875,23630,19.91187934,80.08812066,Housing,3,1
97762,44225,53537,45.23741331,54.76258669,Transportation,4,4
185750,31300,154450,16.85060565,83.14939435,Entertainment,0,0
112179,64728,47451,57.70063916,42.29936084,Transportation,4,4
65945,7538,58407,11.43073774,88.56926226,Transportation,4,4
215020,47944,167076,22.2974607,77.7025393,Entertainment,0,0
103519,50206,53313,48.49930931,51.50069069,Transportation,4,4
172311,42189,130122,24.48421749,75.51578251,Healthcare,2,0
39827,21315,18512,53.51896954,46.48103046,Food,1,1
209850,30642,179208,14.60185847,85.39814153,Entertainment,0,0
136471,61233,75238,44.86887324,55.13112676,Healthcare,2,2
27880,675,27205,2.421090387,97.57890961,Housing,3,1
171819,65615,106204,38.18844249,61.81155751,Healthcare,2,0
108890,49802,59088,45.73606392,54.26393608,Transportation,4,4
41516,18270,23246,44.00712978,55.99287022,Food,1,1
115975,10624,105351,9.160594956,90.83940504,Transportation,4,2
69975,12734,57241,18.19792783,81.80207217,Transportation,4,4
69572,734,68838,1.055022135,98.94497786,Transportation,4,4
235289,39306,195983,16.70541334,83.29458666,Entertainment,0,0
71770,39237,32533,54.67047513,45.32952487,Transportation,4,4
232700,57145,175555,24.55737,75.44263,Entertainment,0,0
120875,29438,91437,24.3540848,75.6459152,Healthcare,2,2
76856,41140,35716,53.52867701,46.47132299,Transportation,4,4
14071,8122,5949,57.72155497,42.27844503,Housing,3,3
234781,63686,171095,27.12570438,72.87429562,Entertainment,0,0
205959,40287,165672,19.56068926,80.43931074,Entertainment,0,0
32599,15028,17571,46.09957361,53.90042639,Food,1,1
234835,12608,222227,5.368876019,94.63112398,Entertainment,0,0
195464,35409,160055,18.11535628,81.88464372,Entertainment,0,0
175794,46674,129120,26.55039421,73.44960579,Healthcare,2,0
45951,7563,38388,16.45883659,83.54116341,Food,1,1
136222,21879,114343,16.06128232,83.93871768,Healthcare,2,2
34287,10508,23779,30.64718406,69.35281594,Food,1,1
46597,8358,38239,17.93677705,82.06322295,Food,1,1
140358,69257,71101,49.34310834,50.65689166,Healthcare,2,2
12568,635,11933,5.052514322,94.94748568,Housing,3,3
28086,15301,12785,54.47909991,45.52090009,Housing,3,1
151479,36520,114959,24.1089524,75.8910476,Healthcare,2,0
49249,14329,34920,29.09500701,70.90499299,Food,1,1
125895,3654,122241,2.902418682,97.09758132,Healthcare,2,2
196835,18021,178814,9.155383951,90.84461605,Entertainment,0,0
29558,2250,27308,7.612152378,92.38784762,Housing,3,1
225523,41693,183830,18.48724964,81.51275036,Entertainment,0,0
106694,35883,70811,33.63169438,66.36830562,Transportation,4,2
113186,46158,67028,40.78066192,59.21933808,Transportation,4,4
38028,15646,22382,41.14336804,58.85663196,Food,1,1
182620,36378,146242,19.92005257,80.07994743,Entertainment,0,0
21267,6326,14941,29.74561527,70.25438473,Housing,3,3
33880,13280,20600,39.19716647,60.80283353,Food,1,1
54537,31864,22673,58.42638942,41.57361058,Food,1,1
247236,17515,229721,7.084324289,92.91567571,Entertainment,0,0
15184,8274,6910,54.49157007,45.50842993,Housing,3,3
13407,18,13389,0.134258223,99.86574178,Housing,3,3
126224,22108,104116,17.51489416,82.48510584,Healthcare,2,2
233299,25,233274,0.010715862,99.98928414,Entertainment,0,0
124930,37005,87925,29.62058753,70.37941247,Healthcare,2,2
32303,11304,20999,34.99365384,65.00634616,Food,1,1
160854,66767,94087,41.50782697,58.49217303,Healthcare,2,0
206346,32914,173432,15.95087862,84.04912138,Entertainment,0,0
27870,11986,15884,43.00681737,56.99318263,Housing,3,1
89278,11102,78176,12.43531441,87.56468559,Transportation,4,4
148460,33999,114461,22.90111815,77.09888185,Healthcare,2,2
12993,4558,8435,35.08042792,64.91957208,Housing,3,3
16040,4758,11282,29.66334165,70.33665835,Housing,3,3
85789,10960,74829,12.77553066,87.22446934,Transportation,4,4
163004,59737,103267,36.64756693,63.35243307,Healthcare,2,0
176220,63132,113088,35.82567245,64.17432755,Healthcare,2,0
14976,1755,13221,11.71875,88.28125,Housing,3,3
21945,1789,20156,8.152198679,91.84780132,Housing,3,3
78965,33448,45517,42.35800671,57.64199329,Transportation,4,4
138676,23425,115251,16.89189189,83.10810811,Healthcare,2,2
30634,2231,28403,7.28275772,92.71724228,Food,1,1
212649,61646,151003,28.98955556,71.01044444,Entertainment,0,0
16631,9968,6663,59.9362636,40.0637364,Housing,3,3
175803,37921,137882,21.57016661,78.42983339,Healthcare,2,0
209541,58632,150909,27.98115882,72.01884118,Entertainment,0,0
60788,33288,27500,54.76080805,45.23919195,Transportation,4,4
11118,4985,6133,44.83720094,55.16279906,Housing,3,3
26800,15965,10835,59.57089552,40.42910448,Housing,3,1
29530,5632,23898,19.07213004,80.92786996,Housing,3,1
86860,10617,76243,12.22311766,87.77688234,Transportation,4,4
29049,7873,21176,27.10248201,72.89751799,Housing,3,1
29771,14632,15139,49.14850022,50.85149978,Housing,3,1
17591,2162,15429,12.29037576,87.70962424,Housing,3,3
175591,22010,153581,12.53481101,87.46518899,Healthcare,2,0
59110,12054,47056,20.39248858,79.60751142,Food,1,4
155584,35266,120318,22.6668552,77.3331448,Healthcare,2,0
87144,26938,60206,30.91205361,69.08794639,Transportation,4,4
10951,154,10797,1.406264268,98.59373573,Housing,3,3
12555,638,11917,5.081640781,94.91835922,Housing,3,3
190762,8124,182638,4.258709806,95.74129019,Entertainment,0,0
117395,36924,80471,31.4527876,68.5472124,Transportation,4,2
110313,55875,54438,50.65132849,49.34867151,Transportation,4,4
231476,69439,162037,29.99835836,70.00164164,Entertainment,0,0
55438,3864,51574,6.969948411,93.03005159,Food,1,4
76792,44300,32492,57.68830086,42.31169914,Transportation,4,4
26051,2495,23556,9.577367471,90.42263253,Housing,3,1
158598,19617,138981,12.36900844,87.63099156,Healthcare,2,0
27288,9128,18160,33.450601,66.549399,Housing,3,1
140762,29875,110887,21.22376778,78.77623222,Healthcare,2,2
43609,11634,31975,26.67797932,73.32202068,Food,1,1
16832,2923,13909,17.36573194,82.63426806,Housing,3,3
28228,2084,26144,7.382740541,92.61725946,Housing,3,1
221172,14016,207156,6.337149368,93.66285063,Entertainment,0,0
137883,19067,118816,13.82839074,86.17160926,Healthcare,2,2
94765,13910,80855,14.67841503,85.32158497,Transportation,4,4
44840,6097,38743,13.59723461,86.40276539,Food,1,1
58249,28898,29351,49.61115212,50.38884788,Food,1,4
60007,17654,42353,29.41990101,70.58009899,Transportation,4,4
38846,833,38013,2.144364928,97.85563507,Food,1,1
221238,64245,156993,29.03886312,70.96113688,Entertainment,0,0
86556,1347,85209,1.55621794,98.44378206,Transportation,4,4
226468,46731,179737,20.63470336,79.36529664,Entertainment,0,0
21508,942,20566,4.379765669,95.62023433,Housing,3,3
125277,8965,116312,7.156141989,92.84385801,Healthcare,2,2
210106,32904,177202,15.66066652,84.33933348,Entertainment,0,0
122145,21820,100325,17.86401408,82.13598592,Healthcare,2,2
24392,11303,13089,46.33896359,53.66103641,Housing,3,3
173574,21398,152176,12.32788321,87.67211679,Healthcare,2,0
72707,16423,56284,22.58792138,77.41207862,Transportation,4,4
48149,4486,43663,9.316912085,90.68308791,Food,1,4
27646,14788,12858,53.49055921,46.50944079,Housing,3,1
46685,16054,30631,34.38791903,65.61208097,Food,1,1
10753,2839,7914,26.40193434,73.59806566,Housing,3,3
79744,33807,45937,42.39441212,57.60558788,Transportation,4,4
94407,34609,59798,36.65935789,63.34064211,Transportation,4,4
11826,5035,6791,42.5756807,57.4243193,Housing,3,3
75408,12147,63261,16.10837046,83.89162954,Transportation,4,4
123704,53337,70367,43.11663325,56.88336675,Healthcare,2,4
99642,45176,54466,45.33831115,54.66168885,Transportation,4,4
241452,11212,230240,4.64357305,95.35642695,Entertainment,0,0
17650,2329,15321,13.19546742,86.80453258,Housing,3,3
29154,9412,19742,32.28373465,67.71626535,Housing,3,1
88777,22341,66436,25.16530182,74.83469818,Transportation,4,4
21953,3579,18374,16.30301098,83.69698902,Housing,3,3
140725,54016,86709,38.38408243,61.61591757,Healthcare,2,2
22211,6090,16121,27.41884652,72.58115348,Housing,3,3
120445,42996,77449,35.69762132,64.30237868,Healthcare,2,2
22730,12573,10157,55.31456225,44.68543775,Housing,3,3
17064,8336,8728,48.85138303,51.14861697,Housing,3,3
21303,4970,16333,23.33004741,76.66995259,Housing,3,3
40331,19735,20596,48.93258288,51.06741712,Food,1,1
15755,5068,10687,32.16756585,67.83243415,Housing,3,3
95292,27321,67971,28.67082231,71.32917769,Transportation,4,4
236820,47635,189185,20.1144329,79.8855671,Entertainment,0,0
118567,16209,102358,13.67075156,86.32924844,Transportation,4,2
79840,26820,53020,33.59218437,66.40781563,Transportation,4,4
128149,35896,92253,28.01114328,71.98885672,Healthcare,2,2
226219,26888,199331,11.88582745,88.11417255,Entertainment,0,0
175355,30590,144765,17.44461236,82.55538764,Healthcare,2,0
249184,8500,240684,3.411133941,96.58886606,Entertainment,0,0
214914,33269,181645,15.48014555,84.51985445,Entertainment,0,0
16668,5709,10959,34.2512599,65.7487401,Housing,3,3
55225,953,54272,1.725667723,98.27433228,Food,1,4
201843,13283,188560,6.580857399,93.4191426,Entertainment,0,0
20065,1507,18558,7.510590581,92.48940942,Housing,3,3
36112,2231,33881,6.178001772,93.82199823,Food,1,1
70604,35117,35487,49.73797519,50.26202481,Transportation,4,4
90965,33031,57934,36.31176826,63.68823174,Transportation,4,4
58635,10463,48172,17.84429095,82.15570905,Food,1,4
169971,25291,144680,14.87959711,85.12040289,Healthcare,2,0
94285,45352,48933,48.10097046,51.89902954,Transportation,4,4
198404,55708,142696,28.07806294,71.92193706,Entertainment,0,0
200685,14952,185733,7.450482099,92.5495179,Entertainment,0,0
230037,29033,201004,12.62101314,87.37898686,Entertainment,0,0
32825,10175,22650,30.99771516,69.00228484,Food,1,1
214805,10819,203986,5.036661158,94.96333884,Entertainment,0,0
54719,21598,33121,39.47075056,60.52924944,Food,1,4
57038,429,56609,0.752130159,99.24786984,Food,1,4
228747,28970,199777,12.66464697,87.33535303,Entertainment,0,0
207301,33829,173472,16.31878283,83.68121717,Entertainment,0,0
203045,23910,179135,11.77571474,88.22428526,Entertainment,0,0
146925,7331,139594,4.989620555,95.01037945,Healthcare,2,2
23696,917,22779,3.869851452,96.13014855,Housing,3,3
58272,17774,40498,30.50178473,69.49821527,Food,1,4
49524,10627,38897,21.45828285,78.54171715,Food,1,1
142598,50991,91607,35.75856604,64.24143396,Healthcare,2,2
59084,32880,26204,55.64958364,44.35041636,Food,1,4
26239,11975,14264,45.63817219,54.36182781,Housing,3,1
178112,41379,136733,23.23201132,76.76798868,Healthcare,2,0
74863,36932,37931,49.33278121,50.66721879,Transportation,4,4
91328,40487,50841,44.33142081,55.66857919,Transportation,4,4
22598,8448,14150,37.38383928,62.61616072,Housing,3,3
11098,1686,9412,15.19192647,84.80807353,Housing,3,3
203804,13886,189918,6.813408962,93.18659104,Entertainment,0,0
249352,22410,226942,8.987295069,91.01270493,Entertainment,0,0
154574,11748,142826,7.600243249,92.39975675,Healthcare,2,0
171653,18397,153256,10.71755227,89.28244773,Healthcare,2,0
58133,23088,35045,39.71582406,60.28417594,Food,1,4
137073,55755,81318,40.67540654,59.32459346,Healthcare,2,2
12817,2991,9826,23.33619412,76.66380588,Housing,3,3
39860,12161,27699,30.50928249,69.49071751,Food,1,1
41154,24481,16673,59.48631968,40.51368032,Food,1,1
26084,818,25266,3.136022083,96.86397792,Housing,3,1
81281,38657,42624,47.5597003,52.4402997,Transportation,4,4
245570,42586,202984,17.34169483,82.65830517,Entertainment,0,0
11258,1735,9523,15.4112631,84.5887369,Housing,3,3
90564,33836,56728,37.36142397,62.63857603,Transportation,4,4
85477,5210,80267,6.095206898,93.9047931,Transportation,4,4
10401,660,9741,6.345543698,93.6544563,Housing,3,3
154896,48304,106592,31.18479496,68.81520504,Healthcare,2,0
205770,52958,152812,25.73650192,74.26349808,Entertainment,0,0
17185,7944,9241,46.2263602,53.7736398,Housing,3,3
27606,6770,20836,24.52365428,75.47634572,Housing,3,1
230727,30111,200616,13.05048824,86.94951176,Entertainment,0,0
227822,60602,167220,26.60059169,73.39940831,Entertainment,0,0
91874,26624,65250,28.97881882,71.02118118,Transportation,4,4
147070,24664,122406,16.77024546,83.22975454,Healthcare,2,2
33625,16503,17122,49.0795539,50.9204461,Food,1,1
69899,15120,54779,21.63121075,78.36878925,Transportation,4,4
47473,11401,36072,24.01575632,75.98424368,Food,1,1
52431,24009,28422,45.79161183,54.20838817,Food,1,4
86913,9461,77452,10.88559824,89.11440176,Transportation,4,4
97371,34670,62701,35.60608395,64.39391605,Transportation,4,4
213726,27656,186070,12.93993244,87.06006756,Entertainment,0,0
72370,41479,30891,57.31518585,42.68481415,Transportation,4,4
39827,3750,36077,9.415723002,90.584277,Food,1,1
44370,1428,42942,3.218390805,96.7816092,Food,1,4
47342,27113,20229,57.27049977,42.72950023,Food,1,1
224782,25266,199516,11.24022386,88.75977614,Entertainment,0,0
15702,3314,12388,21.10559164,78.89440836,Housing,3,3
148372,64198,84174,43.26827164,56.73172836,Healthcare,2,2
140023,28689,111334,20.48877684,79.51122316,Healthcare,2,2
203533,19638,183895,9.648558219,90.35144178,Entertainment,0,0
23577,9453,14124,40.09415956,59.90584044,Housing,3,3
60563,5622,54941,9.282895497,90.7171045,Transportation,4,4
61033,17600,43433,28.83685875,71.16314125,Transportation,4,4
126239,44805,81434,35.4922013,64.5077987,Healthcare,2,2
20531,5790,14741,28.20125664,71.79874336,Housing,3,3
49917,28146,21771,56.3856001,43.6143999,Food,1,1
178291,47077,131214,26.40458576,73.59541424,Healthcare,2,0
68702,867,67835,1.261971995,98.73802801,Transportation,4,4
44672,1456,43216,3.259312321,96.74068768,Food,1,4
17307,1056,16251,6.101577396,93.8984226,Housing,3,3
20168,9397,10771,46.59361365,53.40638635,Housing,3,3
10762,3772,6990,35.04924735,64.95075265,Housing,3,3
95902,55496,40406,57.86740631,42.13259369,Transportation,4,4
66738,17647,49091,26.44220684,73.55779316,Transportation,4,4
142701,25968,116733,18.19748986,81.80251014,Healthcare,2,2
246967,57375,189592,23.23184879,76.76815121,Entertainment,0,0
25846,13147,12699,50.86667183,49.13332817,Housing,3,1
116250,38785,77465,33.36344086,66.63655914,Transportation,4,2
59759,7957,51802,13.31514918,86.68485082,Food,1,4
246998,9763,237235,3.952663584,96.04733642,Entertainment,0,0
29809,5597,24212,18.77620853,81.22379147,Housing,3,1
113829,54372,59457,47.76638642,52.23361358,Transportation,4,4
27985,12947,15038,46.26407004,53.73592996,Housing,3,1
136625,58141,78484,42.55516926,57.44483074,Healthcare,2,2
86608,49332,37276,56.96009607,43.03990393,Transportation,4,4
126713,42699,84014,33.69741068,66.30258932,Healthcare,2,2
22739,10242,12497,45.04155856,54.95844144,Housing,3,3
42652,14378,28274,33.71002532,66.28997468,Food,1,1
197472,13293,184179,6.731587263,93.26841274,Entertainment,0,0
41905,15138,26767,36.12456747,63.87543253,Food,1,1
49389,14630,34759,29.6219806,70.3780194,Food,1,1
14421,7280,7141,50.48193607,49.51806393,Housing,3,3
215376,39841,175535,18.49834708,81.50165292,Entertainment,0,0
58850,1605,57245,2.727272727,97.27272727,Food,1,4
85090,33887,51203,39.82489129,60.17510871,Transportation,4,4
113463,26022,87441,22.93434864,77.06565136,Transportation,4,2
102865,36066,66799,35.06148836,64.93851164,Transportation,4,2
106166,62218,43948,58.60444964,41.39555036,Transportation,4,4
15895,5805,10090,36.52091853,63.47908147,Housing,3,3
145409,40292,105117,27.70942651,72.29057349,Healthcare,2,2
179690,1024,178666,0.569870332,99.43012967,Healthcare,2,0
93599,26950,66649,28.79304266,71.20695734,Transportation,4,4
40335,19153,21182,47.48481468,52.51518532,Food,1,1
154479,24892,129587,16.11351705,83.88648295,Healthcare,2,0
49807,17222,32585,34.57746903,65.42253097,Food,1,1
20610,10393,10217,50.4269772,49.5730228,Housing,3,3
138402,2693,135709,1.94578113,98.05421887,Healthcare,2,2
16431,3028,13403,18.42858012,81.57141988,Housing,3,3
19912,8297,11615,41.6683407,58.3316593,Housing,3,3
221219,22153,199066,10.01405847,89.98594153,Entertainment,0,0
228482,27020,201462,11.82587687,88.17412313,Entertainment,0,0
50002,16176,33826,32.35070597,67.64929403,Food,1,4
249814,36555,213259,14.63288687,85.36711313,Entertainment,0,0
41340,1045,40295,2.527818094,97.47218191,Food,1,1
105089,62988,42101,59.93776704,40.06223296,Transportation,4,4
42418,15843,26575,37.34971003,62.65028997,Food,1,1
118084,36740,81344,31.11344467,68.88655533,Transportation,4,2
56718,33907,22811,59.78172714,40.21827286,Food,1,1
124850,55518,69332,44.46776131,55.53223869,Healthcare,2,4
150276,68602,81674,45.65066943,54.34933057,Healthcare,2,0
101483,28220,73263,27.8076131,72.1923869,Transportation,4,2
47809,9106,38703,19.04662302,80.95337698,Food,1,1
70413,14833,55580,21.0657123,78.9342877,Transportation,4,4
38386,11901,26485,31.00349086,68.99650914,Food,1,1
135856,66438,69418,48.9032505,51.0967495,Healthcare,2,4
139286,65671,73615,47.14831354,52.85168646,Healthcare,2,2
80330,30973,49357,38.55720154,61.44279846,Transportation,4,4
78407,4539,73868,5.789023939,94.21097606,Transportation,4,4
198329,17561,180768,8.854479173,91.14552083,Entertainment,0,0
46145,17571,28574,38.07779824,61.92220176,Food,1,1
24076,12356,11720,51.32081741,48.67918259,Housing,3,3
58046,25718,32328,44.30623988,55.69376012,Food,1,4
180421,53088,127333,29.42451267,70.57548733,Entertainment,0,0
45860,22154,23706,48.30789359,51.69210641,Food,1,1
186925,3261,183664,1.744549953,98.25545005,Entertainment,0,0
57027,10430,46597,18.28958213,81.71041787,Food,1,4
167233,54308,112925,32.47445181,67.52554819,Healthcare,2,0
61624,4093,57531,6.641892769,93.35810723,Transportation,4,4
73459,32956,40503,44.86312092,55.13687908,Transportation,4,4
47902,24250,23652,50.62419106,49.37580894,Food,1,1
85715,40310,45405,47.02794143,52.97205857,Transportation,4,4
161258,32191,129067,19.96242047,80.03757953,Healthcare,2,0
145306,3002,142304,2.065984887,97.93401511,Healthcare,2,2
28327,16278,12049,57.46460974,42.53539026,Housing,3,1
43406,23431,19975,53.98101645,46.01898355,Food,1,1
179282,1812,177470,1.01069823,98.98930177,Healthcare,2,0
59735,30002,29733,50.22516113,49.77483887,Food,1,4
38344,22596,15748,58.92968913,41.07031087,Food,1,1
86190,42461,43729,49.26441583,50.73558417,Transportation,4,4
189889,56445,133444,29.72526055,70.27473945,Entertainment,0,0
46685,16565,30120,35.48248902,64.51751098,Food,1,1
49568,25231,24337,50.90179148,49.09820852,Food,1,1
73397,37070,36327,50.50615148,49.49384852,Transportation,4,4
31254,2020,29234,6.463172714,93.53682729,Food,1,1
160459,29823,130636,18.58605625,81.41394375,Healthcare,2,0
179329,59714,119615,33.29857413,66.70142587,Healthcare,2,0
211043,20559,190484,9.741616637,90.25838336,Entertainment,0,0
61508,33647,27861,54.70345321,45.29654679,Transportation,4,4
167644,43325,124319,25.84345399,74.15654601,Healthcare,2,0
81753,39039,42714,47.75237606,52.24762394,Transportation,4,4
105894,21451,84443,20.2570495,79.7429505,Transportation,4,2
106224,17213,89011,16.20443591,83.79556409,Transportation,4,2
22281,90,22191,0.403931601,99.5960684,Housing,3,3
232593,28495,204098,12.25101357,87.74898643,Entertainment,0,0
239738,6701,233037,2.795134689,97.20486531,Entertainment,0,0
132351,66340,66011,50.12429071,49.87570929,Healthcare,2,4
24271,14155,10116,58.32062956,41.67937044,Housing,3,3
122455,35400,87055,28.90857866,71.09142134,Healthcare,2,2
28318,5109,23209,18.04152836,81.95847164,Housing,3,1
47430,13449,33981,28.35547122,71.64452878,Food,1,1
180731,41892,138839,23.17920003,76.82079997,Entertainment,0,0
21878,5517,16361,25.21711308,74.78288692,Housing,3,3
60774,13764,47010,22.64784283,77.35215717,Transportation,4,4
202143,55603,146540,27.50676501,72.49323499,Entertainment,0,0
166740,4619,162121,2.77018112,97.22981888,Healthcare,2,0
105348,3200,102148,3.037551733,96.96244827,Transportation,4,2
24985,13506,11479,54.05643386,45.94356614,Housing,3,3
11789,199,11590,1.688014251,98.31198575,Housing,3,3
195603,19779,175824,10.1118081,89.8881919,Entertainment,0,0
101082,11007,90075,10.88917908,89.11082092,Transportation,4,2
15341,6274,9067,40.89694283,59.10305717,Housing,3,3
209354,43197,166157,20.63347249,79.36652751,Entertainment,0,0
59853,1810,58043,3.024075652,96.97592435,Food,1,4
24394,14207,10187,58.23973108,41.76026892,Housing,3,3
206960,52524,154436,25.37881716,74.62118284,Entertainment,0,0
33820,19602,14218,57.95978711,42.04021289,Food,1,1
75177,17016,58161,22.63458239,77.36541761,Transportation,4,4
171195,63795,107400,37.26452291,62.73547709,Healthcare,2,0
247942,66236,181706,26.71431222,73.28568778,Entertainment,0,0
51378,815,50563,1.586282066,98.41371793,Food,1,4
56093,15762,40331,28.09976289,71.90023711,Food,1,4
102295,44971,57324,43.96207048,56.03792952,Transportation,4,4
82962,8532,74430,10.28422651,89.71577349,Transportation,4,4
195457,39689,155768,20.305745,79.694255,Entertainment,0,0
183196,2023,181173,1.104281753,98.89571825,Entertainment,0,0
37219,19061,18158,51.21309009,48.78690991,Food,1,1
32077,11457,20620,35.71718053,64.28281947,Food,1,1
54346,13724,40622,25.2530085,74.7469915,Food,1,4
229692,29031,200661,12.63909932,87.36090068,Entertainment,0,0
66231,14248,51983,21.51258474,78.48741526,Transportation,4,4
45696,18709,26987,40.94231443,59.05768557,Food,1,1
56424,3895,52529,6.903090883,93.09690912,Food,1,4
12624,4939,7685,39.123891,60.876109,Housing,3,3
50672,5629,45043,11.10869908,88.89130092,Food,1,4
107454,50777,56677,47.25463919,52.74536081,Transportation,4,4
184486,49273,135213,26.70825971,73.29174029,Entertainment,0,0
178446,3326,175120,1.863869182,98.13613082,Healthcare,2,0
61566,34691,26875,56.34765942,43.65234058,Transportation,4,4
184148,24340,159808,13.2176293,86.7823707,Entertainment,0,0
16274,3184,13090,19.56495023,80.43504977,Housing,3,3
139475,56217,83258,40.30614806,59.69385194,Healthcare,2,2
54630,13516,41114,24.74098481,75.25901519,Food,1,4
13971,1013,12958,7.250733663,92.74926634,Housing,3,3
13853,1095,12758,7.904425034,92.09557497,Housing,3,3
172667,31411,141256,18.19166372,81.80833628,Healthcare,2,0
131396,60714,70682,46.20688605,53.79311395,Healthcare,2,4
36391,15048,21343,41.35088346,58.64911654,Food,1,1
20349,3751,16598,18.43333825,81.56666175,Housing,3,3
24523,5128,19395,20.91098153,79.08901847,Housing,3,3
95298,55976,39322,58.73785389,41.26214611,Transportation,4,4
69511,15156,54355,21.80374329,78.19625671,Transportation,4,4
156372,22190,134182,14.19052004,85.80947996,Healthcare,2,0
208191,18058,190133,8.673765917,91.32623408,Entertainment,0,0
38333,19165,19168,49.99608692,50.00391308,Food,1,1
38987,22841,16146,58.5861954,41.4138046,Food,1,1
12160,4241,7919,34.87664474,65.12335526,Housing,3,3
238913,27136,211777,11.35810944,88.64189056,Entertainment,0,0
143268,30816,112452,21.50933914,78.49066086,Healthcare,2,2
133422,15984,117438,11.98003328,88.01996672,Healthcare,2,2
23584,10602,12982,44.95420624,55.04579376,Housing,3,3
45932,12984,32948,28.26787425,71.73212575,Food,1,1
32748,1744,31004,5.325516062,94.67448394,Food,1,1
169123,53175,115948,31.4416135,68.5583865,Healthcare,2,0
183107,39222,143885,21.42026247,78.57973753,Entertainment,0,0
25044,7369,17675,29.42421338,70.57578662,Housing,3,1
85120,1304,83816,1.531954887,98.46804511,Transportation,4,4
222877,56962,165915,25.55759455,74.44240545,Entertainment,0,0
244677,4040,240637,1.651156423,98.34884358,Entertainment,0,0
19172,7042,12130,36.73064886,63.26935114,Housing,3,3
21287,2578,18709,12.11067788,87.88932212,Housing,3,3
57085,21945,35140,38.44267321,61.55732679,Food,1,4
14959,7239,7720,48.39227221,51.60772779,Housing,3,3
230824,20349,210475,8.815807715,91.18419229,Entertainment,0,0
128247,6417,121830,5.003625816,94.99637418,Healthcare,2,2
75759,18864,56895,24.90001188,75.09998812,Transportation,4,4
102073,7617,94456,7.462306389,92.53769361,Transportation,4,2
39683,9432,30251,23.76836429,76.23163571,Food,1,1
156892,11241,145651,7.164801265,92.83519874,Healthcare,2,0
213433,31717,181716,14.86040116,85.13959884,Entertainment,0,0
13642,2813,10829,20.62014367,79.37985633,Housing,3,3
220112,28672,191440,13.02609581,86.97390419,Entertainment,0,0
21973,8682,13291,39.51212852,60.48787148,Housing,3,3
58967,21953,37014,37.22929774,62.77070226,Food,1,4
185707,31732,153975,17.08713188,82.91286812,Entertainment,0,0
127156,54907,72249,43.18081726,56.81918274,Healthcare,2,2
126905,64986,61919,51.20838422,48.79161578,Healthcare,2,4
24893,13252,11641,53.23584944,46.76415056,Housing,3,3
35806,15835,19971,44.22443166,55.77556834,Food,1,1
187165,18728,168437,10.00614431,89.99385569,Entertainment,0,0
135372,18265,117107,13.49245043,86.50754957,Healthcare,2,2
122859,10965,111894,8.924865089,91.07513491,Healthcare,2,2
51633,2424,49209,4.694672012,95.30532799,Food,1,4
124421,23956,100465,19.25398446,80.74601554,Healthcare,2,2
102063,4447,97616,4.357112764,95.64288724,Transportation,4,2
242758,973,241785,0.400810684,99.59918932,Entertainment,0,0
21401,3258,18143,15.22358768,84.77641232,Housing,3,3
15525,6729,8796,43.34299517,56.65700483,Housing,3,3
51495,17236,34259,33.4712108,66.5287892,Food,1,4
135363,18179,117184,13.42981465,86.57018535,Healthcare,2,2
107128,37215,69913,34.73881712,65.26118288,Transportation,4,2
232774,68315,164459,29.34820899,70.65179101,Entertainment,0,0
27254,5448,21806,19.98972628,80.01027372,Housing,3,1
120926,16139,104787,13.34617865,86.65382135,Healthcare,2,2
205886,69039,136847,33.53263456,66.46736544,Entertainment,0,0
118013,3603,114410,3.053053477,96.94694652,Transportation,4,2
77494,32867,44627,42.41231579,57.58768421,Transportation,4,4
91581,26084,65497,28.48189035,71.51810965,Transportation,4,4
17014,3005,14009,17.66192547,82.33807453,Housing,3,3
151676,48186,103490,31.76903399,68.23096601,Healthcare,2,0
56768,16482,40286,29.0339628,70.9660372,Food,1,4
46498,26659,19839,57.33364876,42.66635124,Food,1,1
54331,10578,43753,19.46954777,80.53045223,Food,1,4
16686,2490,14196,14.92268968,85.07731032,Housing,3,3
127816,54512,73304,42.64880766,57.35119234,Healthcare,2,2
225098,8175,216923,3.631751504,96.3682485,Entertainment,0,0
226003,43643,182360,19.31080561,80.68919439,Entertainment,0,0
73765,2165,71600,2.934996272,97.06500373,Transportation,4,4
26340,10419,15921,39.55580866,60.44419134,Housing,3,1
43619,15100,28519,34.61794172,65.38205828,Food,1,1
153026,5844,147182,3.81895887,96.18104113,Healthcare,2,0
219931,30310,189621,13.78159514,86.21840486,Entertainment,0,0
13161,120,13041,0.911784819,99.08821518,Housing,3,3
31628,4572,27056,14.45554572,85.54445428,Food,1,1
75007,26908,48099,35.87398509,64.12601491,Transportation,4,4
47036,24786,22250,52.69580747,47.30419253,Food,1,1
148308,4897,143411,3.301912237,96.69808776,Healthcare,2,2
25896,9417,16479,36.36468953,63.63531047,Housing,3,1
15806,3675,12131,23.2506643,76.7493357,Housing,3,3
142831,64246,78585,44.98043142,55.01956858,Healthcare,2,2
171872,61360,110512,35.70098678,64.29901322,Healthcare,2,0
104796,23292,81504,22.22603916,77.77396084,Transportation,4,2
33870,9455,24415,27.91555949,72.08444051,Food,1,1
25359,7526,17833,29.67782641,70.32217359,Housing,3,1
140681,3460,137221,2.459465031,97.54053497,Healthcare,2,2
57510,31598,25912,54.94348809,45.05651191,Food,1,4
81975,10456,71519,12.75510826,87.24489174,Transportation,4,4
37475,21016,16459,56.08005337,43.91994663,Food,1,1
196731,16381,180350,8.326598248,91.67340175,Entertainment,0,0
32454,5740,26714,17.68657176,82.31342824,Food,1,1
21208,10196,11012,48.07619766,51.92380234,Housing,3,3
18855,4071,14784,21.5910899,78.4089101,Housing,3,3
40060,7475,32585,18.65951073,81.34048927,Food,1,1
247077,17472,229605,7.071479741,92.92852026,Entertainment,0,0
130932,65303,65629,49.8755079,50.1244921,Healthcare,2,4
108912,54664,54248,50.19097987,49.80902013,Transportation,4,4
153893,20113,133780,13.06947035,86.93052965,Healthcare,2,0
71223,2574,68649,3.614001095,96.3859989,Transportation,4,4
75007,26337,48670,35.11272281,64.88727719,Transportation,4,4
226433,26706,199727,11.79421727,88.20578273,Entertainment,0,0
57047,18605,38442,32.61345908,67.38654092,Food,1,4
127247,13113,114134,10.30515454,89.69484546,Healthcare,2,2
11101,1023,10078,9.215386001,90.784614,Housing,3,3
52692,351,52341,0.666135277,99.33386472,Food,1,4
20050,1163,18887,5.800498753,94.19950125,Housing,3,3
30970,13534,17436,43.70035518,56.29964482,Food,1,1
47032,3013,44019,6.406276578,93.59372342,Food,1,4
43220,7660,35560,17.72327626,82.27672374,Food,1,1
157333,61723,95610,39.23080346,60.76919654,Healthcare,2,0
140292,34568,105724,24.6400365,75.3599635,Healthcare,2,2
59072,19053,40019,32.2538597,67.7461403,Food,1,4
27400,9901,17499,36.1350365,63.8649635,Housing,3,1
110592,48207,62385,43.58995226,56.41004774,Transportation,4,4
224620,62990,161630,28.04291693,71.95708307,Entertainment,0,0
37577,109,37468,0.290071054,99.70992895,Food,1,1
174423,33728,140695,19.33689938,80.66310062,Healthcare,2,0
56754,25476,31278,44.88846601,55.11153399,Food,1,4
56514,8814,47700,15.59613547,84.40386453,Food,1,4
101159,54717,46442,54.09009579,45.90990421,Transportation,4,4
17297,6788,10509,39.2437995,60.7562005,Housing,3,3
134351,35788,98563,26.63768785,73.36231215,Healthcare,2,2
12672,733,11939,5.784406566,94.21559343,Housing,3,3
14959,6901,8058,46.13276289,53.86723711,Housing,3,3
248662,16593,232069,6.672913433,93.32708657,Entertainment,0,0
163904,10827,153077,6.605696017,93.39430398,Healthcare,2,0
13815,1735,12080,12.55881288,87.44118712,Housing,3,3
237385,64384,173001,27.12218548,72.87781452,Entertainment,0,0
129556,29292,100264,22.60952793,77.39047207,Healthcare,2,2
32472,4371,28101,13.46082779,86.53917221,Food,1,1
100002,44736,55266,44.7351053,55.2648947,Transportation,4,4
19352,9428,9924,48.71847871,51.28152129,Housing,3,3
18194,7060,11134,38.80400132,61.19599868,Housing,3,3
53715,23706,30009,44.13292376,55.86707624,Food,1,4
151013,18,150995,0.011919504,99.9880805,Healthcare,2,0
121281,68110,53171,56.15883774,43.84116226,Healthcare,2,4
189685,63412,126273,33.43016053,66.56983947,Entertainment,0,0
179417,64095,115322,35.72403953,64.27596047,Healthcare,2,0
179863,52396,127467,29.13106086,70.86893914,Healthcare,2,0
155119,214,154905,0.1379586,99.8620414,Healthcare,2,0
172124,68571,103553,39.83813995,60.16186005,Healthcare,2,0
59623,14693,44930,24.64317461,75.35682539,Food,1,4
72167,26358,45809,36.52361883,63.47638117,Transportation,4,4
154940,52571,102369,33.92990835,66.07009165,Healthcare,2,0
64478,16103,48375,24.97440988,75.02559012,Transportation,4,4
11220,4257,6963,37.94117647,62.05882353,Housing,3,3
135849,16541,119308,12.17601896,87.82398104,Healthcare,2,2
193220,38793,154427,20.07711417,79.92288583,Entertainment,0,0
211226,41619,169607,19.70354028,80.29645972,Entertainment,0,0
223088,31901,191187,14.29973822,85.70026178,Entertainment,0,0
23553,7417,16136,31.49068059,68.50931941,Housing,3,3
243359,65329,178030,26.84470268,73.15529732,Entertainment,0,0
26757,11341,15416,42.38517024,57.61482976,Housing,3,1
191635,68283,123352,35.63180004,64.36819996,Entertainment,0,0
142702,34235,108467,23.99055374,76.00944626,Healthcare,2,2
60787,10232,50555,16.83254643,83.16745357,Transportation,4,4
15250,1876,13374,12.30163934,87.69836066,Housing,3,3
46532,7978,38554,17.14519041,82.85480959,Food,1,1
109483,53240,56243,48.6285542,51.3714458,Transportation,4,4
76468,7004,69464,9.159386933,90.84061307,Transportation,4,4
246984,3307,243677,1.338953131,98.66104687,Entertainment,0,0
243082,32430,210652,13.34117705,86.65882295,Entertainment,0,0
154814,58089,96725,37.52180035,62.47819965,Healthcare,2,0
22487,8006,14481,35.60279272,64.39720728,Housing,3,3
215035,65050,149985,30.25088939,69.74911061,Entertainment,0,0
179758,13127,166631,7.302595712,92.69740429,Healthcare,2,0
29629,14819,14810,50.01518782,49.98481218,Housing,3,1
10505,22,10483,0.209424084,99.79057592,Housing,3,3
97136,28252,68884,29.08499423,70.91500577,Transportation,4,4
107123,39809,67314,37.16195402,62.83804598,Transportation,4,2
46261,8274,37987,17.88547589,82.11452411,Food,1,1
10070,739,9331,7.338629593,92.66137041,Housing,3,3
227008,55821,171187,24.58988229,75.41011771,Entertainment,0,0
58266,25640,32626,44.00508015,55.99491985,Food,1,4
90133,44140,45993,48.9720746,51.0279254,Transportation,4,4
132538,55209,77329,41.65522341,58.34477659,Healthcare,2,2
10545,4861,5684,46.09767662,53.90232338,Housing,3,3
105633,13356,92277,12.64377609,87.35622391,Transportation,4,2
110721,40674,70047,36.73557862,63.26442138,Transportation,4,2
168390,38975,129415,23.14567373,76.85432627,Healthcare,2,0
41919,4174,37745,9.9572986,90.0427014,Food,1,1
35998,19776,16222,54.93638535,45.06361465,Food,1,1
157146,48861,108285,31.09274178,68.90725822,Healthcare,2,0
171662,67277,104385,39.19155084,60.80844916,Healthcare,2,0
72967,9689,63278,13.2786054,86.7213946,Transportation,4,4
237072,49879,187193,21.03959978,78.96040022,Entertainment,0,0
11212,5411,5801,48.26079201,51.73920799,Housing,3,3
40311,11562,28749,28.68199747,71.31800253,Food,1,1
38106,21210,16896,55.6605259,44.3394741,Food,1,1
231905,57596,174309,24.836032,75.163968,Entertainment,0,0
28723,13725,14998,47.78400585,52.21599415,Housing,3,1
126256,56622,69634,44.84697757,55.15302243,Healthcare,2,4
27527,10518,17009,38.20975769,61.79024231,Housing,3,1
234052,15562,218490,6.648949806,93.35105019,Entertainment,0,0
23553,11404,12149,48.41846049,51.58153951,Housing,3,3
93417,38327,55090,41.02786431,58.97213569,Transportation,4,4
40902,3759,37143,9.190259645,90.80974035,Food,1,1
167728,54772,112956,32.65525136,67.34474864,Healthcare,2,0
191344,1261,190083,0.659022494,99.34097751,Entertainment,0,0
135222,1647,133575,1.217997071,98.78200293,Healthcare,2,2
17277,10363,6914,59.98147827,40.01852173,Housing,3,3
18652,3049,15603,16.34677246,83.65322754,Housing,3,3
42204,1561,40643,3.698701545,96.30129846,Food,1,4
20053,5271,14782,26.28534384,73.71465616,Housing,3,3
97465,33948,63517,34.83096496,65.16903504,Transportation,4,4
48560,20226,28334,41.65156507,58.34843493,Food,1,1
47877,27070,20807,56.54071893,43.45928107,Food,1,1
131248,435,130813,0.331433622,99.66856638,Healthcare,2,2
220715,50941,169774,23.07999003,76.92000997,Entertainment,0,0
133231,28326,104905,21.26081768,78.73918232,Healthcare,2,2
132304,46156,86148,34.88632241,65.11367759,Healthcare,2,2
59266,16734,42532,28.23541322,71.76458678,Food,1,4
103205,41841,61364,40.54164042,59.45835958,Transportation,4,4
238712,40673,198039,17.03852341,82.96147659,Entertainment,0,0
181655,4815,176840,2.650628939,97.34937106,Entertainment,0,0
101441,60082,41359,59.22851707,40.77148293,Transportation,4,4
21990,9179,12811,41.74170077,58.25829923,Housing,3,3
119965,53849,66116,44.88725878,55.11274122,Transportation,4,4
24346,12128,12218,49.81516471,50.18483529,Housing,3,3
122653,37721,84932,30.75424164,69.24575836,Healthcare,2,2
68887,24556,44331,35.64678386,64.35321614,Transportation,4,4
58016,34625,23391,59.68181191,40.31818809,Food,1,1
178262,21586,156676,12.10914272,87.89085728,Healthcare,2,0
57527,7451,50076,12.95217898,87.04782102,Food,1,4
23378,12637,10741,54.05509453,45.94490547,Housing,3,3
95840,12359,83481,12.89545075,87.10454925,Transportation,4,4
122797,42779,80018,34.83717029,65.16282971,Healthcare,2,2
161385,66299,95086,41.0812653,58.9187347,Healthcare,2,0
170099,62539,107560,36.76623613,63.23376387,Healthcare,2,0
245494,33693,211801,13.72457168,86.27542832,Entertainment,0,0
219420,38388,181032,17.49521466,82.50478534,Entertainment,0,0
127118,20694,106424,16.27936248,83.72063752,Healthcare,2,2
204894,5381,199513,2.626236005,97.373764,Entertainment,0,0
247705,4775,242930,1.927696252,98.07230375,Entertainment,0,0
37626,3259,34367,8.661563812,91.33843619,Food,1,1
128253,45775,82478,35.69117292,64.30882708,Healthcare,2,2
53685,9907,43778,18.4539443,81.5460557,Food,1,4
80971,5657,75314,6.98645194,93.01354806,Transportation,4,4
170652,30372,140280,17.79762323,82.20237677,Healthcare,2,0
162592,50936,111656,31.32749459,68.67250541,Healthcare,2,0
27316,9684,17632,35.45174989,64.54825011,Housing,3,1
27738,4052,23686,14.60811883,85.39188117,Housing,3,1
11190,2588,8602,23.12779267,76.87220733,Housing,3,3
243886,42863,201023,17.57501456,82.42498544,Entertainment,0,0
44681,13218,31463,29.58304425,70.41695575,Food,1,1
227805,43385,184420,19.04479709,80.95520291,Entertainment,0,0
121802,11074,110728,9.091804732,90.90819527,Healthcare,2,2
219971,60035,159936,27.29223398,72.70776602,Entertainment,0,0
34374,1349,33025,3.924477803,96.0755222,Food,1,1
33415,11392,22023,34.09247344,65.90752656,Food,1,1
73918,13095,60823,17.71557672,82.28442328,Transportation,4,4
65068,5749,59319,8.835372226,91.16462777,Transportation,4,4
48159,15142,33017,31.44168276,68.55831724,Food,1,1
134203,30701,103502,22.87653778,77.12346222,Healthcare,2,2
128929,11266,117663,8.738142699,91.2618573,Healthcare,2,2
43349,6044,37305,13.9426515,86.0573485,Food,1,1
26129,15166,10963,58.04278771,41.95721229,Housing,3,1
241046,20919,220127,8.678426524,91.32157348,Entertainment,0,0
32196,18082,14114,56.16225618,43.83774382,Food,1,1
41708,11593,30115,27.79562674,72.20437326,Food,1,1
89691,27124,62567,30.2416073,69.7583927,Transportation,4,4
233411,9074,224337,3.88756314,96.11243686,Entertainment,0,0
14708,1739,12969,11.82349742,88.17650258,Housing,3,3
221066,29931,191135,13.53939547,86.46060453,Entertainment,0,0
180946,23510,157436,12.99282659,87.00717341,Entertainment,0,0
27790,6813,20977,24.51601295,75.48398705,Housing,3,1
58416,10281,48135,17.59963024,82.40036976,Food,1,4
191906,27887,164019,14.53159359,85.46840641,Entertainment,0,0
42383,19918,22465,46.99525753,53.00474247,Food,1,1
52638,25973,26665,49.34268019,50.65731981,Food,1,4
26976,8828,18148,32.72538553,67.27461447,Housing,3,1
27136,656,26480,2.41745283,97.58254717,Housing,3,1
212010,18745,193265,8.841564077,91.15843592,Entertainment,0,0
49587,26981,22606,54.41143848,45.58856152,Food,1,1
120168,65449,54719,54.46458292,45.53541708,Healthcare,2,4
45813,2890,42923,6.308253116,93.69174688,Food,1,4
109907,61913,47994,56.33217175,43.66782825,Transportation,4,4
247250,52681,194569,21.30677452,78.69322548,Entertainment,0,0
116995,58631,58364,50.11410744,49.88589256,Transportation,4,4
66917,16623,50294,24.84122121,75.15877879,Transportation,4,4
160786,60866,99920,37.85528591,62.14471409,Healthcare,2,0
29018,7994,21024,27.54841822,72.45158178,Housing,3,1
93862,4032,89830,4.295668108,95.70433189,Transportation,4,4
233050,46960,186090,20.15018236,79.84981764,Entertainment,0,0
196049,46519,149530,23.72825161,76.27174839,Entertainment,0,0
14480,8341,6139,57.60359116,42.39640884,Housing,3,3
192128,62145,129983,32.34562375,67.65437625,Entertainment,0,0
47439,1836,45603,3.870233352,96.12976665,Food,1,4
12080,5845,6235,48.38576159,51.61423841,Housing,3,3
169899,50761,119138,29.87716231,70.12283769,Healthcare,2,0
28937,15125,13812,52.26872171,47.73127829,Housing,3,1
43625,25852,17773,59.25959885,40.74040115,Food,1,1
185536,48315,137221,26.04076837,73.95923163,Entertainment,0,0
28708,3276,25432,11.41145325,88.58854675,Housing,3,1
138945,1999,136946,1.438698766,98.56130123,Healthcare,2,2
139884,56674,83210,40.51499814,59.48500186,Healthcare,2,2
121951,37517,84434,30.76399538,69.23600462,Healthcare,2,2
46317,8765,37552,18.92393722,81.07606278,Food,1,1
181097,63432,117665,35.02653274,64.97346726,Entertainment,0,0
52836,1930,50906,3.652812476,96.34718752,Food,1,4
220413,39896,180517,18.10056576,81.89943424,Entertainment,0,0
146358,22604,123754,15.44432146,84.55567854,Healthcare,2,2
51011,12755,38256,25.00441081,74.99558919,Food,1,4
216466,32714,183752,15.11276598,84.88723402,Entertainment,0,0
138406,36432,101974,26.32255827,73.67744173,Healthcare,2,2
47375,26331,21044,55.57994723,44.42005277,Food,1,1
208338,65750,142588,31.55929307,68.44070693,Entertainment,0,0
171259,52437,118822,30.61853684,69.38146316,Healthcare,2,0
18503,489,18014,2.642814679,97.35718532,Housing,3,3
67578,29356,38222,43.44017284,56.55982716,Transportation,4,4
170324,31250,139074,18.34738498,81.65261502,Healthcare,2,0
13711,529,13182,3.858216031,96.14178397,Housing,3,3
18419,2597,15822,14.0995711,85.9004289,Housing,3,3
103436,57771,45665,55.85192776,44.14807224,Transportation,4,4
206168,16199,189969,7.857184432,92.14281557,Entertainment,0,0
41753,2644,39109,6.332479103,93.6675209,Food,1,1
95799,3648,92151,3.807972943,96.19202706,Transportation,4,4
189246,69845,119401,36.90698879,63.09301121,Entertainment,0,0
109019,23806,85213,21.8365606,78.1634394,Transportation,4,2
20871,9987,10884,47.85108524,52.14891476,Housing,3,3
132325,63663,68662,48.11109012,51.88890988,Healthcare,2,4
84381,3466,80915,4.107559759,95.89244024,Transportation,4,4
28147,3491,24656,12.40274274,87.59725726,Housing,3,1
81350,1015,80335,1.247695144,98.75230486,Transportation,4,4
229103,2591,226512,1.130932375,98.86906762,Entertainment,0,0
200144,50843,149301,25.40320969,74.59679031,Entertainment,0,0
80602,3198,77404,3.967643483,96.03235652,Transportation,4,4
180215,60514,119701,33.5787809,66.4212191,Entertainment,0,0
33785,17465,16320,51.694539,48.305461,Food,1,1
21519,5808,15711,26.99010177,73.00989823,Housing,3,3
72399,902,71497,1.245873562,98.75412644,Transportation,4,4
18458,9574,8884,51.86910825,48.13089175,Housing,3,3
87286,51260,36026,58.72648535,41.27351465,Transportation,4,4
145830,35938,109892,24.64376329,75.35623671,Healthcare,2,2
29447,11842,17605,40.21462288,59.78537712,Housing,3,1
67657,13092,54565,19.35054762,80.64945238,Transportation,4,4
46479,25687,20792,55.26581897,44.73418103,Food,1,1
44397,6879,37518,15.49429015,84.50570985,Food,1,1
25501,12700,12801,49.80196855,50.19803145,Housing,3,1
31808,8066,23742,25.3584004,74.6415996,Food,1,1
110242,2770,107472,2.512653979,97.48734602,Transportation,4,2
164984,14249,150735,8.636595064,91.36340494,Healthcare,2,0
164881,26096,138785,15.82717232,84.17282768,Healthcare,2,0
66844,25467,41377,38.09915624,61.90084376,Transportation,4,4
64190,16648,47542,25.93550397,74.06449603,Transportation,4,4
160812,65157,95655,40.51749869,59.48250131,Healthcare,2,0
16824,8487,8337,50.44579173,49.55420827,Housing,3,3
74465,39183,35282,52.61935137,47.38064863,Transportation,4,4
98735,13305,85430,13.47546463,86.52453537,Transportation,4,4
152677,50896,101781,33.33573492,66.66426508,Healthcare,2,0
17244,5443,11801,31.56460218,68.43539782,Housing,3,3
37047,2580,34467,6.96412665,93.03587335,Food,1,1
36326,1324,35002,3.644772339,96.35522766,Food,1,1
149136,7037,142099,4.718511962,95.28148804,Healthcare,2,2
187252,16196,171056,8.649306816,91.35069318,Entertainment,0,0
49724,8720,41004,17.53680315,82.46319685,Food,1,4
69964,35883,34081,51.28780516,48.71219484,Transportation,4,4
58346,30931,27415,53.01306002,46.98693998,Food,1,4
58848,5474,53374,9.301930397,90.6980696,Food,1,4
31165,17570,13595,56.37734638,43.62265362,Food,1,1
121770,50244,71526,41.26139443,58.73860557,Healthcare,2,2
83731,3787,79944,4.522817117,95.47718288,Transportation,4,4
73139,25445,47694,34.78992056,65.21007944,Transportation,4,4
22778,12257,10521,53.81069453,46.18930547,Housing,3,3
84560,3577,80983,4.23013245,95.76986755,Transportation,4,4
81845,47462,34383,57.99010324,42.00989676,Transportation,4,4
104997,58567,46430,55.77968894,44.22031106,Transportation,4,4
239053,37205,201848,15.56349429,84.43650571,Entertainment,0,0
58826,3164,55662,5.3785741,94.6214259,Food,1,4
41684,16667,25017,39.98416659,60.01583341,Food,1,1
249676,49985,199691,20.01994585,79.98005415,Entertainment,0,0
92955,32097,60858,34.5296111,65.4703889,Transportation,4,4
132177,17948,114229,13.57876181,86.42123819,Healthcare,2,2
185291,46234,139057,24.95210237,75.04789763,Entertainment,0,0
67486,28256,39230,41.86942477,58.13057523,Transportation,4,4
201895,40264,161631,19.9430397,80.0569603,Entertainment,0,0
200192,37390,162802,18.67707001,81.32292999,Entertainment,0,0
93630,11624,82006,12.41482431,87.58517569,Transportation,4,4
17598,2345,15253,13.32537788,86.67462212,Housing,3,3
207724,50435,157289,24.2798136,75.7201864,Entertainment,0,0
48098,21527,26571,44.75653873,55.24346127,Food,1,1
36194,19883,16311,54.93451953,45.06548047,Food,1,1
46507,19166,27341,41.21100049,58.78899951,Food,1,1
160375,16050,144325,10.00779423,89.99220577,Healthcare,2,0
46946,6351,40595,13.52830912,86.47169088,Food,1,4
183414,34814,148600,18.98110286,81.01889714,Entertainment,0,0
121047,24999,96048,20.65230861,79.34769139,Healthcare,2,2
82868,22530,60338,27.18781677,72.81218323,Transportation,4,4
206876,7507,199369,3.628743789,96.37125621,Entertainment,0,0
17414,3925,13489,22.53933617,77.46066383,Housing,3,3
51054,849,50205,1.662945117,98.33705488,Food,1,4
85949,47723,38226,55.52478796,44.47521204,Transportation,4,4
53727,16941,36786,31.53163214,68.46836786,Food,1,4
41843,14718,27125,35.17434218,64.82565782,Food,1,1
19935,2303,17632,11.55254577,88.44745423,Housing,3,3
141571,63389,78182,44.77541304,55.22458696,Healthcare,2,2
92191,15286,76905,16.58079422,83.41920578,Transportation,4,4
80044,1543,78501,1.927689771,98.07231023,Transportation,4,4
21022,5932,15090,28.21805727,71.78194273,Housing,3,3
93731,55619,38112,59.33895936,40.66104064,Transportation,4,4
90946,48802,42144,53.66041387,46.33958613,Transportation,4,4
16808,4879,11929,29.02784388,70.97215612,Housing,3,3
36416,10170,26246,27.92728471,72.07271529,Food,1,1
86691,51151,35540,59.00381816,40.99618184,Transportation,4,4
42769,15701,27068,36.7111693,63.2888307,Food,1,1
150221,28671,121550,19.08588014,80.91411986,Healthcare,2,0
78969,34897,44072,44.1907584,55.8092416,Transportation,4,4
107786,765,107021,0.709739669,99.29026033,Transportation,4,2
124699,26546,98153,21.28806165,78.71193835,Healthcare,2,2
53953,7968,45985,14.76840954,85.23159046,Food,1,4
47039,8590,38449,18.26144263,81.73855737,Food,1,1
160554,18202,142352,11.33699565,88.66300435,Healthcare,2,0
138108,57858,80250,41.89330089,58.10669911,Healthcare,2,2
23889,1744,22145,7.300431161,92.69956884,Housing,3,3
128723,41515,87208,32.2514236,67.7485764,Healthcare,2,2
169818,39605,130213,23.32202711,76.67797289,Healthcare,2,0
59026,23164,35862,39.24372311,60.75627689,Food,1,4
89017,3340,85677,3.752092297,96.2479077,Transportation,4,4
204843,25571,179272,12.48321886,87.51678114,Entertainment,0,0
189467,56552,132915,29.84794186,70.15205814,Entertainment,0,0
39387,7740,31647,19.65115393,80.34884607,Food,1,1
156220,55590,100630,35.58443221,64.41556779,Healthcare,2,0
31748,12079,19669,38.04649112,61.95350888,Food,1,1
11442,826,10616,7.219017654,92.78098235,Housing,3,3
16658,1646,15012,9.881138192,90.11886181,Housing,3,3
146054,1346,144708,0.921576951,99.07842305,Healthcare,2,2
209240,61292,147948,29.29267826,70.70732174,Entertainment,0,0
43357,17380,25977,40.08579929,59.91420071,Food,1,1
104006,47481,56525,45.65217391,54.34782609,Transportation,4,4
26657,15112,11545,56.69055032,43.30944968,Housing,3,1
33509,14818,18691,44.22095556,55.77904444,Food,1,1
25223,13916,11307,55.17186695,44.82813305,Housing,3,1
12495,5704,6791,45.6502601,54.3497399,Housing,3,3
23342,3860,19482,16.53671493,83.46328507,Housing,3,3
78331,43262,35069,55.22973025,44.77026975,Transportation,4,4
129003,29199,99804,22.63435734,77.36564266,Healthcare,2,2
74627,20467,54160,27.42573063,72.57426937,Transportation,4,4
14883,6052,8831,40.66384465,59.33615535,Housing,3,3
22099,11399,10700,51.58151953,48.41848047,Housing,3,3
133573,65869,67704,49.31310969,50.68689031,Healthcare,2,4
125079,39422,85657,31.51768083,68.48231917,Healthcare,2,2
11506,5347,6159,46.47140622,53.52859378,Housing,3,3
20683,5348,15335,25.856984,74.143016,Housing,3,3
31523,6908,24615,21.91415792,78.08584208,Food,1,1
228346,2101,226245,0.920094944,99.07990506,Entertainment,0,0
216451,24980,191471,11.54071822,88.45928178,Entertainment,0,0
11324,1803,9521,15.92193571,84.07806429,Housing,3,3
152697,45232,107465,29.62206199,70.37793801,Healthcare,2,0
11231,4301,6930,38.29578844,61.70421156,Housing,3,3
179303,40191,139112,22.4151297,77.5848703,Healthcare,2,0
175406,57215,118191,32.61861054,67.38138946,Healthcare,2,0
145146,61096,84050,42.09278933,57.90721067,Healthcare,2,2
48214,17058,31156,35.37976521,64.62023479,Food,1,1
34853,19547,15306,56.08412475,43.91587525,Food,1,1
31220,9724,21496,31.14670083,68.85329917,Food,1,1
109326,1361,107965,1.244900573,98.75509943,Transportation,4,2
35041,3232,31809,9.223481065,90.77651893,Food,1,1
28115,7028,21087,24.99733238,75.00266762,Housing,3,1
122888,55651,67237,45.28595144,54.71404856,Healthcare,2,4
120773,53173,67600,44.02722463,55.97277537,Healthcare,2,4
130647,25134,105513,19.23809961,80.76190039,Healthcare,2,2
28673,6086,22587,21.22554319,78.77445681,Housing,3,1
30001,2903,27098,9.676344122,90.32365588,Food,1,1
199173,69021,130152,34.65379344,65.34620656,Entertainment,0,0
99570,53522,46048,53.7531385,46.2468615,Transportation,4,4
15880,4703,11177,29.61586902,70.38413098,Housing,3,3
10041,3705,6336,36.89871527,63.10128473,Housing,3,3
205634,9993,195641,4.859604929,95.14039507,Entertainment,0,0
63507,30566,32941,48.13012739,51.86987261,Transportation,4,4
26761,10077,16684,37.65554351,62.34445649,Housing,3,1
144161,10852,133309,7.52769473,92.47230527,Healthcare,2,2
240275,56983,183292,23.71574238,76.28425762,Entertainment,0,0
238417,44731,193686,18.76166549,81.23833451,Entertainment,0,0
156525,10146,146379,6.482031624,93.51796838,Healthcare,2,0
233201,65305,167896,28.00373926,71.99626074,Entertainment,0,0
240485,21830,218655,9.07748924,90.92251076,Entertainment,0,0
245687,37784,207903,15.37891708,84.62108292,Entertainment,0,0
156372,2882,153490,1.843040954,98.15695905,Healthcare,2,0
24109,10259,13850,42.55257373,57.44742627,Housing,3,3
42798,4933,37865,11.52623954,88.47376046,Food,1,1
133380,60258,73122,45.17768781,54.82231219,Healthcare,2,2
11343,4436,6907,39.1078198,60.8921802,Housing,3,3
133727,6381,127346,4.771661669,95.22833833,Healthcare,2,2
17820,7225,10595,40.54433221,59.45566779,Housing,3,3
53150,11434,41716,21.51269991,78.48730009,Food,1,4
247986,8272,239714,3.335672175,96.66432782,Entertainment,0,0
25888,2251,23637,8.695148331,91.30485167,Housing,3,1
76498,17576,58922,22.97576407,77.02423593,Transportation,4,4
134268,59632,74636,44.4126672,55.5873328,Healthcare,2,2
38884,17838,21046,45.87490999,54.12509001,Food,1,1
82249,532,81717,0.646816375,99.35318363,Transportation,4,4
161782,22001,139781,13.59916431,86.40083569,Healthcare,2,0
205573,23900,181673,11.62604038,88.37395962,Entertainment,0,0
196061,20807,175254,10.61251345,89.38748655,Entertainment,0,0
143030,41915,101115,29.3050409,70.6949591,Healthcare,2,2
84160,23615,60545,28.05964829,71.94035171,Transportation,4,4
11413,5455,5958,47.79637256,52.20362744,Housing,3,3
26298,4851,21447,18.44626968,81.55373032,Housing,3,1
51282,22928,28354,44.70964471,55.29035529,Food,1,4
239412,61744,177668,25.7898518,74.2101482,Entertainment,0,0
202210,45393,156817,22.44844469,77.55155531,Entertainment,0,0
193382,9749,183633,5.041317186,94.95868281,Entertainment,0,0
49587,6929,42658,13.97342045,86.02657955,Food,1,4
31831,2465,29366,7.744023122,92.25597688,Food,1,1
51500,22754,28746,44.18252427,55.81747573,Food,1,4
41779,15036,26743,35.98937265,64.01062735,Food,1,1
202251,13977,188274,6.910719848,93.08928015,Entertainment,0,0
75297,16666,58631,22.13368394,77.86631606,Transportation,4,4
23375,10997,12378,47.0459893,52.9540107,Housing,3,3
185640,20542,165098,11.06550312,88.93449688,Entertainment,0,0
11372,4496,6876,39.53570172,60.46429828,Housing,3,3
124518,26970,97548,21.65951911,78.34048089,Healthcare,2,2
41767,9419,32348,22.55129648,77.44870352,Food,1,1
58373,7090,51283,12.14602642,87.85397358,Food,1,4
80001,13517,66484,16.8960388,83.1039612,Transportation,4,4
49993,28831,21162,57.67007381,42.32992619,Food,1,1
121557,61389,60168,50.50223352,49.49776648,Healthcare,2,4
51991,1998,49993,3.842972822,96.15702718,Food,1,4
97277,56665,40612,58.25117962,41.74882038,Transportation,4,4
25375,4970,20405,19.5862069,80.4137931,Housing,3,1
67379,26757,40622,39.71118598,60.28881402,Transportation,4,4
179291,52863,126428,29.48446938,70.51553062,Healthcare,2,0
217264,41314,175950,19.01557552,80.98442448,Entertainment,0,0
12880,5325,7555,41.3431677,58.6568323,Housing,3,3
49479,15996,33483,32.32886679,67.67113321,Food,1,1
30912,5860,25052,18.95703934,81.04296066,Food,1,1
75173,12849,62324,17.09257313,82.90742687,Transportation,4,4
34950,13604,21346,38.9241774,61.0758226,Food,1,1
180650,28873,151777,15.98283975,84.01716025,Entertainment,0,0
78448,4152,74296,5.292677952,94.70732205,Transportation,4,4
22940,4050,18890,17.65475153,82.34524847,Housing,3,3
28771,14271,14500,49.60202982,50.39797018,Housing,3,1
107250,57139,50111,53.27645688,46.72354312,Transportation,4,4
34672,6323,28349,18.23661744,81.76338256,Food,1,1
107333,51788,55545,48.24983929,51.75016071,Transportation,4,4
233970,1808,232162,0.772748643,99.22725136,Entertainment,0,0
12842,5632,7210,43.85609718,56.14390282,Housing,3,3
135062,25931,109131,19.19933068,80.80066932,Healthcare,2,2
187930,32854,155076,17.48204119,82.51795881,Entertainment,0,0
230696,24361,206335,10.5597843,89.4402157,Entertainment,0,0
205508,53110,152398,25.84327617,74.15672383,Entertainment,0,0
17099,3327,13772,19.4572782,80.5427218,Housing,3,3
54827,4257,50570,7.764422638,92.23557736,Food,1,4
36322,8819,27503,24.28005066,75.71994934,Food,1,1
162893,65700,97193,40.33322488,59.66677512,Healthcare,2,0
36863,365,36498,0.990152728,99.00984727,Food,1,1
27980,7601,20379,27.16583274,72.83416726,Housing,3,1
27730,6648,21082,23.97403534,76.02596466,Housing,3,1
233940,43915,190025,18.77190733,81.22809267,Entertainment,0,0
121797,17399,104398,14.28524512,85.71475488,Healthcare,2,2
22903,4793,18110,20.92738942,79.07261058,Housing,3,3
18681,764,17917,4.089716825,95.91028318,Housing,3,3
227188,11114,216074,4.891983732,95.10801627,Entertainment,0,0
226151,29298,196853,12.955061,87.044939,Entertainment,0,0
21136,4563,16573,21.58875852,78.41124148,Housing,3,3
82416,8085,74331,9.809988352,90.19001165,Transportation,4,4
26497,2716,23781,10.25021701,89.74978299,Housing,3,1
139604,61920,77684,44.35402997,55.64597003,Healthcare,2,2
224274,63904,160370,28.49371751,71.50628249,Entertainment,0,0
185824,40534,145290,21.81311348,78.18688652,Entertainment,0,0
128562,298,128264,0.231794776,99.76820522,Healthcare,2,2
16027,9438,6589,58.88812629,41.11187371,Housing,3,3
80065,47908,32157,59.83638294,40.16361706,Transportation,4,4
40008,18420,21588,46.04079184,53.95920816,Food,1,1
138768,25646,113122,18.48120604,81.51879396,Healthcare,2,2
228289,69967,158322,30.64843247,69.35156753,Entertainment,0,0
146938,22427,124511,15.2629,84.7371,Healthcare,2,2
20382,2266,18116,11.11765283,88.88234717,Housing,3,3
123854,41483,82371,33.49346812,66.50653188,Healthcare,2,2
120676,7376,113300,6.112234413,93.88776559,Healthcare,2,2
200447,28061,172386,13.99921176,86.00078824,Entertainment,0,0
35405,13221,22184,37.34218331,62.65781669,Food,1,1
68496,40941,27555,59.77137351,40.22862649,Transportation,4,4
58133,14654,43479,25.20771335,74.79228665,Food,1,4
170615,25407,145208,14.89142221,85.10857779,Healthcare,2,0
20048,8195,11853,40.87689545,59.12310455,Housing,3,3
26411,2292,24119,8.678202264,91.32179774,Housing,3,1
37400,10989,26411,29.38235294,70.61764706,Food,1,1
84434,33441,50993,39.60608286,60.39391714,Transportation,4,4
25224,6833,18391,27.08928005,72.91071995,Housing,3,1
110664,39384,71280,35.58880937,64.41119063,Transportation,4,2
86790,39127,47663,45.08238276,54.91761724,Transportation,4,4
104038,51763,52275,49.75393606,50.24606394,Transportation,4,4
114383,7412,106971,6.479983914,93.52001609,Transportation,4,2
217520,39890,177630,18.33854358,81.66145642,Entertainment,0,0
101649,19243,82406,18.9308306,81.0691694,Transportation,4,2
54371,22567,31804,41.50558202,58.49441798,Food,1,4
92512,41263,51249,44.60286233,55.39713767,Transportation,4,4
249540,62104,187436,24.8873928,75.1126072,Entertainment,0,0
146320,43849,102471,29.96787862,70.03212138,Healthcare,2,2
218415,24667,193748,11.29363826,88.70636174,Entertainment,0,0
14224,1089,13135,7.656074241,92.34392576,Housing,3,3
72710,36079,36631,49.62040985,50.37959015,Transportation,4,4
51957,28068,23889,54.02159478,45.97840522,Food,1,4
55257,268,54989,0.485006425,99.51499358,Food,1,4
58718,1848,56870,3.14724616,96.85275384,Food,1,4
136907,12872,124035,9.402002819,90.59799718,Healthcare,2,2
219731,188,219543,0.085559161,99.91444084,Entertainment,0,0
179870,50141,129729,27.87624395,72.12375605,Healthcare,2,0
35625,3617,32008,10.15298246,89.84701754,Food,1,1
86989,32646,54343,37.52888296,62.47111704,Transportation,4,4
62128,18637,43491,29.99774659,70.00225341,Transportation,4,4
118216,48586,69630,41.09934357,58.90065643,Transportation,4,4
163503,61155,102348,37.40298343,62.59701657,Healthcare,2,0
151531,61193,90338,40.38315592,59.61684408,Healthcare,2,0
93939,45599,48340,48.54107453,51.45892547,Transportation,4,4
11279,269,11010,2.384963206,97.61503679,Housing,3,3
109166,8551,100615,7.833024935,92.16697507,Transportation,4,2
64670,28627,36043,44.26627493,55.73372507,Transportation,4,4
35072,8127,26945,23.1723312,76.8276688,Food,1,1
36437,5675,30762,15.57482778,84.42517222,Food,1,1
107082,53490,53592,49.95237295,50.04762705,Transportation,4,4
180531,20309,160222,11.24959148,88.75040852,Entertainment,0,0
20242,2871,17371,14.18338109,85.81661891,Housing,3,3
116740,63257,53483,54.1862258,45.8137742,Transportation,4,4
57472,27850,29622,48.45837973,51.54162027,Food,1,4
243542,7554,235988,3.101723727,96.89827627,Entertainment,0,0
195609,15131,180478,7.735329152,92.26467085,Entertainment,0,0
36394,3974,32420,10.91938232,89.08061768,Food,1,1
103374,34214,69160,33.09729719,66.90270281,Transportation,4,2
157518,44066,113452,27.97521553,72.02478447,Healthcare,2,0
99321,39978,59343,40.25130637,59.74869363,Transportation,4,4
152490,57926,94564,37.98675323,62.01324677,Healthcare,2,0
137852,50934,86918,36.94832139,63.05167861,Healthcare,2,2
133431,60294,73137,45.18740023,54.81259977,Healthcare,2,2
39040,12079,26961,30.94006148,69.05993852,Food,1,1
169198,19365,149833,11.44517075,88.55482925,Healthcare,2,0
195196,62084,133112,31.80597963,68.19402037,Entertainment,0,0
233715,61209,172506,26.18958989,73.81041011,Entertainment,0,0
58247,2225,56022,3.819939224,96.18006078,Food,1,4
35608,11988,23620,33.66659178,66.33340822,Food,1,1
94188,14418,79770,15.30768251,84.69231749,Transportation,4,4
121681,3569,118112,2.933079117,97.06692088,Healthcare,2,2
88365,45592,42773,51.59508855,48.40491145,Transportation,4,4
232340,8618,223722,3.709219248,96.29078075,Entertainment,0,0
29550,16167,13383,54.7106599,45.2893401,Housing,3,1
155303,50048,105255,32.22603556,67.77396444,Healthcare,2,0
242602,17440,225162,7.188728865,92.81127114,Entertainment,0,0
90673,49094,41579,54.144012,45.855988,Transportation,4,4
204796,23161,181635,11.30930292,88.69069708,Entertainment,0,0
18169,9867,8302,54.30678628,45.69321372,Housing,3,3
179694,48877,130817,27.20012911,72.79987089,Healthcare,2,0
195877,49472,146405,25.25666617,74.74333383,Entertainment,0,0
230410,37814,192596,16.41161408,83.58838592,Entertainment,0,0
45444,25771,19673,56.70935657,43.29064343,Food,1,1
183419,65665,117754,35.80054411,64.19945589,Entertainment,0,0
42463,9986,32477,23.51694416,76.48305584,Food,1,1
33482,9719,23763,29.02753718,70.97246282,Food,1,1
166091,20605,145486,12.40584981,87.59415019,Healthcare,2,0
24122,7779,16343,32.24856977,67.75143023,Housing,3,3
152104,65111,86993,42.80689528,57.19310472,Healthcare,2,0
46135,27324,18811,59.22618403,40.77381597,Food,1,1
146553,60892,85661,41.54947357,58.45052643,Healthcare,2,2
45465,5321,40144,11.70350819,88.29649181,Food,1,1
80037,27987,52050,34.9675775,65.0324225,Transportation,4,4
149511,59398,90113,39.72818054,60.27181946,Healthcare,2,2
168325,49014,119311,29.11866924,70.88133076,Healthcare,2,0
48879,9109,39770,18.63581497,81.36418503,Food,1,1
70308,10798,59510,15.35813848,84.64186152,Transportation,4,4
110753,58135,52618,52.49067745,47.50932255,Transportation,4,4
30402,18194,12208,59.84474706,40.15525294,Food,1,1
223308,52914,170394,23.69552367,76.30447633,Entertainment,0,0
89036,30316,58720,34.04914866,65.95085134,Transportation,4,4
246636,29834,216802,12.09636874,87.90363126,Entertainment,0,0
232782,11461,221321,4.923490648,95.07650935,Entertainment,0,0
200858,16044,184814,7.987732627,92.01226737,Entertainment,0,0
29086,16317,12769,56.09915423,43.90084577,Housing,3,1
16090,3672,12418,22.82162834,77.17837166,Housing,3,3
154934,45196,109738,29.17113093,70.82886907,Healthcare,2,0
199303,68489,130814,34.36425944,65.63574056,Entertainment,0,0
45509,632,44877,1.388736294,98.61126371,Food,1,4
130210,39748,90462,30.52607327,69.47392673,Healthcare,2,2
16393,2214,14179,13.50576466,86.49423534,Housing,3,3
138906,53359,85547,38.41374743,61.58625257,Healthcare,2,2
35098,1700,33398,4.843580831,95.15641917,Food,1,1
11534,5489,6045,47.5897347,52.4102653,Housing,3,3
107805,41620,66185,38.60674366,61.39325634,Transportation,4,2
129298,13540,115758,10.47193305,89.52806695,Healthcare,2,2
138984,43016,95968,30.95032522,69.04967478,Healthcare,2,2
14436,2429,12007,16.82599058,83.17400942,Housing,3,3
149095,10724,138371,7.192729468,92.80727053,Healthcare,2,2
140212,373,139839,0.266025732,99.73397427,Healthcare,2,2
74695,24113,50582,32.28194658,67.71805342,Transportation,4,4
74649,15101,59548,20.22933998,79.77066002,Transportation,4,4
146159,61333,84826,41.96320446,58.03679554,Healthcare,2,2
50804,7235,43569,14.24100465,85.75899535,Food,1,4
46501,25153,21348,54.09130986,45.90869014,Food,1,1
215083,52642,162441,24.4752026,75.5247974,Entertainment,0,0
55757,22910,32847,41.08901125,58.91098875,Food,1,4
56220,29406,26814,52.30522946,47.69477054,Food,1,4
161354,1902,159452,1.17877462,98.82122538,Healthcare,2,0
23796,12843,10953,53.97125567,46.02874433,Housing,3,3
128489,3053,125436,2.376078886,97.62392111,Healthcare,2,2
111143,10504,100639,9.450887595,90.5491124,Transportation,4,2
33831,4501,29330,13.30436582,86.69563418,Food,1,1
59302,20992,38310,35.39846885,64.60153115,Food,1,4
25024,3467,21557,13.85469949,86.14530051,Housing,3,1
71620,22963,48657,32.06227311,67.93772689,Transportation,4,4
34653,8626,26027,24.8925057,75.1074943,Food,1,1
236420,19250,217170,8.142289146,91.85771085,Entertainment,0,0
134142,15244,118898,11.36407687,88.63592313,Healthcare,2,2
88724,22359,66365,25.20062215,74.79937785,Transportation,4,4
14618,792,13826,5.417977836,94.58202216,Housing,3,3
15034,3862,11172,25.68843954,74.31156046,Housing,3,3
55332,12728,42604,23.00296393,76.99703607,Food,1,4
194832,25765,169067,13.22421368,86.77578632,Entertainment,0,0
20832,652,20180,3.129800307,96.87019969,Housing,3,3
10260,1874,8386,18.26510721,81.73489279,Housing,3,3
101502,50456,51046,49.70936533,50.29063467,Transportation,4,4
31330,4527,26803,14.44940951,85.55059049,Food,1,1
25201,4243,20958,16.83663347,83.16336653,Housing,3,1
197659,33845,163814,17.12292382,82.87707618,Entertainment,0,0
74954,11149,63805,14.87445633,85.12554367,Transportation,4,4
115124,48505,66619,42.13283069,57.86716931,Transportation,4,4
24826,11273,13553,45.40803996,54.59196004,Housing,3,3
248832,18141,230691,7.290461034,92.70953897,Entertainment,0,0
153351,6040,147311,3.938676631,96.06132337,Healthcare,2,0
157668,12188,145480,7.730167187,92.26983281,Healthcare,2,0
248100,37050,211050,14.93349456,85.06650544,Entertainment,0,0
39947,201,39746,0.503166696,99.4968333,Food,1,1
35991,14067,21924,39.08477119,60.91522881,Food,1,1
55596,13059,42537,23.48909994,76.51090006,Food,1,4
41992,8769,33223,20.88254906,79.11745094,Food,1,1
21597,10885,10712,50.40051859,49.59948141,Housing,3,3
122680,38720,83960,31.56178676,68.43821324,Healthcare,2,2
10979,441,10538,4.016759268,95.98324073,Housing,3,3
149205,10652,138553,7.139170939,92.86082906,Healthcare,2,2
176815,30439,146376,17.2151684,82.7848316,Healthcare,2,0
177227,19166,158061,10.8143793,89.1856207,Healthcare,2,0
14638,5766,8872,39.39062713,60.60937287,Housing,3,3
164573,14300,150273,8.689153142,91.31084686,Healthcare,2,0
235945,41978,193967,17.79143444,82.20856556,Entertainment,0,0
107479,16973,90506,15.79192214,84.20807786,Transportation,4,2
26002,9441,16561,36.30874548,63.69125452,Housing,3,1
37132,18533,18599,49.91112787,50.08887213,Food,1,1
107717,33335,74382,30.9468329,69.0531671,Transportation,4,2
72586,24532,48054,33.79715097,66.20284903,Transportation,4,4
158501,15691,142810,9.899622084,90.10037792,Healthcare,2,0
134722,51852,82870,38.48814596,61.51185404,Healthcare,2,2
199952,27698,172254,13.85232456,86.14767544,Entertainment,0,0
156042,34455,121587,22.08059369,77.91940631,Healthcare,2,0
118256,26725,91531,22.59927615,77.40072385,Transportation,4,2
237892,2710,235182,1.139172398,98.8608276,Entertainment,0,0
49482,19944,29538,40.30556566,59.69443434,Food,1,1
163957,51264,112693,31.26673457,68.73326543,Healthcare,2,0
22913,12928,9985,56.42211845,43.57788155,Housing,3,3
172808,43666,129142,25.26850609,74.73149391,Healthcare,2,0
94945,11398,83547,12.00484491,87.99515509,Transportation,4,4
95268,45726,49542,47.99722887,52.00277113,Transportation,4,4
59489,7586,51903,12.75193733,87.24806267,Food,1,4
87380,13324,74056,15.24834058,84.75165942,Transportation,4,4
183969,1383,182586,0.75175709,99.24824291,Entertainment,0,0
14195,3541,10654,24.94540331,75.05459669,Housing,3,3
220306,60027,160279,27.24710176,72.75289824,Entertainment,0,0
123756,41370,82386,33.42868225,66.57131775,Healthcare,2,2
202595,2465,200130,1.216713147,98.78328685,Entertainment,0,0
169866,66885,102981,39.37515453,60.62484547,Healthcare,2,0
36122,11973,24149,33.1460052,66.8539948,Food,1,1
150921,29292,121629,19.40882979,80.59117021,Healthcare,2,0
243161,63999,179162,26.31959895,73.68040105,Entertainment,0,0
163576,16390,147186,10.01980731,89.98019269,Healthcare,2,0
137374,8263,129111,6.014966442,93.98503356,Healthcare,2,2
220204,66909,153295,30.38500663,69.61499337,Entertainment,0,0
230149,27175,202974,11.80756814,88.19243186,Entertainment,0,0
19003,1753,17250,9.224859233,90.77514077,Housing,3,3
19255,7149,12106,37.1280187,62.8719813,Housing,3,3
136496,33213,103283,24.33258117,75.66741883,Healthcare,2,2
42517,14100,28417,33.16320531,66.83679469,Food,1,1
110032,29666,80366,26.96124764,73.03875236,Transportation,4,2
57430,311,57119,0.541528818,99.45847118,Food,1,4
42456,17622,24834,41.50650085,58.49349915,Food,1,1
28843,17060,11783,59.14780016,40.85219984,Housing,3,1
15779,3495,12284,22.14969263,77.85030737,Housing,3,3
110809,19332,91477,17.44623632,82.55376368,Transportation,4,2
24270,5879,18391,24.22332097,75.77667903,Housing,3,3
119370,27042,92328,22.65393315,77.34606685,Transportation,4,2
111995,11951,100044,10.6710121,89.3289879,Transportation,4,2
36584,18895,17689,51.64826154,48.35173846,Food,1,1
26972,9896,17076,36.68990064,63.31009936,Housing,3,1
23594,12108,11486,51.31813173,48.68186827,Housing,3,3
12620,5267,7353,41.73534073,58.26465927,Housing,3,3
32006,13393,18613,41.84527901,58.15472099,Food,1,1
26738,11812,14926,44.17682699,55.82317301,Housing,3,1
141466,24946,116520,17.6339191,82.3660809,Healthcare,2,2
102354,32756,69598,32.00265744,67.99734256,Transportation,4,2
243952,2556,241396,1.047747098,98.9522529,Entertainment,0,0
230086,8358,221728,3.632554784,96.36744522,Entertainment,0,0
29853,274,29579,0.917830704,99.0821693,Housing,3,1
22341,10201,12140,45.66044492,54.33955508,Housing,3,3
132076,24044,108032,18.20467004,81.79532996,Healthcare,2,2
213130,53321,159809,25.01806409,74.98193591,Entertainment,0,0
11098,4080,7018,36.76338079,63.23661921,Housing,3,3
210320,28228,182092,13.42145302,86.57854698,Entertainment,0,0
131737,41291,90446,31.34351018,68.65648982,Healthcare,2,2
229352,16405,212947,7.152760822,92.84723918,Entertainment,0,0
152083,66482,85601,43.71428759,56.28571241,Healthcare,2,0
27990,16650,11340,59.48553055,40.51446945,Housing,3,1
179586,17588,161998,9.793636475,90.20636352,Healthcare,2,0
184202,9756,174446,5.296359431,94.70364057,Entertainment,0,0
23262,11240,12022,48.31914711,51.68085289,Housing,3,3
26155,10850,15305,41.48346396,58.51653604,Housing,3,1
124639,61102,63537,49.02317894,50.97682106,Healthcare,2,4
155851,14122,141729,9.061218728,90.93878127,Healthcare,2,0
73862,40498,33364,54.82927622,45.17072378,Transportation,4,4
192435,22100,170335,11.48439733,88.51560267,Entertainment,0,0
169853,10039,159814,5.91040488,94.08959512,Healthcare,2,0
58445,11797,46648,20.18478912,79.81521088,Food,1,4
39094,10470,28624,26.78160332,73.21839668,Food,1,1
76477,44788,31689,58.56401271,41.43598729,Transportation,4,4
28143,13559,14584,48.17894325,51.82105675,Housing,3,1
51167,17532,33635,34.26427189,65.73572811,Food,1,4
60733,32901,27832,54.17318427,45.82681573,Transportation,4,4
246838,33741,213097,13.66928917,86.33071083,Entertainment,0,0
161304,15582,145722,9.66002083,90.33997917,Healthcare,2,0
142801,50292,92509,35.21824077,64.78175923,Healthcare,2,2
202715,66900,135815,33.00199788,66.99800212,Entertainment,0,0
79640,29226,50414,36.69763938,63.30236062,Transportation,4,4
186410,44814,141596,24.04055576,75.95944424,Entertainment,0,0
238101,14292,223809,6.00249474,93.99750526,Entertainment,0,0
149067,6538,142529,4.385947259,95.61405274,Healthcare,2,2
146147,39601,106546,27.09669032,72.90330968,Healthcare,2,2
236298,40351,195947,17.07631889,82.92368111,Entertainment,0,0
132793,53634,79159,40.38917714,59.61082286,Healthcare,2,2
238310,1953,236357,0.819520792,99.18047921,Entertainment,0,0
29751,12087,17664,40.62720581,59.37279419,Housing,3,1
99949,15607,84342,15.61496363,84.38503637,Transportation,4,4
21259,9278,11981,43.64269251,56.35730749,Housing,3,3
26840,436,26404,1.624441133,98.37555887,Housing,3,1
60195,11972,48223,19.88869507,80.11130493,Transportation,4,4
137729,22293,115436,16.18613364,83.81386636,Healthcare,2,2
11200,3065,8135,27.36607143,72.63392857,Housing,3,3
207213,48139,159074,23.23165052,76.76834948,Entertainment,0,0
99212,49444,49768,49.8367133,50.1632867,Transportation,4,4
37595,12422,25173,33.04162788,66.95837212,Food,1,1
222910,67235,155675,30.16239738,69.83760262,Entertainment,0,0
52086,28027,24059,53.80908497,46.19091503,Food,1,4
188839,68513,120326,36.28117073,63.71882927,Entertainment,0,0
240937,35299,205638,14.65071782,85.34928218,Entertainment,0,0
70128,28606,41522,40.7911248,59.2088752,Transportation,4,4
22133,2116,20017,9.560384946,90.43961505,Housing,3,3
63941,19523,44418,30.53283496,69.46716504,Transportation,4,4
137760,58589,79171,42.5297619,57.4702381,Healthcare,2,2
59565,22111,37454,37.12079241,62.87920759,Food,1,4
64431,9388,55043,14.57062594,85.42937406,Transportation,4,4
231845,67015,164830,28.90508745,71.09491255,Entertainment,0,0
47551,3993,43558,8.397299741,91.60270026,Food,1,4
30871,5519,25352,17.87761977,82.12238023,Food,1,1
115218,43442,71776,37.70417817,62.29582183,Transportation,4,2
211501,5649,205852,2.670909357,97.32909064,Entertainment,0,0
91669,28508,63161,31.09884476,68.90115524,Transportation,4,4
213581,39324,174257,18.41175011,81.58824989,Entertainment,0,0
70663,1676,68987,2.371821179,97.62817882,Transportation,4,4
103251,17284,85967,16.73978945,83.26021055,Transportation,4,2
179712,27414,152298,15.25440705,84.74559295,Healthcare,2,0
174014,19085,154929,10.96750836,89.03249164,Healthcare,2,0
17736,7174,10562,40.44880469,59.55119531,Housing,3,3
39348,5041,34307,12.81132459,87.18867541,Food,1,1
78881,12877,66004,16.32459021,83.67540979,Transportation,4,4
10277,3543,6734,34.47504135,65.52495865,Housing,3,3
112349,40010,72339,35.61224399,64.38775601,Transportation,4,2
195956,38030,157926,19.40741799,80.59258201,Entertainment,0,0
96039,40792,55247,42.47441144,57.52558856,Transportation,4,4
171427,26326,145101,15.35697411,84.64302589,Healthcare,2,0
142821,9311,133510,6.519349395,93.4806506,Healthcare,2,2
184740,22120,162620,11.9735845,88.0264155,Entertainment,0,0
27907,11245,16662,40.29454975,59.70545025,Housing,3,1
22584,6361,16223,28.1659582,71.8340418,Housing,3,3
43729,16634,27095,38.03883007,61.96116993,Food,1,1
12071,3451,8620,28.58918068,71.41081932,Housing,3,3
44984,11304,33680,25.12893473,74.87106527,Food,1,1
205083,7981,197102,3.89159511,96.10840489,Entertainment,0,0
58566,24070,34496,41.09893112,58.90106888,Food,1,4
172936,33065,139871,19.11978998,80.88021002,Healthcare,2,0
203685,24830,178855,12.19039203,87.80960797,Entertainment,0,0
167890,49501,118389,29.48418607,70.51581393,Healthcare,2,0
222450,37870,184580,17.02405035,82.97594965,Entertainment,0,0
165948,68456,97492,41.25147637,58.74852363,Healthcare,2,0
28925,12304,16621,42.53759723,57.46240277,Housing,3,1
18887,6578,12309,34.8281887,65.1718113,Housing,3,3
198331,49394,148937,24.90483081,75.09516919,Entertainment,0,0
163015,27483,135532,16.85918474,83.14081526,Healthcare,2,0
18315,303,18012,1.654381654,98.34561835,Housing,3,3
26807,355,26452,1.324280971,98.67571903,Housing,3,1
21390,307,21083,1.435250117,98.56474988,Housing,3,3
155057,13013,142044,8.392397634,91.60760237,Healthcare,2,0
61215,20272,40943,33.11606632,66.88393368,Transportation,4,4
31944,6255,25689,19.581142,80.418858,Food,1,1
89709,50112,39597,55.86061599,44.13938401,Transportation,4,4
190257,57471,132786,30.20703575,69.79296425,Entertainment,0,0
28312,3592,24720,12.68719977,87.31280023,Housing,3,1
62076,15281,46795,24.61659901,75.38340099,Transportation,4,4
30717,7338,23379,23.88905167,76.11094833,Food,1,1
18219,480,17739,2.634612218,97.36538778,Housing,3,3
14161,5124,9037,36.18388532,63.81611468,Housing,3,3
109721,15192,94529,13.84602765,86.15397235,Transportation,4,2
14198,3623,10575,25.51767855,74.48232145,Housing,3,3
40523,24309,16214,59.98815488,40.01184512,Food,1,1
177307,54617,122690,30.80363437,69.19636563,Healthcare,2,0
128159,8717,119442,6.801707254,93.19829275,Healthcare,2,2
20926,3546,17380,16.94542674,83.05457326,Housing,3,3
54918,22708,32210,41.34892021,58.65107979,Food,1,4
90356,26060,64296,28.84147151,71.15852849,Transportation,4,4
117817,48595,69222,41.24616991,58.75383009,Transportation,4,4
80709,37773,42936,46.80147195,53.19852805,Transportation,4,4
20282,432,19850,2.129967459,97.87003254,Housing,3,3
102482,19790,82692,19.31070822,80.68929178,Transportation,4,2
127779,920,126859,0.719993113,99.28000689,Healthcare,2,2
39824,499,39325,1.253013258,98.74698674,Food,1,1
206507,34685,171822,16.79604081,83.20395919,Entertainment,0,0
136299,41108,95191,30.16016258,69.83983742,Healthcare,2,2
13026,6364,6662,48.85613389,51.14386611,Housing,3,3
197321,46835,150486,23.73543617,76.26456383,Entertainment,0,0
21704,5186,16518,23.89421305,76.10578695,Housing,3,3
133787,59226,74561,44.26887515,55.73112485,Healthcare,2,2
18994,11041,7953,58.12888281,41.87111719,Housing,3,3
22305,11617,10688,52.08249271,47.91750729,Housing,3,3
225971,48929,177042,21.65277845,78.34722155,Entertainment,0,0
59981,28735,31246,47.90683717,52.09316283,Food,1,4
11304,2775,8529,24.54883227,75.45116773,Housing,3,3
69644,32036,37608,45.99965539,54.00034461,Transportation,4,4
216570,747,215823,0.34492312,99.65507688,Entertainment,0,0
45404,16763,28641,36.91965466,63.08034534,Food,1,1
98959,20113,78846,20.32457887,79.67542113,Transportation,4,4
97748,28783,68965,29.44612677,70.55387323,Transportation,4,4
96673,16734,79939,17.30990039,82.69009961,Transportation,4,4
145917,51422,94495,35.24058197,64.75941803,Healthcare,2,2
35891,15363,20528,42.80460283,57.19539717,Food,1,1
24685,2568,22117,10.40307879,89.59692121,Housing,3,3
91490,23536,67954,25.72521587,74.27478413,Transportation,4,4
185099,38939,146160,21.03685055,78.96314945,Entertainment,0,0
22610,11274,11336,49.86289253,50.13710747,Housing,3,3
128884,26962,101922,20.91958661,79.08041339,Healthcare,2,2
15254,5059,10195,33.16507146,66.83492854,Housing,3,3
176625,56983,119642,32.2621373,67.7378627,Healthcare,2,0
90465,32237,58228,35.63477588,64.36522412,Transportation,4,4
121501,44268,77233,36.43426803,63.56573197,Healthcare,2,2
88141,16185,71956,18.36262352,81.63737648,Transportation,4,4
59186,34397,24789,58.11678437,41.88321563,Food,1,4
42269,17714,24555,41.90778112,58.09221888,Food,1,1
101325,27951,73374,27.58549223,72.41450777,Transportation,4,2
181532,32210,149322,17.74342816,82.25657184,Entertainment,0,0
133277,45350,87927,34.02687636,65.97312364,Healthcare,2,2
136236,33909,102327,24.88989694,75.11010306,Healthcare,2,2
14142,2723,11419,19.25470231,80.74529769,Housing,3,3
17612,5506,12106,31.26277538,68.73722462,Housing,3,3
88698,8654,80044,9.756702519,90.24329748,Transportation,4,4
180108,49446,130662,27.45352788,72.54647212,Entertainment,0,0
30348,11227,19121,36.99420061,63.00579939,Food,1,1
12065,1374,10691,11.3883133,88.6116867,Housing,3,3
84932,29554,55378,34.79724956,65.20275044,Transportation,4,4
48500,16417,32083,33.84948454,66.15051546,Food,1,1
117054,4512,112542,3.854631196,96.1453688,Transportation,4,2
213360,11217,202143,5.257311586,94.74268841,Entertainment,0,0
57240,12418,44822,21.69461915,78.30538085,Food,1,4
31527,7787,23740,24.69946395,75.30053605,Food,1,1
59201,12363,46838,20.88309319,79.11690681,Food,1,4
133733,16780,116953,12.5473892,87.4526108,Healthcare,2,2
223114,19410,203704,8.699588551,91.30041145,Entertainment,0,0
139874,52698,87176,37.67533637,62.32466363,Healthcare,2,2
180987,59851,121136,33.06922597,66.93077403,Entertainment,0,0
241461,37042,204419,15.34077967,84.65922033,Entertainment,0,0
175057,24281,150776,13.87033938,86.12966062,Healthcare,2,0
180845,63743,117102,35.24731123,64.75268877,Entertainment,0,0
158459,20006,138453,12.62534788,87.37465212,Healthcare,2,0
12902,3669,9233,28.43745156,71.56254844,Housing,3,3
248783,49579,199204,19.92861249,80.07138751,Entertainment,0,0
199895,19114,180781,9.562020061,90.43797994,Entertainment,0,0
154400,67984,86416,44.03108808,55.96891192,Healthcare,2,0
89210,31163,58047,34.93218249,65.06781751,Transportation,4,4
245441,43531,201910,17.73583061,82.26416939,Entertainment,0,0
83389,1628,81761,1.952295866,98.04770413,Transportation,4,4
19686,5438,14248,27.62369196,72.37630804,Housing,3,3
176820,42647,134173,24.11887795,75.88112205,Healthcare,2,0
24154,826,23328,3.419723441,96.58027656,Housing,3,3
33229,1728,31501,5.200276867,94.79972313,Food,1,1
58662,3680,54982,6.273226279,93.72677372,Food,1,4
26497,2446,24051,9.231233725,90.76876628,Housing,3,1
52133,1792,50341,3.437362131,96.56263787,Food,1,4
10060,4983,5077,49.53280318,50.46719682,Housing,3,3
25701,4950,20751,19.25995097,80.74004903,Housing,3,1
140470,42257,98213,30.08257991,69.91742009,Healthcare,2,2
248337,63863,184474,25.71626459,74.28373541,Entertainment,0,0
10408,1165,9243,11.19331284,88.80668716,Housing,3,3
50304,12420,37884,24.6898855,75.3101145,Food,1,4
192289,18685,173604,9.717144506,90.28285549,Entertainment,0,0
20185,3496,16689,17.31979192,82.68020808,Housing,3,3
68844,12381,56463,17.98413805,82.01586195,Transportation,4,4
21344,3576,17768,16.75412294,83.24587706,Housing,3,3
101667,13837,87830,13.61011931,86.38988069,Transportation,4,2
201785,37811,163974,18.73826102,81.26173898,Entertainment,0,0
35128,15019,20109,42.75506718,57.24493282,Food,1,1
46424,13890,32534,29.91986903,70.08013097,Food,1,1
66602,28506,38096,42.8005165,57.1994835,Transportation,4,4
101610,35538,66072,34.97490404,65.02509596,Transportation,4,2
64038,23246,40792,36.30032168,63.69967832,Transportation,4,4
94515,23704,70811,25.07961699,74.92038301,Transportation,4,4
73998,18786,55212,25.38717263,74.61282737,Transportation,4,4
197501,67169,130332,34.00944805,65.99055195,Entertainment,0,0
84827,19636,65191,23.14829005,76.85170995,Transportation,4,4
84462,47986,36476,56.81371504,43.18628496,Transportation,4,4
202802,1429,201373,0.704628159,99.29537184,Entertainment,0,0
15836,3251,12585,20.52917403,79.47082597,Housing,3,3
194433,14631,179802,7.524957183,92.47504282,Entertainment,0,0
114959,33482,81477,29.12516636,70.87483364,Transportation,4,2
63168,422,62746,0.668059777,99.33194022,Transportation,4,4
152425,35192,117233,23.0880761,76.9119239,Healthcare,2,0
31772,14088,17684,44.34092912,55.65907088,Food,1,1
141967,57221,84746,40.30584572,59.69415428,Healthcare,2,2
212134,21400,190734,10.08796327,89.91203673,Entertainment,0,0
53374,22734,30640,42.59377225,57.40622775,Food,1,4
16801,8188,8613,48.73519433,51.26480567,Housing,3,3
47541,16970,30571,35.69550493,64.30449507,Food,1,1
63932,35811,28121,56.01420259,43.98579741,Transportation,4,4
42240,1295,40945,3.065814394,96.93418561,Food,1,4
47422,9344,38078,19.70393488,80.29606512,Food,1,1
22524,13198,9326,58.59527615,41.40472385,Housing,3,3
29515,2847,26668,9.645942741,90.35405726,Housing,3,1
141490,4456,137034,3.149339176,96.85066082,Healthcare,2,2
159252,32457,126795,20.38090573,79.61909427,Healthcare,2,0
78521,39674,38847,50.52661072,49.47338928,Transportation,4,4
77256,36094,41162,46.71999586,53.28000414,Transportation,4,4
67139,35494,31645,52.86644126,47.13355874,Transportation,4,4
66826,18129,48697,27.1286625,72.8713375,Transportation,4,4
227578,40207,187371,17.66734922,82.33265078,Entertainment,0,0
39978,14571,25407,36.44754615,63.55245385,Food,1,1
139253,37685,101568,27.0622536,72.9377464,Healthcare,2,2
12208,5354,6854,43.85648755,56.14351245,Housing,3,3
97891,18251,79640,18.64420631,81.35579369,Transportation,4,4
130057,48569,81488,37.34439515,62.65560485,Healthcare,2,2
55836,8712,47124,15.60283688,84.39716312,Food,1,4
242350,6337,236013,2.614813287,97.38518671,Entertainment,0,0
40967,19581,21386,47.79700735,52.20299265,Food,1,1
225828,30827,195001,13.65065448,86.34934552,Entertainment,0,0
21355,924,20431,4.326855537,95.67314446,Housing,3,3
28625,2863,25762,10.00174672,89.99825328,Housing,3,1
201574,15050,186524,7.466240686,92.53375931,Entertainment,0,0
28918,11113,17805,38.42935196,61.57064804,Housing,3,1
164425,17466,146959,10.62247225,89.37752775,Healthcare,2,0
63729,36397,27332,57.11214675,42.88785325,Transportation,4,4
83535,43899,39636,52.55162507,47.44837493,Transportation,4,4
119023,51642,67381,43.38825269,56.61174731,Transportation,4,4
111438,48037,63401,43.10648073,56.89351927,Transportation,4,4
40943,20289,20654,49.55425836,50.44574164,Food,1,1
156478,2251,154227,1.438540881,98.56145912,Healthcare,2,0
117068,28134,88934,24.03218642,75.96781358,Transportation,4,2
124572,23090,101482,18.53546543,81.46453457,Healthcare,2,2
72795,15883,56912,21.81880624,78.18119376,Transportation,4,4
187799,30004,157795,15.97665589,84.02334411,Entertainment,0,0
74015,43221,30794,58.39491995,41.60508005,Transportation,4,4
33028,7673,25355,23.23180332,76.76819668,Food,1,1
148716,34777,113939,23.3848409,76.6151591,Healthcare,2,2
140546,21739,118807,15.46753376,84.53246624,Healthcare,2,2
153397,21681,131716,14.13391396,85.86608604,Healthcare,2,0
205291,35501,169790,17.29301333,82.70698667,Entertainment,0,0
213556,62840,150716,29.4255371,70.5744629,Entertainment,0,0
239669,26465,213204,11.04231252,88.95768748,Entertainment,0,0
12219,4595,7624,37.60536869,62.39463131,Housing,3,3
34878,19121,15757,54.82252423,45.17747577,Food,1,1
31603,14265,17338,45.1381198,54.8618802,Food,1,1
52244,4194,48050,8.027716101,91.9722839,Food,1,4
192657,9376,183281,4.866680162,95.13331984,Entertainment,0,0
36260,10348,25912,28.53833425,71.46166575,Food,1,1
15037,3503,11534,23.29587019,76.70412981,Housing,3,3
213937,27865,186072,13.02486246,86.97513754,Entertainment,0,0
110345,18580,91765,16.83809869,83.16190131,Transportation,4,2
230516,7318,223198,3.174616946,96.82538305,Entertainment,0,0
13306,7676,5630,57.68826093,42.31173907,Housing,3,3
16576,1216,15360,7.335907336,92.66409266,Housing,3,3
168798,46951,121847,27.81490302,72.18509698,Healthcare,2,0
194437,29339,165098,15.08920627,84.91079373,Entertainment,0,0
39871,2684,37187,6.731709764,93.26829024,Food,1,1
181033,55356,125677,30.57785045,69.42214955,Entertainment,0,0
103233,60300,42933,58.41155444,41.58844556,Transportation,4,4
108734,27142,81592,24.96183347,75.03816653,Transportation,4,2
216893,25839,191054,11.91324755,88.08675245,Entertainment,0,0
118995,32378,86617,27.20954662,72.79045338,Transportation,4,2
137492,58333,79159,42.42646845,57.57353155,Healthcare,2,2
85575,3167,82408,3.70084721,96.29915279,Transportation,4,4
12170,3186,8984,26.17912901,73.82087099,Housing,3,3
22665,6962,15703,30.71696448,69.28303552,Housing,3,3
139369,45234,94135,32.45628511,67.54371489,Healthcare,2,2
93116,4495,88621,4.82731217,95.17268783,Transportation,4,4
28322,12801,15521,45.19807923,54.80192077,Housing,3,1
47697,23461,24236,49.18757993,50.81242007,Food,1,1
193925,6077,187848,3.133685703,96.8663143,Entertainment,0,0
58947,26789,32158,45.44590904,54.55409096,Food,1,4
65722,34692,31030,52.7859773,47.2140227,Transportation,4,4
158590,10686,147904,6.738129769,93.26187023,Healthcare,2,0
15612,6475,9137,41.47450679,58.52549321,Housing,3,3
172841,46366,126475,26.82581101,73.17418899,Healthcare,2,0
28828,2146,26682,7.444151519,92.55584848,Housing,3,1
23577,13988,9589,59.32900708,40.67099292,Housing,3,3
54141,10962,43179,20.24713249,79.75286751,Food,1,4
170879,61039,109840,35.72059762,64.27940238,Healthcare,2,0
241897,15074,226823,6.231577903,93.7684221,Entertainment,0,0
19956,11710,8246,58.67909401,41.32090599,Housing,3,3
202671,34193,168478,16.87118532,83.12881468,Entertainment,0,0
10052,5676,4376,56.46637485,43.53362515,Housing,3,3
51437,6417,45020,12.47545541,87.52454459,Food,1,4
79878,16034,63844,20.0731115,79.9268885,Transportation,4,4
16546,4007,12539,24.21733349,75.78266651,Housing,3,3
29646,16435,13211,55.43749578,44.56250422,Housing,3,1
147570,53204,94366,36.05339839,63.94660161,Healthcare,2,2
221057,49974,171083,22.60683896,77.39316104,Entertainment,0,0
20613,5039,15574,24.44573813,75.55426187,Housing,3,3
236817,4826,231991,2.037860458,97.96213954,Entertainment,0,0
186370,1638,184732,0.878896818,99.12110318,Entertainment,0,0
177889,48482,129407,27.25407417,72.74592583,Healthcare,2,0
24625,1224,23401,4.970558376,95.02944162,Housing,3,3
165706,36223,129483,21.85979989,78.14020011,Healthcare,2,0
155716,35026,120690,22.49351383,77.50648617,Healthcare,2,0
228016,697,227319,0.305680303,99.6943197,Entertainment,0,0
105257,18477,86780,17.55417692,82.44582308,Transportation,4,2
115195,30458,84737,26.4403837,73.5596163,Transportation,4,2
63671,33229,30442,52.18859449,47.81140551,Transportation,4,4
23006,5821,17185,25.30209511,74.69790489,Housing,3,3
31121,9447,21674,30.35570836,69.64429164,Food,1,1
24152,2205,21947,9.129678702,90.8703213,Housing,3,3
96631,41902,54729,43.36289597,56.63710403,Transportation,4,4
21882,11884,9998,54.30947811,45.69052189,Housing,3,3
28980,14966,14014,51.64251208,48.35748792,Housing,3,1
59960,29449,30511,49.11440961,50.88559039,Food,1,4
227633,28249,199384,12.40988785,87.59011215,Entertainment,0,0
169636,67784,101852,39.95849938,60.04150062,Healthcare,2,0
100944,20840,80104,20.64511016,79.35488984,Transportation,4,2
45984,757,45227,1.646224774,98.35377523,Food,1,4
33864,18844,15020,55.64611387,44.35388613,Food,1,1
51133,3384,47749,6.61803532,93.38196468,Food,1,4
79328,2272,77056,2.864058088,97.13594191,Transportation,4,4
198596,68349,130247,34.41610103,65.58389897,Entertainment,0,0
10400,781,9619,7.509615385,92.49038462,Housing,3,3
87636,24297,63339,27.72490757,72.27509243,Transportation,4,4
91604,41087,50517,44.85284485,55.14715515,Transportation,4,4
166101,5930,160171,3.570116977,96.42988302,Healthcare,2,0
119575,27650,91925,23.12356262,76.87643738,Transportation,4,2
55265,3900,51365,7.056907627,92.94309237,Food,1,4
82530,11431,71099,13.85072095,86.14927905,Transportation,4,4
46635,12177,34458,26.1112898,73.8887102,Food,1,1
79539,9466,70073,11.90107997,88.09892003,Transportation,4,4
22871,6318,16553,27.62450265,72.37549735,Housing,3,3
40782,21003,19779,51.50066206,48.49933794,Food,1,1
91741,24259,67482,26.44292083,73.55707917,Transportation,4,4
169979,12472,157507,7.33737697,92.66262303,Healthcare,2,0
167035,5232,161803,3.132277666,96.86772233,Healthcare,2,0
155989,60471,95518,38.76619505,61.23380495,Healthcare,2,0
219647,35488,184159,16.15683346,83.84316654,Entertainment,0,0
26564,2819,23745,10.61210661,89.38789339,Housing,3,1
41991,23012,18979,54.80221952,45.19778048,Food,1,1
230379,69033,161346,29.96497077,70.03502923,Entertainment,0,0
40184,1643,38541,4.088692017,95.91130798,Food,1,1
134413,49446,84967,36.78662034,63.21337966,Healthcare,2,2
172686,6347,166339,3.675457188,96.32454281,Healthcare,2,0
16034,1390,14644,8.669078209,91.33092179,Housing,3,3
100851,20170,80681,19.99980169,80.00019831,Transportation,4,2
20644,6203,14441,30.04747142,69.95252858,Housing,3,3
94527,11519,83008,12.18593629,87.81406371,Transportation,4,4
129224,13691,115533,10.59478116,89.40521884,Healthcare,2,2
146934,61694,85240,41.98755904,58.01244096,Healthcare,2,2
208159,67911,140248,32.62458025,67.37541975,Entertainment,0,0
21929,12043,9886,54.91814492,45.08185508,Housing,3,3
174156,48899,125257,28.07770045,71.92229955,Healthcare,2,0
122558,20530,102028,16.75125247,83.24874753,Healthcare,2,2
51417,6751,44666,13.12989867,86.87010133,Food,1,4
73533,27699,45834,37.66880176,62.33119824,Transportation,4,4
38214,9916,28298,25.94860522,74.05139478,Food,1,1
36430,12201,24229,33.49162778,66.50837222,Food,1,1
150716,63294,87422,41.99554128,58.00445872,Healthcare,2,0
57354,12773,44581,22.27046065,77.72953935,Food,1,4
15940,8244,7696,51.71894605,48.28105395,Housing,3,3
208113,43732,164381,21.01358397,78.98641603,Entertainment,0,0
52287,24244,28043,46.36716583,53.63283417,Food,1,4
94144,44383,49761,47.14373725,52.85626275,Transportation,4,4
18824,10868,7956,57.73480663,42.26519337,Housing,3,3
15211,3349,11862,22.01696141,77.98303859,Housing,3,3
96080,27932,68148,29.07160699,70.92839301,Transportation,4,4
98595,6995,91600,7.094680258,92.90531974,Transportation,4,4
20642,1875,18767,9.083422149,90.91657785,Housing,3,3
173593,9693,163900,5.583750497,94.4162495,Healthcare,2,0
114954,66110,48844,57.50996051,42.49003949,Transportation,4,4
19733,4420,15313,22.39902701,77.60097299,Housing,3,3
24028,10304,13724,42.88330281,57.11669719,Housing,3,3
92729,44512,48217,48.0022431,51.9977569,Transportation,4,4
32571,9281,23290,28.49467318,71.50532682,Food,1,1
175578,14137,161441,8.051692125,91.94830787,Healthcare,2,0
62430,24381,38049,39.05333974,60.94666026,Transportation,4,4
44732,11314,33418,25.29285523,74.70714477,Food,1,1
14202,6416,7786,45.17673567,54.82326433,Housing,3,3
39567,8628,30939,21.8060505,78.1939495,Food,1,1
56882,1536,55346,2.700326993,97.29967301,Food,1,4
92066,1790,90276,1.944257381,98.05574262,Transportation,4,4
167015,24625,142390,14.74418465,85.25581535,Healthcare,2,0
12294,3914,8380,31.83666829,68.16333171,Housing,3,3
166053,19874,146179,11.9684679,88.0315321,Healthcare,2,0
49744,22361,27383,44.95215503,55.04784497,Food,1,1
102403,17962,84441,17.54050174,82.45949826,Transportation,4,2
22214,10743,11471,48.36139372,51.63860628,Housing,3,3
17601,1293,16308,7.346173513,92.65382649,Housing,3,3
207909,2445,205464,1.175995267,98.82400473,Entertainment,0,0
17979,7880,10099,43.82891151,56.17108849,Housing,3,3
21341,11161,10180,52.29839277,47.70160723,Housing,3,3
42252,8841,33411,20.92445328,79.07554672,Food,1,1
199911,8661,191250,4.33242793,95.66757207,Entertainment,0,0
101467,55289,46178,54.48963702,45.51036298,Transportation,4,4
91096,41179,49917,45.20396066,54.79603934,Transportation,4,4
214957,60600,154357,28.19168485,71.80831515,Entertainment,0,0
29994,3962,26032,13.20930853,86.79069147,Housing,3,1
103994,5943,98051,5.714752774,94.28524723,Transportation,4,2
234960,64250,170710,27.34508001,72.65491999,Entertainment,0,0
35599,9317,26282,26.17208349,73.82791651,Food,1,1
43636,1120,42516,2.566688056,97.43331194,Food,1,4
156254,28530,127724,18.25873258,81.74126742,Healthcare,2,0
122981,24302,98679,19.76077605,80.23922395,Healthcare,2,2
119436,1374,118062,1.150406912,98.84959309,Transportation,4,2
55413,29459,25954,53.16261527,46.83738473,Food,1,4
32161,16847,15314,52.38332141,47.61667859,Food,1,1
25326,9882,15444,39.01918977,60.98081023,Housing,3,1
79942,20291,59651,25.38215206,74.61784794,Transportation,4,4
35705,19666,16039,55.07912057,44.92087943,Food,1,1
84309,35562,48747,42.18055012,57.81944988,Transportation,4,4
244634,48858,195776,19.97187635,80.02812365,Entertainment,0,0
226338,53218,173120,23.51262271,76.48737729,Entertainment,0,0
175854,3855,171999,2.192159405,97.8078406,Healthcare,2,0
70013,7543,62470,10.77371345,89.22628655,Transportation,4,4
176976,35251,141725,19.91852003,80.08147997,Healthcare,2,0
142364,62855,79509,44.15090894,55.84909106,Healthcare,2,2
28374,5622,22752,19.81391415,80.18608585,Housing,3,1
123393,37456,85937,30.35504445,69.64495555,Healthcare,2,2
56404,26987,29417,47.84589745,52.15410255,Food,1,4
35000,6610,28390,18.88571429,81.11428571,Food,1,1
99182,14790,84392,14.91198,85.08802,Transportation,4,4
223254,44978,178276,20.14655952,79.85344048,Entertainment,0,0
210322,55304,155018,26.29491922,73.70508078,Entertainment,0,0
75103,757,74346,1.007949083,98.99205092,Transportation,4,4
10593,2840,7753,26.81015765,73.18984235,Housing,3,3
12747,6996,5751,54.883502,45.116498,Housing,3,3
175916,21584,154332,12.26949226,87.73050774,Healthcare,2,0
30826,1832,28994,5.9430351,94.0569649,Food,1,1
110437,31890,78547,28.87619186,71.12380814,Transportation,4,2
74561,26613,47948,35.69292257,64.30707743,Transportation,4,4
146722,54492,92230,37.1396246,62.8603754,Healthcare,2,2
147783,68239,79544,46.17513516,53.82486484,Healthcare,2,2
105736,32844,72892,31.06226829,68.93773171,Transportation,4,2
48028,6917,41111,14.40201549,85.59798451,Food,1,4
20196,1454,18742,7.199445435,92.80055457,Housing,3,3
182829,40448,142381,22.12340493,77.87659507,Entertainment,0,0
70957,35316,35641,49.77098806,50.22901194,Transportation,4,4
233661,40977,192684,17.53694455,82.46305545,Entertainment,0,0
226109,49991,176118,22.10924819,77.89075181,Entertainment,0,0
75335,34607,40728,45.93747926,54.06252074,Transportation,4,4
172277,25945,146332,15.06004864,84.93995136,Healthcare,2,0
222283,27903,194380,12.55291678,87.44708322,Entertainment,0,0
13577,1368,12209,10.07586359,89.92413641,Housing,3,3
171072,63410,107662,37.0662645,62.9337355,Healthcare,2,0
45715,15645,30070,34.22290277,65.77709723,Food,1,1
191679,42222,149457,22.02745215,77.97254785,Entertainment,0,0
154492,53368,101124,34.54418352,65.45581648,Healthcare,2,0
58684,19643,39041,33.47249676,66.52750324,Food,1,4
15318,4648,10670,30.34338687,69.65661313,Housing,3,3
30404,10532,19872,34.64017892,65.35982108,Food,1,1
79381,26023,53358,32.78240385,67.21759615,Transportation,4,4
225432,63919,161513,28.35400476,71.64599524,Entertainment,0,0
16613,4017,12596,24.17985915,75.82014085,Housing,3,3
248441,20478,227963,8.242600859,91.75739914,Entertainment,0,0
115341,18484,96857,16.02552431,83.97447569,Transportation,4,2
214465,41426,173039,19.3159723,80.6840277,Entertainment,0,0
36218,55,36163,0.151858192,99.84814181,Food,1,1
154530,64215,90315,41.55503786,58.44496214,Healthcare,2,0
31830,8411,23419,26.42475652,73.57524348,Food,1,1
107814,59509,48305,55.19598568,44.80401432,Transportation,4,4
226975,44335,182640,19.53298821,80.46701179,Entertainment,0,0
98344,57689,40655,58.6604165,41.3395835,Transportation,4,4
29009,1911,27098,6.587610741,93.41238926,Housing,3,1
59897,9396,50501,15.68692923,84.31307077,Food,1,4
191053,25105,165948,13.14033279,86.85966721,Entertainment,0,0
57052,32709,24343,57.33190773,42.66809227,Food,1,4
50175,8340,41835,16.62182362,83.37817638,Food,1,4
26413,7746,18667,29.32646803,70.67353197,Housing,3,1
222657,33235,189422,14.92654621,85.07345379,Entertainment,0,0
191804,3322,188482,1.731976393,98.26802361,Entertainment,0,0
80095,14145,65950,17.66027842,82.33972158,Transportation,4,4
172606,13968,158638,8.092418572,91.90758143,Healthcare,2,0
53058,29263,23795,55.1528516,44.8471484,Food,1,4
110648,6566,104082,5.934133468,94.06586653,Transportation,4,2
226149,14963,211186,6.616434298,93.3835657,Entertainment,0,0
80727,1230,79497,1.523653796,98.4763462,Transportation,4,4
117054,40496,76558,34.59599843,65.40400157,Transportation,4,2
221503,58740,162763,26.51882819,73.48117181,Entertainment,0,0
14779,1327,13452,8.978956628,91.02104337,Housing,3,3
52670,21016,31654,39.90127207,60.09872793,Food,1,4
152087,21114,130973,13.88284337,86.11715663,Healthcare,2,0
242635,6650,235985,2.740742267,97.25925773,Entertainment,0,0
148877,17996,130881,12.08783089,87.91216911,Healthcare,2,2
60958,7912,53046,12.97942846,87.02057154,Transportation,4,4
64967,31332,33635,48.22756169,51.77243831,Transportation,4,4
132246,47340,84906,35.79692391,64.20307609,Healthcare,2,2
144668,9175,135493,6.342107446,93.65789255,Healthcare,2,2
121531,24762,96769,20.37504834,79.62495166,Healthcare,2,2
14671,8673,5998,59.11662463,40.88337537,Housing,3,3
73001,19207,53794,26.31059848,73.68940152,Transportation,4,4
82336,5031,77305,6.11032841,93.88967159,Transportation,4,4
132806,45701,87105,34.41184886,65.58815114,Healthcare,2,2
237871,69890,167981,29.38147147,70.61852853,Entertainment,0,0
13711,826,12885,6.024360003,93.97564,Housing,3,3
181172,40283,140889,22.23467202,77.76532798,Entertainment,0,0
134714,6050,128664,4.490995739,95.50900426,Healthcare,2,2
84815,24074,60741,28.38413017,71.61586983,Transportation,4,4
111124,65383,45741,58.83787481,41.16212519,Transportation,4,4
23301,4343,18958,18.63868503,81.36131497,Housing,3,3
39430,14136,25294,35.85087497,64.14912503,Food,1,1
212246,62313,149933,29.35885718,70.64114282,Entertainment,0,0
31428,3422,28006,10.88837979,89.11162021,Food,1,1
31133,5655,25478,18.16400604,81.83599396,Food,1,1
38520,12648,25872,32.83489097,67.16510903,Food,1,1
206363,34511,171852,16.72344364,83.27655636,Entertainment,0,0
39774,20358,19416,51.18419068,48.81580932,Food,1,1
21754,10021,11733,46.06509148,53.93490852,Housing,3,3
183666,42596,141070,23.1920987,76.8079013,Entertainment,0,0
125546,28502,97044,22.70243576,77.29756424,Healthcare,2,2
34469,614,33855,1.781310743,98.21868926,Food,1,1
39632,2478,37154,6.252523214,93.74747679,Food,1,1
42882,25353,17529,59.12270883,40.87729117,Food,1,1
103668,42667,61001,41.15734846,58.84265154,Transportation,4,4
30354,5419,24935,17.85267181,82.14732819,Food,1,1
63075,11386,51689,18.05152596,81.94847404,Transportation,4,4
50554,19769,30785,39.10471971,60.89528029,Food,1,4
195037,10096,184941,5.176453699,94.8235463,Entertainment,0,0
14976,191,14785,1.275373932,98.72462607,Housing,3,3
23090,13054,10036,56.53529667,43.46470333,Housing,3,3
224340,29978,194362,13.36275296,86.63724704,Entertainment,0,0
31890,7019,24871,22.01003449,77.98996551,Food,1,1
28039,12505,15534,44.59859481,55.40140519,Housing,3,1
13025,7544,5481,57.9193858,42.0806142,Housing,3,3
36757,3260,33497,8.869058955,91.13094105,Food,1,1
35328,14663,20665,41.50532156,58.49467844,Food,1,1
50817,23598,27219,46.43721589,53.56278411,Food,1,4
29227,16825,12402,57.56663359,42.43336641,Housing,3,1
52334,12401,39933,23.69587649,76.30412351,Food,1,4
209382,10467,198915,4.998997048,95.00100295,Entertainment,0,0
11960,460,11500,3.846153846,96.15384615,Housing,3,3
221880,27766,194114,12.51397152,87.48602848,Entertainment,0,0
113235,42524,70711,37.55375988,62.44624012,Transportation,4,2
130747,25856,104891,19.77559715,80.22440285,Healthcare,2,2
167296,47054,120242,28.12619549,71.87380451,Healthcare,2,0
48919,7726,41193,15.79345449,84.20654551,Food,1,4
53103,15183,37920,28.59160499,71.40839501,Food,1,4
32599,5342,27257,16.38700574,83.61299426,Food,1,1
14954,2509,12445,16.77811957,83.22188043,Housing,3,3
232799,30363,202436,13.0425818,86.9574182,Entertainment,0,0
15013,7358,7655,49.01085726,50.98914274,Housing,3,3
40570,18971,21599,46.76115356,53.23884644,Food,1,1
73284,38631,34653,52.71409858,47.28590142,Transportation,4,4
189338,1956,187382,1.033073128,98.96692687,Entertainment,0,0
20489,1711,18778,8.350822393,91.64917761,Housing,3,3
176597,55876,120721,31.64040159,68.35959841,Healthcare,2,0
62813,36892,25921,58.73306481,41.26693519,Transportation,4,4
110465,14973,95492,13.55451953,86.44548047,Transportation,4,2
24120,6511,17609,26.99419569,73.00580431,Housing,3,3
15853,324,15529,2.043777203,97.9562228,Housing,3,3
104392,181,104211,0.173384934,99.82661507,Transportation,4,2
118904,60843,58061,51.16985131,48.83014869,Transportation,4,4
149018,35071,113947,23.53474077,76.46525923,Healthcare,2,2
217827,58736,159091,26.96451771,73.03548229,Entertainment,0,0
10636,378,10258,3.553967657,96.44603234,Housing,3,3
221879,66662,155217,30.04430343,69.95569657,Entertainment,0,0
209307,46139,163168,22.04369658,77.95630342,Entertainment,0,0
227189,47002,180187,20.68850164,79.31149836,Entertainment,0,0
230214,9927,220287,4.312074852,95.68792515,Entertainment,0,0
94020,38280,55740,40.71474154,59.28525846,Transportation,4,4
12918,3196,9722,24.74067193,75.25932807,Housing,3,3
105698,63376,42322,59.95950728,40.04049272,Transportation,4,4
216825,980,215845,0.451977401,99.5480226,Entertainment,0,0
150036,66722,83314,44.47066037,55.52933963,Healthcare,2,0
27115,14007,13108,51.65775401,48.34224599,Housing,3,1
13944,5297,8647,37.98766495,62.01233505,Housing,3,3
195681,45532,150149,23.26848289,76.73151711,Entertainment,0,0
33400,15359,18041,45.98502994,54.01497006,Food,1,1
242536,45213,197323,18.64176864,81.35823136,Entertainment,0,0
145651,33322,112329,22.87797543,77.12202457,Healthcare,2,2
78534,38287,40247,48.75213283,51.24786717,Transportation,4,4
41467,16522,24945,39.84373116,60.15626884,Food,1,1
134822,39734,95088,29.47145125,70.52854875,Healthcare,2,2
131814,3291,128523,2.496699895,97.5033001,Healthcare,2,2
46022,15291,30731,33.22541393,66.77458607,Food,1,1
63311,32661,30650,51.58819163,48.41180837,Transportation,4,4
165538,35551,129987,21.47603571,78.52396429,Healthcare,2,0
214430,22971,191459,10.71258686,89.28741314,Entertainment,0,0
195377,29716,165661,15.20956919,84.79043081,Entertainment,0,0
104361,49792,54569,47.71130978,52.28869022,Transportation,4,4
23836,10902,12934,45.73753986,54.26246014,Housing,3,3
153525,45396,108129,29.56912555,70.43087445,Healthcare,2,0
47371,6928,40443,14.62498153,85.37501847,Food,1,1
150768,21382,129386,14.18205455,85.81794545,Healthcare,2,0
70992,17706,53286,24.9408384,75.0591616,Transportation,4,4
94982,21137,73845,22.25369017,77.74630983,Transportation,4,4
145985,52149,93836,35.72216324,64.27783676,Healthcare,2,2
199702,61793,137909,30.94260448,69.05739552,Entertainment,0,0
63558,374,63184,0.588438906,99.41156109,Transportation,4,4
10057,83,9974,0.825295814,99.17470419,Housing,3,3
21638,5310,16328,24.54016083,75.45983917,Housing,3,3
14382,6687,7695,46.49561952,53.50438048,Housing,3,3
64309,11081,53228,17.23086971,82.76913029,Transportation,4,4
55787,12777,43010,22.90318533,77.09681467,Food,1,4
193401,19252,174149,9.954446978,90.04555302,Entertainment,0,0
21104,11321,9783,53.64385898,46.35614102,Housing,3,3
204965,37844,167121,18.46364013,81.53635987,Entertainment,0,0
159625,42334,117291,26.52090838,73.47909162,Healthcare,2,0
88513,40785,47728,46.07797725,53.92202275,Transportation,4,4
113087,27126,85961,23.98684199,76.01315801,Transportation,4,2
10060,1187,8873,11.79920477,88.20079523,Housing,3,3
167019,64653,102366,38.70996713,61.29003287,Healthcare,2,0
134684,54727,79957,40.63363131,59.36636869,Healthcare,2,2
79839,1661,78178,2.080436879,97.91956312,Transportation,4,4
188055,41747,146308,22.19935657,77.80064343,Entertainment,0,0
154061,39631,114430,25.72422612,74.27577388,Healthcare,2,0
35045,5368,29677,15.31744899,84.68255101,Food,1,1
150088,15654,134434,10.42988114,89.57011886,Healthcare,2,0
116771,66718,50053,57.13576145,42.86423855,Transportation,4,4
242964,37313,205651,15.35741921,84.64258079,Entertainment,0,0
13692,6680,7012,48.7876132,51.2123868,Housing,3,3
95343,20649,74694,21.65759416,78.34240584,Transportation,4,4
115235,17143,98092,14.8765566,85.1234434,Transportation,4,2
40404,10530,29874,26.06177606,73.93822394,Food,1,1
27716,12354,15362,44.57353153,55.42646847,Housing,3,1
36511,15670,20841,42.91857249,57.08142751,Food,1,1
172352,8672,163680,5.031563312,94.96843669,Healthcare,2,0
11684,1439,10245,12.31598768,87.68401232,Housing,3,3
179403,17970,161433,10.01655491,89.98344509,Healthcare,2,0
180314,56957,123357,31.58767483,68.41232517,Entertainment,0,0
158294,3759,154535,2.374695187,97.62530481,Healthcare,2,0
87918,36843,51075,41.90609432,58.09390568,Transportation,4,4
56811,28653,28158,50.43565507,49.56434493,Food,1,4
170975,15463,155512,9.044012282,90.95598772,Healthcare,2,0
21332,8583,12749,40.23532721,59.76467279,Housing,3,3
103438,58696,44742,56.74510335,43.25489665,Transportation,4,4
201310,47544,153766,23.61730664,76.38269336,Entertainment,0,0
12241,2913,9328,23.7970754,76.2029246,Housing,3,3
248101,22438,225663,9.043897445,90.95610256,Entertainment,0,0
104158,56688,47470,54.42500816,45.57499184,Transportation,4,4
44985,2992,41993,6.651105924,93.34889408,Food,1,4
97200,31969,65231,32.8899177,67.1100823,Transportation,4,4
24877,2777,22100,11.16292157,88.83707843,Housing,3,3
246889,23981,222908,9.713271956,90.28672804,Entertainment,0,0
56242,237,56005,0.421393265,99.57860674,Food,1,4
36598,4246,32352,11.60172687,88.39827313,Food,1,1
56009,14896,41113,26.59572569,73.40427431,Food,1,4
238694,59454,179240,24.90804126,75.09195874,Entertainment,0,0
120628,19115,101513,15.84623802,84.15376198,Healthcare,2,2
74284,35330,38954,47.56071294,52.43928706,Transportation,4,4
137262,7948,129314,5.790386269,94.20961373,Healthcare,2,2
248686,11251,237435,4.524179085,95.47582091,Entertainment,0,0
22698,4529,18169,19.95329985,80.04670015,Housing,3,3
247282,36704,210578,14.8429728,85.1570272,Entertainment,0,0
55486,20981,34505,37.81314205,62.18685795,Food,1,4
26888,3695,23193,13.74218982,86.25781018,Housing,3,1
24130,14041,10089,58.18897638,41.81102362,Housing,3,3
20086,6127,13959,30.50383352,69.49616648,Housing,3,3
132232,56545,75687,42.76196382,57.23803618,Healthcare,2,2
84013,16454,67559,19.58506422,80.41493578,Transportation,4,4
30713,13613,17100,44.32325074,55.67674926,Food,1,1
197262,31522,165740,15.97976295,84.02023705,Entertainment,0,0
37175,15990,21185,43.0127774,56.9872226,Food,1,1
43409,16528,26881,38.07505356,61.92494644,Food,1,1
132175,55338,76837,41.86722149,58.13277851,Healthcare,2,2
163174,15564,147610,9.538284285,90.46171571,Healthcare,2,0
143780,49750,94030,34.60147447,65.39852553,Healthcare,2,2
204031,40989,163042,20.08959423,79.91040577,Entertainment,0,0
171303,60731,110572,35.45238554,64.54761446,Healthcare,2,0
108151,15055,93096,13.9203521,86.0796479,Transportation,4,2
244647,51316,193331,20.97552801,79.02447199,Entertainment,0,0
47482,18226,29256,38.38507224,61.61492776,Food,1,1
29298,13171,16127,44.95528705,55.04471295,Housing,3,1
37896,19472,18424,51.38273169,48.61726831,Food,1,1
125573,17086,108487,13.60642813,86.39357187,Healthcare,2,2
17249,5308,11941,30.77279842,69.22720158,Housing,3,3
104512,56552,47960,54.11053276,45.88946724,Transportation,4,4
18121,9123,8998,50.3449037,49.6550963,Housing,3,3
103830,44178,59652,42.54839642,57.45160358,Transportation,4,4
170789,59969,110820,35.11291711,64.88708289,Healthcare,2,0
216830,9515,207315,4.388230411,95.61176959,Entertainment,0,0
248131,51670,196461,20.82367782,79.17632218,Entertainment,0,0
53607,17625,35982,32.8781689,67.1218311,Food,1,4
58813,30419,28394,51.72155816,48.27844184,Food,1,4
150989,59261,91728,39.24855453,60.75144547,Healthcare,2,0
233197,29910,203287,12.82606552,87.17393448,Entertainment,0,0
48915,1334,47581,2.727179802,97.2728202,Food,1,4
159121,25792,133329,16.20904846,83.79095154,Healthcare,2,0
52508,2617,49891,4.984002438,95.01599756,Food,1,4
11111,2447,8664,22.02322023,77.97677977,Housing,3,3
103052,8281,94771,8.035748942,91.96425106,Transportation,4,2
73103,36071,37032,49.34270823,50.65729177,Transportation,4,4
223334,62036,161298,27.77723052,72.22276948,Entertainment,0,0
158260,68357,89903,43.19284721,56.80715279,Healthcare,2,0
55819,8492,47327,15.21345778,84.78654222,Food,1,4
22281,786,21495,3.527669315,96.47233069,Housing,3,3
32287,9374,22913,29.03335708,70.96664292,Food,1,1
27898,12923,14975,46.32231701,53.67768299,Housing,3,1
19042,9367,9675,49.19126142,50.80873858,Housing,3,3
19325,5206,14119,26.93919793,73.06080207,Housing,3,3
10886,1657,9229,15.22138527,84.77861473,Housing,3,3
83604,40984,42620,49.02157791,50.97842209,Transportation,4,4
27228,14334,12894,52.64433671,47.35566329,Housing,3,1
32878,15622,17256,47.51505566,52.48494434,Food,1,1
170488,32293,138195,18.94150908,81.05849092,Healthcare,2,0
44886,22404,22482,49.91311322,50.08688678,Food,1,1
94124,54395,39729,57.79078662,42.20921338,Transportation,4,4
10308,5229,5079,50.72759022,49.27240978,Housing,3,3
149711,36347,113364,24.27810916,75.72189084,Healthcare,2,2
73025,16766,56259,22.95926053,77.04073947,Transportation,4,4
40693,5172,35521,12.70980267,87.29019733,Food,1,1
130249,64173,66076,49.26947616,50.73052384,Healthcare,2,4
10191,413,9778,4.052595427,95.94740457,Housing,3,3
11730,2358,9372,20.10230179,79.89769821,Housing,3,3
11222,6284,4938,55.99714846,44.00285154,Housing,3,3
13072,6823,6249,52.19553244,47.80446756,Housing,3,3
183447,32766,150681,17.86128964,82.13871036,Entertainment,0,0
202377,60836,141541,30.06072824,69.93927176,Entertainment,0,0
10636,447,10189,4.202707785,95.79729222,Housing,3,3
37108,17683,19425,47.65279724,52.34720276,Food,1,1
24728,12451,12277,50.35182789,49.64817211,Housing,3,3
236274,36742,199532,15.55058957,84.44941043,Entertainment,0,0
71019,7166,63853,10.09025754,89.90974246,Transportation,4,4
198052,45857,152195,23.15402016,76.84597984,Entertainment,0,0
164859,21517,143342,13.05175938,86.94824062,Healthcare,2,0
23385,13020,10365,55.67671584,44.32328416,Housing,3,3
191515,10978,180537,5.732188079,94.26781192,Entertainment,0,0
94899,35135,59764,37.02357243,62.97642757,Transportation,4,4
26808,15832,10976,59.05699791,40.94300209,Housing,3,1
102826,51524,51302,50.10794935,49.89205065,Transportation,4,4
57713,17259,40454,29.90487412,70.09512588,Food,1,4
177144,53559,123585,30.23472429,69.76527571,Healthcare,2,0
11406,342,11064,2.998421883,97.00157812,Housing,3,3
14419,7182,7237,49.80927942,50.19072058,Housing,3,3
43966,21973,21993,49.97725515,50.02274485,Food,1,1
187116,48855,138261,26.1094722,73.8905278,Entertainment,0,0
22654,11502,11152,50.77249051,49.22750949,Housing,3,3
119396,48603,70793,40.70739388,59.29260612,Transportation,4,4
44561,12588,31973,28.24891721,71.75108279,Food,1,1
246855,43833,203022,17.75657775,82.24342225,Entertainment,0,0
132881,27619,105262,20.78476231,79.21523769,Healthcare,2,2
109654,64289,45365,58.62896018,41.37103982,Transportation,4,4
131738,23787,107951,18.05629355,81.94370645,Healthcare,2,2
18110,4187,13923,23.1198233,76.8801767,Housing,3,3
220424,21158,199266,9.598773273,90.40122673,Entertainment,0,0
14202,4662,9540,32.82636248,67.17363752,Housing,3,3
45654,15889,29765,34.80308407,65.19691593,Food,1,1
13970,1910,12060,13.67215462,86.32784538,Housing,3,3
151870,42342,109528,27.88042405,72.11957595,Healthcare,2,0
15497,7279,8218,46.97038136,53.02961864,Housing,3,3
49916,17134,32782,34.32566712,65.67433288,Food,1,1
210169,18947,191222,9.015125922,90.98487408,Entertainment,0,0
235845,26770,209075,11.35067523,88.64932477,Entertainment,0,0
185478,53689,131789,28.94629013,71.05370987,Entertainment,0,0
180770,13174,167596,7.287713669,92.71228633,Entertainment,0,0
223580,9242,214338,4.133643439,95.86635656,Entertainment,0,0
197422,69373,128049,35.13944748,64.86055252,Entertainment,0,0
23802,14279,9523,59.99075708,40.00924292,Housing,3,3
56948,28313,28635,49.71728595,50.28271405,Food,1,4
102413,39219,63194,38.29494302,61.70505698,Transportation,4,2
51106,7834,43272,15.3289242,84.6710758,Food,1,4
176023,64148,111875,36.44296484,63.55703516,Healthcare,2,0
61739,35741,25998,57.89047442,42.10952558,Transportation,4,4
249422,61230,188192,24.54875673,75.45124327,Entertainment,0,0
137712,64558,73154,46.87899384,53.12100616,Healthcare,2,2
83968,33704,50264,40.13910061,59.86089939,Transportation,4,4
83120,11307,71813,13.60322425,86.39677575,Transportation,4,4
234940,10510,224430,4.473482591,95.52651741,Entertainment,0,0
51784,8043,43741,15.5318245,84.4681755,Food,1,4
28590,11917,16673,41.68240644,58.31759356,Housing,3,1
191856,23282,168574,12.13514302,87.86485698,Entertainment,0,0
211103,51106,159997,24.2090354,75.7909646,Entertainment,0,0
25212,8699,16513,34.50341107,65.49658893,Housing,3,1
58018,17085,40933,29.44775759,70.55224241,Food,1,4
170525,23995,146530,14.07125055,85.92874945,Healthcare,2,0
194433,10744,183689,5.525810948,94.47418905,Entertainment,0,0
245431,67392,178039,27.45863399,72.54136601,Entertainment,0,0
161445,51618,109827,31.97249837,68.02750163,Healthcare,2,0
25866,12929,12937,49.98453568,50.01546432,Housing,3,1
139575,18990,120585,13.60558839,86.39441161,Healthcare,2,2
108211,51903,56308,47.96462467,52.03537533,Transportation,4,4
55142,14714,40428,26.68383446,73.31616554,Food,1,4
41703,22296,19407,53.46377958,46.53622042,Food,1,1
44414,5355,39059,12.05700905,87.94299095,Food,1,1
39413,15431,23982,39.15205643,60.84794357,Food,1,1
33491,11460,22031,34.21814816,65.78185184,Food,1,1
24846,4229,20617,17.02084843,82.97915157,Housing,3,3
30083,16155,13928,53.70142605,46.29857395,Food,1,1
166275,55995,110280,33.67613893,66.32386107,Healthcare,2,0
200803,49734,151069,24.76755825,75.23244175,Entertainment,0,0
24165,12953,11212,53.6023174,46.3976826,Housing,3,3
44894,3599,41295,8.016661469,91.98333853,Food,1,4
23022,11214,11808,48.70992963,51.29007037,Housing,3,3
19058,1872,17186,9.822646658,90.17735334,Housing,3,3
86770,41453,45317,47.77342399,52.22657601,Transportation,4,4
246154,61284,184870,24.89660944,75.10339056,Entertainment,0,0
233446,58677,174769,25.13514903,74.86485097,Entertainment,0,0
145269,52683,92586,36.26582409,63.73417591,Healthcare,2,2
28704,830,27874,2.891583055,97.10841695,Housing,3,1
20570,8224,12346,39.98055421,60.01944579,Housing,3,3
102479,21219,81260,20.70570556,79.29429444,Transportation,4,2
195774,51492,144282,26.30175611,73.69824389,Entertainment,0,0
147062,29544,117518,20.08948607,79.91051393,Healthcare,2,2
87887,25615,62272,29.14537986,70.85462014,Transportation,4,4
14531,479,14052,3.296400798,96.7035992,Housing,3,3
217420,8860,208560,4.075062092,95.92493791,Entertainment,0,0
225383,46756,178627,20.74513162,79.25486838,Entertainment,0,0
25132,2625,22507,10.44485119,89.55514881,Housing,3,1
94736,33109,61627,34.94869954,65.05130046,Transportation,4,4
195707,62948,132759,32.16440904,67.83559096,Entertainment,0,0
30190,5339,24851,17.6846638,82.3153362,Food,1,1
91543,40993,50550,44.78004872,55.21995128,Transportation,4,4
241742,38743,202999,16.02659033,83.97340967,Entertainment,0,0
68644,8861,59783,12.90863003,87.09136997,Transportation,4,4
34825,12918,21907,37.09404164,62.90595836,Food,1,1
225430,25955,199475,11.51355188,88.48644812,Entertainment,0,0
120443,8969,111474,7.446676021,92.55332398,Healthcare,2,2
50541,6148,44393,12.16438139,87.83561861,Food,1,4
10763,3329,7434,30.93003809,69.06996191,Housing,3,3
16122,2709,13413,16.80312616,83.19687384,Housing,3,3
13615,1779,11836,13.0664708,86.9335292,Housing,3,3
37597,535,37062,1.422985877,98.57701412,Food,1,1
233632,21829,211803,9.343326257,90.65667374,Entertainment,0,0
239546,11980,227566,5.001127132,94.99887287,Entertainment,0,0
249746,53077,196669,21.25239243,78.74760757,Entertainment,0,0
157168,32901,124267,20.93365062,79.06634938,Healthcare,2,0
208765,32606,176159,15.61851843,84.38148157,Entertainment,0,0
69980,1340,68640,1.914832809,98.08516719,Transportation,4,4
82357,5176,77181,6.284833105,93.7151669,Transportation,4,4
226742,69597,157145,30.69435746,69.30564254,Entertainment,0,0
14048,6434,7614,45.8001139,54.1998861,Housing,3,3
233449,11603,221846,4.970250462,95.02974954,Entertainment,0,0
13273,7347,5926,55.3529722,44.6470278,Housing,3,3
209868,65873,143995,31.38782473,68.61217527,Entertainment,0,0
67187,37564,29623,55.90962537,44.09037463,Transportation,4,4
202873,67291,135582,33.16902693,66.83097307,Entertainment,0,0
50639,13761,36878,27.17470724,72.82529276,Food,1,4
44379,9915,34464,22.34164808,77.65835192,Food,1,1
205793,63401,142392,30.80814216,69.19185784,Entertainment,0,0
213662,67266,146396,31.48243487,68.51756513,Entertainment,0,0
241907,32833,209074,13.57257128,86.42742872,Entertainment,0,0
161406,17125,144281,10.60989059,89.39010941,Healthcare,2,0
83184,3705,79479,4.453981535,95.54601847,Transportation,4,4
77307,37330,39977,48.28799462,51.71200538,Transportation,4,4
53364,5073,48291,9.506408815,90.49359119,Food,1,4
32219,18959,13260,58.84416028,41.15583972,Food,1,1
223535,63870,159665,28.57270673,71.42729327,Entertainment,0,0
149667,37940,111727,25.34960947,74.65039053,Healthcare,2,2
40626,7058,33568,17.37311082,82.62688918,Food,1,1
132658,30781,101877,23.20327459,76.79672541,Healthcare,2,2
84615,24170,60445,28.56467529,71.43532471,Transportation,4,4
54586,30270,24316,55.45377936,44.54622064,Food,1,4
34652,10290,24362,29.69525569,70.30474431,Food,1,1
84940,34342,50598,40.43089239,59.56910761,Transportation,4,4
242147,54300,187847,22.4243951,77.5756049,Entertainment,0,0
55805,15068,40737,27.00116477,72.99883523,Food,1,4
100817,5047,95770,5.006100162,94.99389984,Transportation,4,2
12483,6857,5626,54.93070576,45.06929424,Housing,3,3
175991,56889,119102,32.32494843,67.67505157,Healthcare,2,0
247454,50822,196632,20.53795857,79.46204143,Entertainment,0,0
105867,6114,99753,5.775170733,94.22482927,Transportation,4,2
42424,11069,31355,26.09136338,73.90863662,Food,1,1
30407,14228,16179,46.79185714,53.20814286,Food,1,1
11215,731,10484,6.518056175,93.48194383,Housing,3,3
28187,11556,16631,40.99762302,59.00237698,Housing,3,1
160355,15375,144980,9.5881014,90.4118986,Healthcare,2,0
47845,12781,35064,26.71334518,73.28665482,Food,1,1
201495,51239,150256,25.42941512,74.57058488,Entertainment,0,0
177527,47928,129599,26.99758347,73.00241653,Healthcare,2,0
57137,28943,28194,50.65544218,49.34455782,Food,1,4
90335,46264,44071,51.21381524,48.78618476,Transportation,4,4
13250,542,12708,4.090566038,95.90943396,Housing,3,3
12856,1146,11710,8.9141257,91.0858743,Housing,3,3
22833,3136,19697,13.73450707,86.26549293,Housing,3,3
209727,56165,153562,26.78005216,73.21994784,Entertainment,0,0
36897,1477,35420,4.003035477,95.99696452,Food,1,1
59497,21098,38399,35.46061146,64.53938854,Food,1,4
25701,8740,16961,34.00645889,65.99354111,Housing,3,1
18498,10043,8455,54.29235593,45.70764407,Housing,3,3
22945,9515,13430,41.46872957,58.53127043,Housing,3,3
21909,3062,18847,13.9759916,86.0240084,Housing,3,3
35087,1528,33559,4.354889275,95.64511072,Food,1,1
66999,38499,28500,57.46205167,42.53794833,Transportation,4,4
86847,8785,78062,10.11549046,89.88450954,Transportation,4,4
65966,24145,41821,36.60218901,63.39781099,Transportation,4,4
58390,8570,49820,14.67717075,85.32282925,Food,1,4
32554,9393,23161,28.8535971,71.1464029,Food,1,1
44995,5208,39787,11.5746194,88.4253806,Food,1,1
23313,9593,13720,41.14871531,58.85128469,Housing,3,3
82785,4,82781,0.004831793,99.99516821,Transportation,4,4
63199,1783,61416,2.821247172,97.17875283,Transportation,4,4
66756,11449,55307,17.15051831,82.84948169,Transportation,4,4
58685,6759,51926,11.51742353,88.48257647,Food,1,4
244403,49215,195188,20.1368232,79.8631768,Entertainment,0,0
197890,21514,176376,10.8716964,89.1283036,Entertainment,0,0
242705,32067,210638,13.21233596,86.78766404,Entertainment,0,0
95473,21577,73896,22.60010684,77.39989316,Transportation,4,4
95709,44344,51365,46.33211088,53.66788912,Transportation,4,4
19974,2361,17613,11.82036648,88.17963352,Housing,3,3
54715,15110,39605,27.61582747,72.38417253,Food,1,4
51645,3736,47909,7.234001355,92.76599864,Food,1,4
31965,718,31247,2.246206789,97.75379321,Food,1,1
176165,55484,120681,31.49547299,68.50452701,Healthcare,2,0
98611,21784,76827,22.09084179,77.90915821,Transportation,4,4
154397,54933,99464,35.57905918,64.42094082,Healthcare,2,0
31926,11576,20350,36.25884859,63.74115141,Food,1,1
57112,18139,38973,31.76040062,68.23959938,Food,1,4
216624,32319,184305,14.91939951,85.08060049,Entertainment,0,0
14449,5848,8601,40.47338916,59.52661084,Housing,3,3
101835,36763,65072,36.10055482,63.89944518,Transportation,4,2
13686,4903,8783,35.82493059,64.17506941,Housing,3,3
27815,15229,12586,54.75103361,45.24896639,Housing,3,1
193607,64605,129002,33.36914471,66.63085529,Entertainment,0,0
54537,31349,23188,57.48207639,42.51792361,Food,1,4
18515,9011,9504,48.66864704,51.33135296,Housing,3,3
87974,22874,65100,26.00086389,73.99913611,Transportation,4,4
192244,46319,145925,24.09385989,75.90614011,Entertainment,0,0
117960,22565,95395,19.12936589,80.87063411,Transportation,4,2
21799,11420,10379,52.38772421,47.61227579,Housing,3,3
74683,16607,58076,22.23665359,77.76334641,Transportation,4,4
234397,69280,165117,29.55669228,70.44330772,Entertainment,0,0
177359,65564,111795,36.96682999,63.03317001,Healthcare,2,0
57610,34281,23329,59.50529422,40.49470578,Food,1,1
25120,11998,13122,47.76273885,52.23726115,Housing,3,1
197400,16413,180987,8.314589666,91.68541033,Entertainment,0,0
110067,65177,44890,59.21575041,40.78424959,Transportation,4,4
95168,36589,58579,38.44674681,61.55325319,Transportation,4,4
229810,57220,172590,24.89882947,75.10117053,Entertainment,0,0
27060,12061,14999,44.57132299,55.42867701,Housing,3,1
236682,39454,197228,16.66962422,83.33037578,Entertainment,0,0
15329,7994,7335,52.14952052,47.85047948,Housing,3,3
26166,13029,13137,49.79362532,50.20637468,Housing,3,1
140915,39686,101229,28.16307703,71.83692297,Healthcare,2,2
92105,54553,37552,59.22914065,40.77085935,Transportation,4,4
64615,31184,33431,48.26123965,51.73876035,Transportation,4,4
173696,14663,159033,8.441760317,91.55823968,Healthcare,2,0
179648,62216,117432,34.63216958,65.36783042,Healthcare,2,0
29238,1444,27794,4.938778302,95.0612217,Housing,3,1
57326,20054,37272,34.98238147,65.01761853,Food,1,4
19134,3058,16076,15.98202153,84.01797847,Housing,3,3
25194,2406,22788,9.549892832,90.45010717,Housing,3,1
57957,10367,47590,17.88739928,82.11260072,Food,1,4
105680,5661,100019,5.35673732,94.64326268,Transportation,4,2
234823,53521,181302,22.7920604,77.2079396,Entertainment,0,0
28283,10272,18011,36.31863664,63.68136336,Housing,3,1
44470,24444,20026,54.96739375,45.03260625,Food,1,1
14305,7719,6586,53.96015379,46.03984621,Housing,3,3
58482,3084,55398,5.273417462,94.72658254,Food,1,4
162717,1417,161300,0.870837098,99.1291629,Healthcare,2,0
59022,25214,33808,42.71966385,57.28033615,Food,1,4
235154,39132,196022,16.64100972,83.35899028,Entertainment,0,0
95639,18628,77011,19.47740984,80.52259016,Transportation,4,4
76439,28282,48157,36.99943746,63.00056254,Transportation,4,4
83025,34054,48971,41.01656128,58.98343872,Transportation,4,4
28350,13358,14992,47.11816578,52.88183422,Housing,3,1
109182,18149,91033,16.62270338,83.37729662,Transportation,4,2
200128,52186,147942,26.07631116,73.92368884,Entertainment,0,0
30946,3401,27545,10.99011181,89.00988819,Food,1,1
186880,41169,145711,22.02964469,77.97035531,Entertainment,0,0
11524,3088,8436,26.7962513,73.2037487,Housing,3,3
202154,35358,166796,17.49062596,82.50937404,Entertainment,0,0
191862,54085,137777,28.18953206,71.81046794,Entertainment,0,0
127720,9556,118164,7.481991857,92.51800814,Healthcare,2,2
36108,5653,30455,15.65581035,84.34418965,Food,1,1
211092,65552,145540,31.05375855,68.94624145,Entertainment,0,0
16354,2219,14135,13.56854592,86.43145408,Housing,3,3
46991,8507,38484,18.10346662,81.89653338,Food,1,1
192059,6855,185204,3.56921571,96.43078429,Entertainment,0,0
166869,55181,111688,33.0684549,66.9315451,Healthcare,2,0
78631,7169,71462,9.11726927,90.88273073,Transportation,4,4
101416,6873,94543,6.777037154,93.22296285,Transportation,4,2
83671,38275,45396,45.74464271,54.25535729,Transportation,4,4
132247,54174,78073,40.96425628,59.03574372,Healthcare,2,2
117901,17900,100001,15.18222916,84.81777084,Transportation,4,2
73186,39158,34028,53.50476867,46.49523133,Transportation,4,4
32405,13473,18932,41.57691714,58.42308286,Food,1,1
160746,51118,109628,31.80048026,68.19951974,Healthcare,2,0
29612,15873,13739,53.60326895,46.39673105,Housing,3,1
22907,7451,15456,32.5271751,67.4728249,Housing,3,3
46873,11203,35670,23.9007531,76.0992469,Food,1,1
132202,43200,89002,32.67726661,67.32273339,Healthcare,2,2
206640,41558,165082,20.11130468,79.88869532,Entertainment,0,0
75491,2909,72582,3.853439483,96.14656052,Transportation,4,4
106097,34347,71750,32.37320565,67.62679435,Transportation,4,2
22149,5204,16945,23.4954174,76.5045826,Housing,3,3
221448,33151,188297,14.97010585,85.02989415,Entertainment,0,0
176138,2212,173926,1.255833494,98.74416651,Healthcare,2,0
17259,8165,9094,47.30865056,52.69134944,Housing,3,3
86090,6208,79882,7.211058195,92.78894181,Transportation,4,4
14231,1452,12779,10.20307779,89.79692221,Housing,3,3
204921,42626,162295,20.8011868,79.1988132,Entertainment,0,0
50168,17480,32688,34.84292776,65.15707224,Food,1,4
191717,6568,185149,3.425882942,96.57411706,Entertainment,0,0
15608,1669,13939,10.69323424,89.30676576,Housing,3,3
147408,42594,104814,28.89531097,71.10468903,Healthcare,2,2
236909,58084,178825,24.51743074,75.48256926,Entertainment,0,0
28764,15121,13643,52.5691837,47.4308163,Housing,3,1
38142,7441,30701,19.5086781,80.4913219,Food,1,1
126698,57882,68816,45.68501476,54.31498524,Healthcare,2,4
68897,16249,52648,23.58448118,76.41551882,Transportation,4,4
214281,8975,205306,4.188425479,95.81157452,Entertainment,0,0
45817,6326,39491,13.80710217,86.19289783,Food,1,1
156243,39329,116914,25.17168769,74.82831231,Healthcare,2,0
10968,6010,4958,54.79576951,45.20423049,Housing,3,3
68921,17029,51892,24.70799901,75.29200099,Transportation,4,4
65775,27323,38452,41.54009882,58.45990118,Transportation,4,4
46005,8481,37524,18.43495272,81.56504728,Food,1,1
16805,3796,13009,22.58851532,77.41148468,Housing,3,3
118755,42429,76326,35.72817987,64.27182013,Transportation,4,2
145433,66333,79100,45.61069358,54.38930642,Healthcare,2,2
71181,17044,54137,23.94459196,76.05540804,Transportation,4,4
80838,19749,61089,24.43034217,75.56965783,Transportation,4,4
53002,16913,36089,31.9101166,68.0898834,Food,1,4
40188,8495,31693,21.13815069,78.86184931,Food,1,1
28405,1958,26447,6.893152614,93.10684739,Housing,3,1
25801,12159,13642,47.12608038,52.87391962,Housing,3,1
94710,15323,79387,16.17886179,83.82113821,Transportation,4,4
213850,29381,184469,13.73906944,86.26093056,Entertainment,0,0
19049,1616,17433,8.483384955,91.51661505,Housing,3,3
153736,29968,123768,19.4931571,80.5068429,Healthcare,2,0
19634,10426,9208,53.10176225,46.89823775,Housing,3,3
105163,1065,104098,1.012713597,98.9872864,Transportation,4,2
114244,19721,94523,17.26217569,82.73782431,Transportation,4,2
225963,5167,220796,2.28665755,97.71334245,Entertainment,0,0
169584,64815,104769,38.21999717,61.78000283,Healthcare,2,0
113837,44022,69815,38.67108234,61.32891766,Transportation,4,4
242542,55699,186843,22.96468241,77.03531759,Entertainment,0,0
248425,1657,246768,0.667002113,99.33299789,Entertainment,0,0
222643,50097,172546,22.50104427,77.49895573,Entertainment,0,0
74239,12324,61915,16.60043912,83.39956088,Transportation,4,4
26070,4034,22036,15.47372459,84.52627541,Housing,3,1
19568,10845,8723,55.42211774,44.57788226,Housing,3,3
145272,40913,104359,28.16303211,71.83696789,Healthcare,2,2
46918,16568,30350,35.31267317,64.68732683,Food,1,1
186441,7123,179318,3.820511583,96.17948842,Entertainment,0,0
122807,58053,64754,47.27173532,52.72826468,Healthcare,2,4
26203,14206,11997,54.2151662,45.7848338,Housing,3,1
116806,31217,85589,26.72551068,73.27448932,Transportation,4,2
218894,69985,148909,31.97209608,68.02790392,Entertainment,0,0
81469,1151,80318,1.412807325,98.58719267,Transportation,4,4
35172,20754,14418,59.00716479,40.99283521,Food,1,1
157508,30104,127404,19.11267999,80.88732001,Healthcare,2,0
53574,5199,48375,9.704334192,90.29566581,Food,1,4
27070,15937,11133,58.87329147,41.12670853,Housing,3,1
153813,14024,139789,9.117564835,90.88243516,Healthcare,2,0
205512,61690,143822,30.01771186,69.98228814,Entertainment,0,0
32338,937,31401,2.897519946,97.10248005,Food,1,1
24920,12291,12629,49.32182986,50.67817014,Housing,3,3
73291,22554,50737,30.77321909,69.22678091,Transportation,4,4
51659,28115,23544,54.42420488,45.57579512,Food,1,4
91594,38575,53019,42.11520405,57.88479595,Transportation,4,4
219560,67158,152402,30.58753871,69.41246129,Entertainment,0,0
27426,14191,13235,51.74287173,48.25712827,Housing,3,1
56956,7480,49476,13.13294473,86.86705527,Food,1,4
51440,25873,25567,50.2974339,49.7025661,Food,1,4
18367,5270,13097,28.6927642,71.3072358,Housing,3,3
175926,18335,157591,10.42199561,89.57800439,Healthcare,2,0
52309,23385,28924,44.70550001,55.29449999,Food,1,4
220345,7588,212757,3.443690576,96.55630942,Entertainment,0,0
158695,56,158639,0.035287816,99.96471218,Healthcare,2,0
76600,9711,66889,12.67754569,87.32245431,Transportation,4,4
172998,16617,156381,9.605313356,90.39468664,Healthcare,2,0
134020,50997,83023,38.05178332,61.94821668,Healthcare,2,2
14441,2558,11883,17.71345475,82.28654525,Housing,3,3
137355,17218,120137,12.53540097,87.46459903,Healthcare,2,2
23726,5728,17998,24.14229116,75.85770884,Housing,3,3
41577,11456,30121,27.55369555,72.44630445,Food,1,1
132768,33674,99094,25.36303929,74.63696071,Healthcare,2,2
58744,7660,51084,13.03962958,86.96037042,Food,1,4
200035,22791,177244,11.39350614,88.60649386,Entertainment,0,0
232816,32628,200188,14.01450072,85.98549928,Entertainment,0,0
34621,8453,26168,24.41581699,75.58418301,Food,1,1
63869,17367,46502,27.1915953,72.8084047,Transportation,4,4
120234,54975,65259,45.72333949,54.27666051,Healthcare,2,4
211516,48500,163016,22.92970745,77.07029255,Entertainment,0,0
38631,17161,21470,44.42287282,55.57712718,Food,1,1
242632,12413,230219,5.115978107,94.88402189,Entertainment,0,0
187841,14066,173775,7.48824804,92.51175196,Entertainment,0,0
224085,57635,166450,25.72015084,74.27984916,Entertainment,0,0
97589,48715,48874,49.9185359,50.0814641,Transportation,4,4
26493,3445,23048,13.00343487,86.99656513,Housing,3,1
212713,40829,171884,19.19440749,80.80559251,Entertainment,0,0
81559,33578,47981,41.17019581,58.82980419,Transportation,4,4
72838,41212,31626,56.58035641,43.41964359,Transportation,4,4
59276,22147,37129,37.36250759,62.63749241,Food,1,4
28154,15517,12637,55.11472615,44.88527385,Housing,3,1
165327,48246,117081,29.18216625,70.81783375,Healthcare,2,0
85164,35253,49911,41.39425109,58.60574891,Transportation,4,4
65611,1053,64558,1.60491381,98.39508619,Transportation,4,4
33041,6022,27019,18.22584062,81.77415938,Food,1,1
58355,16736,41619,28.67963328,71.32036672,Food,1,4
49113,20346,28767,41.42691344,58.57308656,Food,1,1
172472,28350,144122,16.43745072,83.56254928,Healthcare,2,0
20327,6532,13795,32.1345993,67.8654007,Housing,3,3
206593,21975,184618,10.63685604,89.36314396,Entertainment,0,0
177428,24058,153370,13.55930293,86.44069707,Healthcare,2,0
93650,40977,52673,43.7554725,56.2445275,Transportation,4,4
139049,12031,127018,8.652345576,91.34765442,Healthcare,2,2
120888,67060,53828,55.47283436,44.52716564,Healthcare,2,4
16002,8673,7329,54.19947507,45.80052493,Housing,3,3
31095,18216,12879,58.58176556,41.41823444,Food,1,1
66629,35237,31392,52.88538024,47.11461976,Transportation,4,4
246903,62114,184789,25.15724799,74.84275201,Entertainment,0,0
31059,670,30389,2.157184713,97.84281529,Food,1,1
20586,11928,8658,57.94229088,42.05770912,Housing,3,3
38182,6205,31977,16.25111309,83.74888691,Food,1,1
100909,55832,45077,55.32905886,44.67094114,Transportation,4,4
65807,33571,32236,51.01432978,48.98567022,Transportation,4,4
72393,2377,70016,3.283466634,96.71653337,Transportation,4,4
206097,57897,148200,28.09211197,71.90788803,Entertainment,0,0
18113,2512,15601,13.86849224,86.13150776,Housing,3,3
27619,13125,14494,47.52163366,52.47836634,Housing,3,1
182625,46006,136619,25.19151266,74.80848734,Entertainment,0,0
191261,64473,126788,33.70943371,66.29056629,Entertainment,0,0
131775,3277,128498,2.486814646,97.51318535,Healthcare,2,2
231010,3263,227747,1.412492966,98.58750703,Entertainment,0,0
91504,4234,87270,4.627120126,95.37287987,Transportation,4,4
21697,5141,16556,23.69451998,76.30548002,Housing,3,3
185264,37290,147974,20.12803351,79.87196649,Entertainment,0,0
15155,3187,11968,21.02936325,78.97063675,Housing,3,3
200420,37339,163081,18.63037621,81.36962379,Entertainment,0,0
150245,49511,100734,32.95350927,67.04649073,Healthcare,2,0
208322,24922,183400,11.9632108,88.0367892,Entertainment,0,0
16092,3462,12630,21.51379567,78.48620433,Housing,3,3
197129,33179,163950,16.83111059,83.16888941,Entertainment,0,0
68873,6002,62871,8.714590623,91.28540938,Transportation,4,4
43594,12974,30620,29.76097628,70.23902372,Food,1,1
120162,29558,90604,24.59845875,75.40154125,Healthcare,2,2
205219,51220,153999,24.95870265,75.04129735,Entertainment,0,0
120649,10380,110269,8.603469569,91.39653043,Healthcare,2,2
50747,24968,25779,49.20093799,50.79906201,Food,1,4
159441,68140,91301,42.73681174,57.26318826,Healthcare,2,0
58050,428,57622,0.737295435,99.26270457,Food,1,4
225307,28718,196589,12.74616412,87.25383588,Entertainment,0,0
33353,6537,26816,19.59943633,80.40056367,Food,1,1
36093,3737,32356,10.35380822,89.64619178,Food,1,1
25567,11757,13810,45.98505886,54.01494114,Housing,3,1
50839,4103,46736,8.070575739,91.92942426,Food,1,4
100708,14658,86050,14.55495095,85.44504905,Transportation,4,2
237908,12291,225617,5.166282765,94.83371724,Entertainment,0,0
203740,40485,163255,19.87091391,80.12908609,Entertainment,0,0
64051,5486,58565,8.565049726,91.43495027,Transportation,4,4
172462,12485,159977,7.239275898,92.7607241,Healthcare,2,0
157009,36592,120417,23.30567038,76.69432962,Healthcare,2,0
206364,48182,158182,23.34806458,76.65193542,Entertainment,0,0
31458,17973,13485,57.13332062,42.86667938,Food,1,1
184602,22489,162113,12.18242489,87.81757511,Entertainment,0,0
137519,40038,97481,29.11452236,70.88547764,Healthcare,2,2
46320,18356,27964,39.62867012,60.37132988,Food,1,1
27992,16644,11348,59.45984567,40.54015433,Housing,3,1
18640,3207,15433,17.20493562,82.79506438,Housing,3,3
77301,11077,66224,14.32969819,85.67030181,Transportation,4,4
10779,4631,6148,42.96316913,57.03683087,Housing,3,3
28674,13582,15092,47.36695264,52.63304736,Housing,3,1
145861,27451,118410,18.81997244,81.18002756,Healthcare,2,2
225761,1781,223980,0.788887363,99.21111264,Entertainment,0,0
62289,16295,45994,26.16031723,73.83968277,Transportation,4,4
86476,7767,78709,8.981682779,91.01831722,Transportation,4,4
112301,2864,109437,2.550288956,97.44971104,Transportation,4,2
155962,36592,119370,23.46212539,76.53787461,Healthcare,2,0
197727,63028,134699,31.87627385,68.12372615,Entertainment,0,0
14971,6318,8653,42.20158974,57.79841026,Housing,3,3
158018,39760,118258,25.16169044,74.83830956,Healthcare,2,0
19061,2757,16304,14.46408898,85.53591102,Housing,3,3
209039,14287,194752,6.83460981,93.16539019,Entertainment,0,0
140795,32676,108119,23.20821052,76.79178948,Healthcare,2,2
41880,18793,23087,44.87344795,55.12655205,Food,1,1
90840,3966,86874,4.365918098,95.6340819,Transportation,4,4
60822,4265,56557,7.012265299,92.9877347,Transportation,4,4
45471,19208,26263,42.24230828,57.75769172,Food,1,1
83598,28087,55511,33.59769372,66.40230628,Transportation,4,4
48106,621,47485,1.290899264,98.70910074,Food,1,4
26630,14668,11962,55.08073601,44.91926399,Housing,3,1
80641,24683,55958,30.6084994,69.3915006,Transportation,4,4
192388,22447,169941,11.66756762,88.33243238,Entertainment,0,0
107943,61287,46656,56.77718796,43.22281204,Transportation,4,4
12920,5459,7461,42.25232198,57.74767802,Housing,3,3
121851,53153,68698,43.62130799,56.37869201,Healthcare,2,4
233760,25783,207977,11.02968857,88.97031143,Entertainment,0,0
86956,39361,47595,45.26542159,54.73457841,Transportation,4,4
242852,28691,214161,11.81419136,88.18580864,Entertainment,0,0
176618,64464,112154,36.49911108,63.50088892,Healthcare,2,0
17638,6566,11072,37.22644291,62.77355709,Housing,3,3
82853,42112,40741,50.82736895,49.17263105,Transportation,4,4
248306,64388,183918,25.93090783,74.06909217,Entertainment,0,0
104468,14328,90140,13.71520466,86.28479534,Transportation,4,2
229269,23447,205822,10.22685143,89.77314857,Entertainment,0,0
85504,2460,83044,2.877058383,97.12294162,Transportation,4,4
238872,14552,224320,6.091965572,93.90803443,Entertainment,0,0
158501,47282,111219,29.83072662,70.16927338,Healthcare,2,0
229518,32213,197305,14.03506479,85.96493521,Entertainment,0,0
196560,62759,133801,31.92867318,68.07132682,Entertainment,0,0
113245,66471,46774,58.6966312,41.3033688,Transportation,4,4
183524,58155,125369,31.68795362,68.31204638,Entertainment,0,0
23083,4262,18821,18.46380453,81.53619547,Housing,3,3
41882,16896,24986,40.34191299,59.65808701,Food,1,1
216053,9345,206708,4.325327582,95.67467242,Entertainment,0,0
180727,33049,147678,18.28669762,81.71330238,Entertainment,0,0
15700,8779,6921,55.91719745,44.08280255,Housing,3,3
185487,29902,155585,16.12080631,83.87919369,Entertainment,0,0
29329,15763,13566,53.74543967,46.25456033,Housing,3,1
165611,3222,162389,1.945522942,98.05447706,Healthcare,2,0
229737,38500,191237,16.75829318,83.24170682,Entertainment,0,0
41865,18913,22952,45.17616147,54.82383853,Food,1,1
23332,10355,12977,44.38110749,55.61889251,Housing,3,3
160780,27020,133760,16.80557283,83.19442717,Healthcare,2,0
196065,54207,141858,27.64746385,72.35253615,Entertainment,0,0
223361,42020,181341,18.81259486,81.18740514,Entertainment,0,0
48061,18984,29077,39.49980233,60.50019767,Food,1,1
68105,16263,51842,23.87930402,76.12069598,Transportation,4,4
123753,67639,56114,54.65645277,45.34354723,Healthcare,2,4
121705,22401,99304,18.40598168,81.59401832,Healthcare,2,2
25319,9047,16272,35.73205893,64.26794107,Housing,3,1
115082,58769,56313,51.06706522,48.93293478,Transportation,4,4
182444,24634,157810,13.50222534,86.49777466,Entertainment,0,0
184864,40758,144106,22.04755929,77.95244071,Entertainment,0,0
230298,15260,215038,6.626197362,93.37380264,Entertainment,0,0
10022,2858,7164,28.51726202,71.48273798,Housing,3,3
31876,14844,17032,46.56795081,53.43204919,Food,1,1
14788,7629,7159,51.58912632,48.41087368,Housing,3,3
51845,30982,20863,59.75889671,40.24110329,Food,1,1
12469,6452,6017,51.74432593,48.25567407,Housing,3,3
96696,12411,84285,12.83507074,87.16492926,Transportation,4,4
71747,8388,63359,11.69108116,88.30891884,Transportation,4,4
93850,49599,44251,52.84922749,47.15077251,Transportation,4,4
34718,13562,21156,39.0633101,60.9366899,Food,1,1
47085,27640,19445,58.70234682,41.29765318,Food,1,1
70341,8867,61474,12.60573492,87.39426508,Transportation,4,4
18116,3774,14342,20.83241334,79.16758666,Housing,3,3
236388,26386,210002,11.16215713,88.83784287,Entertainment,0,0
134972,66654,68318,49.38357585,50.61642415,Healthcare,2,4
108973,38591,70382,35.41335927,64.58664073,Transportation,4,2
233498,4618,228880,1.977747133,98.02225287,Entertainment,0,0
32561,17328,15233,53.21703879,46.78296121,Food,1,1
163287,29052,134235,17.79198589,82.20801411,Healthcare,2,0
201413,35646,165767,17.69796389,82.30203611,Entertainment,0,0
186660,2011,184649,1.077359906,98.92264009,Entertainment,0,0
189315,56436,132879,29.81063307,70.18936693,Entertainment,0,0
209598,63565,146033,30.32710236,69.67289764,Entertainment,0,0
19823,848,18975,4.277859053,95.72214095,Housing,3,3
59665,8587,51078,14.39202212,85.60797788,Food,1,4
51286,3179,48107,6.19857271,93.80142729,Food,1,4
101515,12375,89140,12.1903167,87.8096833,Transportation,4,2
55861,28107,27754,50.31596284,49.68403716,Food,1,4
17087,5182,11905,30.32714929,69.67285071,Housing,3,3
152640,35595,117045,23.31957547,76.68042453,Healthcare,2,0
16395,953,15442,5.812747789,94.18725221,Housing,3,3
63222,12799,50423,20.24453513,79.75546487,Transportation,4,4
65248,3404,61844,5.217018146,94.78298185,Transportation,4,4
20745,7771,12974,37.45962883,62.54037117,Housing,3,3
57581,9006,48575,15.64057588,84.35942412,Food,1,4
19504,11678,7826,59.87489746,40.12510254,Housing,3,3
141805,37762,104043,26.62952646,73.37047354,Healthcare,2,2
102479,8228,94251,8.028962031,91.97103797,Transportation,4,2
57570,9875,47695,17.15303109,82.84696891,Food,1,4
219425,60185,159240,27.42850632,72.57149368,Entertainment,0,0
76447,13247,63200,17.32834513,82.67165487,Transportation,4,4
47528,4654,42874,9.792122538,90.20787746,Food,1,4
39648,9832,29816,24.79822437,75.20177563,Food,1,1
196412,37204,159208,18.94181618,81.05818382,Entertainment,0,0
206799,59531,147268,28.78688969,71.21311031,Entertainment,0,0
200869,49098,151771,24.44279605,75.55720395,Entertainment,0,0
100490,33212,67278,33.05005473,66.94994527,Transportation,4,2
145934,1482,144452,1.015527567,98.98447243,Healthcare,2,2
115123,46062,69061,40.01111854,59.98888146,Transportation,4,4
39591,8249,31342,20.83554343,79.16445657,Food,1,1
133589,48376,85213,36.21256241,63.78743759,Healthcare,2,2
90158,40462,49696,44.87899022,55.12100978,Transportation,4,4
167085,43740,123345,26.17829249,73.82170751,Healthcare,2,0
86798,2591,84207,2.985091822,97.01490818,Transportation,4,4
65937,32177,33760,48.79961175,51.20038825,Transportation,4,4
174181,5199,168982,2.984826129,97.01517387,Healthcare,2,0
17205,1359,15846,7.898866609,92.10113339,Housing,3,3
170646,43792,126854,25.66248257,74.33751743,Healthcare,2,0
167305,68756,98549,41.09620155,58.90379845,Healthcare,2,0
61708,13383,48325,21.68762559,78.31237441,Transportation,4,4
21579,9754,11825,45.20135317,54.79864683,Housing,3,3
57876,31722,26154,54.81028406,45.18971594,Food,1,4
19956,1795,18161,8.994788535,91.00521147,Housing,3,3
214106,30639,183467,14.31020149,85.68979851,Entertainment,0,0
52240,6631,45609,12.69333844,87.30666156,Food,1,4
44199,26113,18086,59.08052218,40.91947782,Food,1,1
111601,62947,48654,56.40361646,43.59638354,Transportation,4,4
105387,50669,54718,48.07898507,51.92101493,Transportation,4,4
143620,59590,84030,41.49143573,58.50856427,Healthcare,2,2
190480,25517,164963,13.39615708,86.60384292,Entertainment,0,0
36972,2134,34838,5.771935519,94.22806448,Food,1,1
126514,3391,123123,2.680335773,97.31966423,Healthcare,2,2
152034,66834,85200,43.95990371,56.04009629,Healthcare,2,0
146819,48306,98513,32.90173615,67.09826385,Healthcare,2,2
202258,41610,160648,20.57273384,79.42726616,Entertainment,0,0
53493,6180,47313,11.55291347,88.44708653,Food,1,4
27660,6119,21541,22.12219812,77.87780188,Housing,3,1
129929,64922,65007,49.96728983,50.03271017,Healthcare,2,4
53756,10784,42972,20.06101644,79.93898356,Food,1,4
12877,5954,6923,46.23747767,53.76252233,Housing,3,3
237168,11715,225453,4.939536531,95.06046347,Entertainment,0,0
134161,39302,94859,29.29465344,70.70534656,Healthcare,2,2
182063,50003,132060,27.46466882,72.53533118,Entertainment,0,0
199620,63680,135940,31.90061116,68.09938884,Entertainment,0,0
227580,34662,192918,15.23068811,84.76931189,Entertainment,0,0
92454,36311,56143,39.27466632,60.72533368,Transportation,4,4
205173,47791,157382,23.29302589,76.70697411,Entertainment,0,0
56802,25029,31773,44.06358931,55.93641069,Food,1,4
123521,48951,74570,39.62969859,60.37030141,Healthcare,2,2
95167,17197,77970,18.07033951,81.92966049,Transportation,4,4
191449,61154,130295,31.94271059,68.05728941,Entertainment,0,0
45215,12097,33118,26.75439567,73.24560433,Food,1,1
85418,36339,49079,42.54255543,57.45744457,Transportation,4,4
190948,66312,124636,34.72777929,65.27222071,Entertainment,0,0
41670,912,40758,2.18862491,97.81137509,Food,1,4
150662,4377,146285,2.905178479,97.09482152,Healthcare,2,0
19063,2463,16600,12.92031684,87.07968316,Housing,3,3
246704,67019,179685,27.16575329,72.83424671,Entertainment,0,0
158281,26569,131712,16.78596926,83.21403074,Healthcare,2,0
190462,57758,132704,30.32520923,69.67479077,Entertainment,0,0
73021,2408,70613,3.297681489,96.70231851,Transportation,4,4
118564,53237,65327,44.9014878,55.0985122,Transportation,4,4
118771,45826,72945,38.5834926,61.4165074,Transportation,4,2
211119,68595,142524,32.49115428,67.50884572,Entertainment,0,0
70199,22208,47991,31.63577829,68.36422171,Transportation,4,4
156197,52631,103566,33.69526944,66.30473056,Healthcare,2,0
28634,5727,22907,20.00069847,79.99930153,Housing,3,1
44510,8067,36443,18.12401707,81.87598293,Food,1,1
82976,14474,68502,17.44359815,82.55640185,Transportation,4,4
52785,28536,24249,54.06081273,45.93918727,Food,1,4
17150,6842,10308,39.89504373,60.10495627,Housing,3,3
34927,19750,15177,56.54651129,43.45348871,Food,1,1
33174,18457,14717,55.6369446,44.3630554,Food,1,1
158367,13564,144803,8.564915671,91.43508433,Healthcare,2,0
122618,41571,81047,33.90285276,66.09714724,Healthcare,2,2
248209,23494,224715,9.465410199,90.5345898,Entertainment,0,0
130998,6913,124085,5.277179804,94.7228202,Healthcare,2,2
44671,6319,38352,14.14564259,85.85435741,Food,1,1
240424,31020,209404,12.9022061,87.0977939,Entertainment,0,0
76500,23608,52892,30.86013072,69.13986928,Transportation,4,4
148491,56911,91580,38.32622853,61.67377147,Healthcare,2,2
179788,55636,124152,30.94533562,69.05466438,Healthcare,2,0
71252,2609,68643,3.661651603,96.3383484,Transportation,4,4
44952,15149,29803,33.70039153,66.29960847,Food,1,1
156138,16934,139204,10.84553408,89.15446592,Healthcare,2,0
231355,1143,230212,0.494045947,99.50595405,Entertainment,0,0
211401,3163,208238,1.496208627,98.50379137,Entertainment,0,0
13178,1832,11346,13.90195781,86.09804219,Housing,3,3
97683,32429,65254,33.19820235,66.80179765,Transportation,4,4
92585,24233,68352,26.17378625,73.82621375,Transportation,4,4
82433,31727,50706,38.4882268,61.5117732,Transportation,4,4
112970,38073,74897,33.70186775,66.29813225,Transportation,4,2
119906,22480,97426,18.74801928,81.25198072,Transportation,4,2
221879,26159,195720,11.78975928,88.21024072,Entertainment,0,0
84879,26322,58557,31.01120418,68.98879582,Transportation,4,4
19250,8392,10858,43.59480519,56.40519481,Housing,3,3
154251,32454,121797,21.03973394,78.96026606,Healthcare,2,0
81649,36473,45176,44.67047974,55.32952026,Transportation,4,4
100691,60173,40518,59.760058,40.239942,Transportation,4,4
22613,5529,17084,24.4505373,75.5494627,Housing,3,3
59329,20209,39120,34.06260008,65.93739992,Food,1,4
112570,61346,51224,54.49586924,45.50413076,Transportation,4,4
103999,13043,90956,12.54146674,87.45853326,Transportation,4,2
17950,8447,9503,47.05849582,52.94150418,Housing,3,3
77048,44369,32679,57.58618004,42.41381996,Transportation,4,4
112366,46119,66247,41.0435541,58.9564459,Transportation,4,4
52752,31600,21152,59.90294207,40.09705793,Food,1,1
13495,959,12536,7.10633568,92.89366432,Housing,3,3
33441,4067,29374,12.16171765,87.83828235,Food,1,1
10468,3560,6908,34.00840657,65.99159343,Housing,3,3
65665,20943,44722,31.89370289,68.10629711,Transportation,4,4
139306,43272,96034,31.06255294,68.93744706,Healthcare,2,2
79653,33412,46241,41.94694487,58.05305513,Transportation,4,4
133505,46498,87007,34.8286581,65.1713419,Healthcare,2,2
10108,4840,5268,47.88286506,52.11713494,Housing,3,3
147391,61910,85481,42.00392154,57.99607846,Healthcare,2,2
37242,4278,32964,11.48703077,88.51296923,Food,1,1
22752,6999,15753,30.7621308,69.2378692,Housing,3,3
18034,8726,9308,48.38638128,51.61361872,Housing,3,3
61682,33846,27836,54.87176162,45.12823838,Transportation,4,4
62850,19752,43098,31.42720764,68.57279236,Transportation,4,4
49051,9775,39276,19.92823796,80.07176204,Food,1,1
26440,6899,19541,26.09304085,73.90695915,Housing,3,1
174791,31945,142846,18.27611261,81.72388739,Healthcare,2,0
59418,26323,33095,44.30139015,55.69860985,Food,1,4
184436,30360,154076,16.4609946,83.5390054,Entertainment,0,0
222820,23712,199108,10.64177363,89.35822637,Entertainment,0,0
170449,23055,147394,13.52604005,86.47395995,Healthcare,2,0
52835,2328,50507,4.406170152,95.59382985,Food,1,4
77243,45943,31300,59.4785288,40.5214712,Transportation,4,4
184131,39536,144595,21.47166963,78.52833037,Entertainment,0,0
55164,6384,48780,11.57276485,88.42723515,Food,1,4
98052,57804,40248,58.95239261,41.04760739,Transportation,4,4
13451,4566,8885,33.94543157,66.05456843,Housing,3,3
27547,1968,25579,7.144153628,92.85584637,Housing,3,1
39298,12664,26634,32.22555855,67.77444145,Food,1,1
85401,22996,62405,26.92708516,73.07291484,Transportation,4,4
59980,3253,56727,5.423474491,94.57652551,Food,1,4
18095,1737,16358,9.599336833,90.40066317,Housing,3,3
52583,6866,45717,13.05745203,86.94254797,Food,1,4
39378,12525,26853,31.80710041,68.19289959,Food,1,1
14119,7348,6771,52.04334585,47.95665415,Housing,3,3
60376,22580,37796,37.39896648,62.60103352,Transportation,4,4
146687,68495,78192,46.69466279,53.30533721,Healthcare,2,2
226073,26473,199600,11.7099344,88.2900656,Entertainment,0,0
24459,9848,14611,40.26329776,59.73670224,Housing,3,3
200605,1549,199056,0.772164203,99.2278358,Entertainment,0,0
124441,58717,65724,47.18460957,52.81539043,Healthcare,2,4
174745,45440,129305,26.00360525,73.99639475,Healthcare,2,0
29786,15095,14691,50.67817095,49.32182905,Housing,3,1
239641,67889,171752,28.32945948,71.67054052,Entertainment,0,0
57865,16719,41146,28.89311328,71.10688672,Food,1,4
78450,4916,73534,6.266411727,93.73358827,Transportation,4,4
117521,23856,93665,20.29935075,79.70064925,Transportation,4,2
12504,6715,5789,53.7028151,46.2971849,Housing,3,3
91785,21252,70533,23.15411015,76.84588985,Transportation,4,4
62550,15683,46867,25.07274181,74.92725819,Transportation,4,4
14001,7780,6221,55.56745947,44.43254053,Housing,3,3
153382,23859,129523,15.55528028,84.44471972,Healthcare,2,0
97899,51389,46510,52.49185385,47.50814615,Transportation,4,4
43207,12772,30435,29.560025,70.439975,Food,1,1
37650,7637,30013,20.28419655,79.71580345,Food,1,1
168012,26868,141144,15.99171488,84.00828512,Healthcare,2,0
212472,35327,177145,16.6266614,83.3733386,Entertainment,0,0
248920,69587,179333,27.95556805,72.04443195,Entertainment,0,0
96013,55800,40213,58.11712997,41.88287003,Transportation,4,4
187655,59081,128574,31.48384003,68.51615997,Entertainment,0,0
49564,2160,47404,4.358001775,95.64199822,Food,1,4
195443,6633,188810,3.39382838,96.60617162,Entertainment,0,0
31917,9720,22197,30.45399004,69.54600996,Food,1,1
23118,6137,16981,26.54641405,73.45358595,Housing,3,3
34006,7215,26791,21.21684409,78.78315591,Food,1,1
181830,26769,155061,14.72199307,85.27800693,Entertainment,0,0
245571,53895,191676,21.94680968,78.05319032,Entertainment,0,0
153057,28041,125016,18.32062565,81.67937435,Healthcare,2,0
82095,4836,77259,5.890736342,94.10926366,Transportation,4,4
191865,39099,152766,20.37839106,79.62160894,Entertainment,0,0
98090,39735,58355,40.50871648,59.49128352,Transportation,4,4
231323,55739,175584,24.09574491,75.90425509,Entertainment,0,0
37404,8071,29333,21.57790611,78.42209389,Food,1,1
14647,810,13837,5.530142691,94.46985731,Housing,3,3
25962,9548,16414,36.77682767,63.22317233,Housing,3,1
66014,20656,45358,31.29033235,68.70966765,Transportation,4,4
19342,2191,17151,11.32768069,88.67231931,Housing,3,3
59712,5962,53750,9.984592712,90.01540729,Food,1,4
211326,24252,187074,11.476108,88.523892,Entertainment,0,0
191403,63603,127800,33.22988668,66.77011332,Entertainment,0,0
17120,8980,8140,52.45327103,47.54672897,Housing,3,3
20208,7097,13111,35.11975455,64.88024545,Housing,3,3
100766,12736,88030,12.63918385,87.36081615,Transportation,4,2
160551,32381,128170,20.16866915,79.83133085,Healthcare,2,0
234310,54104,180206,23.09077718,76.90922282,Entertainment,0,0
57794,30345,27449,52.50545039,47.49454961,Food,1,4
53537,11747,41790,21.94183462,78.05816538,Food,1,4
47252,16582,30670,35.09269449,64.90730551,Food,1,1
236313,15130,221183,6.402525464,93.59747454,Entertainment,0,0
209185,25308,183877,12.09838182,87.90161818,Entertainment,0,0
31565,14689,16876,46.53571994,53.46428006,Food,1,1
22568,8327,14241,36.89737682,63.10262318,Housing,3,3
45456,16284,29172,35.82365364,64.17634636,Food,1,1
199673,64424,135249,32.26475287,67.73524713,Entertainment,0,0
22697,12718,9979,56.03383707,43.96616293,Housing,3,3
224724,44606,180118,19.84923729,80.15076271,Entertainment,0,0
17483,7836,9647,44.82068295,55.17931705,Housing,3,3
15201,8432,6769,55.47003487,44.52996513,Housing,3,3
62526,4647,57879,7.432108243,92.56789176,Transportation,4,4
102212,2114,100098,2.068250303,97.9317497,Transportation,4,2
195835,55163,140672,28.1681007,71.8318993,Entertainment,0,0
247773,7710,240063,3.111719195,96.88828081,Entertainment,0,0
11930,6233,5697,52.24643755,47.75356245,Housing,3,3
162492,68692,93800,42.27408119,57.72591881,Healthcare,2,0
31384,2420,28964,7.710935509,92.28906449,Food,1,1
195709,35267,160442,18.02012171,81.97987829,Entertainment,0,0
53647,16903,36744,31.50781964,68.49218036,Food,1,4
193880,43214,150666,22.28904477,77.71095523,Entertainment,0,0
57912,9934,47978,17.15361238,82.84638762,Food,1,4
29642,9800,19842,33.06119695,66.93880305,Housing,3,1
14015,1497,12518,10.68141277,89.31858723,Housing,3,3
13693,2842,10851,20.75513036,79.24486964,Housing,3,3
211624,50902,160722,24.05303746,75.94696254,Entertainment,0,0
123336,8464,114872,6.862554323,93.13744568,Healthcare,2,2
42059,12660,29399,30.100573,69.899427,Food,1,1
104202,61789,42413,59.29732635,40.70267365,Transportation,4,4
14488,7940,6548,54.8039757,45.1960243,Housing,3,3
68479,38441,30038,56.13545759,43.86454241,Transportation,4,4
31548,18605,12943,58.97362749,41.02637251,Food,1,1
21565,3505,18060,16.25318804,83.74681196,Housing,3,3
61635,13254,48381,21.50401558,78.49598442,Transportation,4,4
60059,35108,24951,58.45585175,41.54414825,Transportation,4,4
66622,39069,27553,58.64279067,41.35720933,Transportation,4,4
29228,14791,14437,50.60558369,49.39441631,Housing,3,1
37995,6754,31241,17.77602316,82.22397684,Food,1,1
123677,47480,76197,38.39032318,61.60967682,Healthcare,2,2
125812,24712,101100,19.64200553,80.35799447,Healthcare,2,2
36383,15543,20840,42.72050133,57.27949867,Food,1,1
140510,17887,122623,12.7300548,87.2699452,Healthcare,2,2
97500,4510,92990,4.625641026,95.37435897,Transportation,4,4
12293,1784,10509,14.51232409,85.48767591,Housing,3,3
195523,53496,142027,27.36046399,72.63953601,Entertainment,0,0
15109,2994,12115,19.81600371,80.18399629,Housing,3,3
144515,45566,98949,31.53029097,68.46970903,Healthcare,2,2
165584,20547,145037,12.40880761,87.59119239,Healthcare,2,0
95731,18299,77432,19.11502021,80.88497979,Transportation,4,4
245539,22177,223362,9.031966409,90.96803359,Entertainment,0,0
75289,6830,68459,9.071710343,90.92828966,Transportation,4,4
184818,168,184650,0.090900237,99.90909976,Entertainment,0,0
131172,58653,72519,44.71457323,55.28542677,Healthcare,2,2
108490,64829,43661,59.75573786,40.24426214,Transportation,4,4
25129,8880,16249,35.33765769,64.66234231,Housing,3,1
18473,687,17786,3.718941157,96.28105884,Housing,3,3
113260,30153,83107,26.62281476,73.37718524,Transportation,4,2
81014,9625,71389,11.8806626,88.1193374,Transportation,4,4
11524,93,11431,0.807011454,99.19298855,Housing,3,3
170647,33053,137594,19.36922419,80.63077581,Healthcare,2,0
174045,22648,151397,13.01272659,86.98727341,Healthcare,2,0
40739,5549,35190,13.62085471,86.37914529,Food,1,1
21862,3853,18009,17.62418809,82.37581191,Housing,3,3
110354,1630,108724,1.477064719,98.52293528,Transportation,4,2
188419,9388,179031,4.982512379,95.01748762,Entertainment,0,0
161339,61940,99399,38.39121353,61.60878647,Healthcare,2,0
122070,18058,104012,14.79315147,85.20684853,Healthcare,2,2
12278,6188,6090,50.3990878,49.6009122,Housing,3,3
39990,12110,27880,30.28257064,69.71742936,Food,1,1
14216,6355,7861,44.70315138,55.29684862,Housing,3,3
186514,51089,135425,27.39150948,72.60849052,Entertainment,0,0
29545,17410,12135,58.92706042,41.07293958,Housing,3,1
26994,12979,14015,48.08105505,51.91894495,Housing,3,1
199553,4444,195109,2.226977294,97.77302271,Entertainment,0,0
19199,7239,11960,37.70508881,62.29491119,Housing,3,3
139675,40777,98898,29.19420082,70.80579918,Healthcare,2,2
28456,15323,13133,53.84804611,46.15195389,Housing,3,1
68201,2546,65655,3.733083093,96.26691691,Transportation,4,4
229484,39916,189568,17.39380523,82.60619477,Entertainment,0,0
58885,1398,57487,2.374119046,97.62588095,Food,1,4
132220,20958,111262,15.85085464,84.14914536,Healthcare,2,2
189607,41046,148561,21.64793494,78.35206506,Entertainment,0,0
132654,62628,70026,47.21154281,52.78845719,Healthcare,2,4
222860,26143,196717,11.73068294,88.26931706,Entertainment,0,0
59495,16312,43183,27.41743004,72.58256996,Food,1,4
88807,23324,65483,26.26369543,73.73630457,Transportation,4,4
140349,30320,110029,21.60328894,78.39671106,Healthcare,2,2
202378,30958,171420,15.29711728,84.70288272,Entertainment,0,0
128107,24584,103523,19.19020819,80.80979181,Healthcare,2,2
192179,61461,130718,31.98112177,68.01887823,Entertainment,0,0
37519,9996,27523,26.64250113,73.35749887,Food,1,1
133365,55276,78089,41.4471563,58.5528437,Healthcare,2,2
191799,65092,126707,33.93761177,66.06238823,Entertainment,0,0
30895,108,30787,0.349571128,99.65042887,Food,1,1
34625,14830,19795,42.83032491,57.16967509,Food,1,1
17543,4992,12551,28.45579433,71.54420567,Housing,3,3
75977,5362,70615,7.05739895,92.94260105,Transportation,4,4
40972,4908,36064,11.97891243,88.02108757,Food,1,1
116715,69130,47585,59.22974768,40.77025232,Transportation,4,4
20202,11847,8355,58.64270864,41.35729136,Housing,3,3
204893,31993,172900,15.61449147,84.38550853,Entertainment,0,0
135612,69524,66088,51.26684954,48.73315046,Healthcare,2,4
48829,28084,20745,57.51500133,42.48499867,Food,1,1
36145,3840,32305,10.62387605,89.37612395,Food,1,1
53020,24717,28303,46.61825726,53.38174274,Food,1,4
127416,33572,93844,26.3483393,73.6516607,Healthcare,2,2
78108,32852,45256,42.05971219,57.94028781,Transportation,4,4
222978,9549,213429,4.282485268,95.71751473,Entertainment,0,0
213176,45015,168161,21.11635456,78.88364544,Entertainment,0,0
161067,47623,113444,29.56719874,70.43280126,Healthcare,2,0
138471,675,137796,0.48746669,99.51253331,Healthcare,2,2
136378,29647,106731,21.73884351,78.26115649,Healthcare,2,2
204481,60165,144316,29.4232716,70.5767284,Entertainment,0,0
221796,18085,203711,8.153889159,91.84611084,Entertainment,0,0
78574,33235,45339,42.29770662,57.70229338,Transportation,4,4
113968,38954,75014,34.17976976,65.82023024,Transportation,4,2
53459,1685,51774,3.151948222,96.84805178,Food,1,4
161955,30969,130986,19.12197833,80.87802167,Healthcare,2,0
57042,15413,41629,27.02044108,72.97955892,Food,1,4
61823,21601,40222,34.94007085,65.05992915,Transportation,4,4
195232,47157,148075,24.15433945,75.84566055,Entertainment,0,0
30587,6962,23625,22.76130382,77.23869618,Food,1,1
142370,43542,98828,30.58369038,69.41630962,Healthcare,2,2
73730,22719,51011,30.81378001,69.18621999,Transportation,4,4
136075,36969,99106,27.16810582,72.83189418,Healthcare,2,2
75566,37279,38287,49.33303337,50.66696663,Transportation,4,4
95327,14653,80674,15.37130089,84.62869911,Transportation,4,4
97395,40914,56481,42.00831665,57.99168335,Transportation,4,4
41779,24749,17030,59.23789464,40.76210536,Food,1,1
112556,41559,70997,36.92295391,63.07704609,Transportation,4,2
17947,7322,10625,40.79790494,59.20209506,Housing,3,3
45095,3054,42041,6.772369442,93.22763056,Food,1,4
19789,3109,16680,15.7107484,84.2892516,Housing,3,3
95126,28357,66769,29.8099363,70.1900637,Transportation,4,4
236367,728,235639,0.307995617,99.69200438,Entertainment,0,0
191810,60269,131541,31.42119806,68.57880194,Entertainment,0,0
241230,60757,180473,25.18633669,74.81366331,Entertainment,0,0
104587,34534,70053,33.01940012,66.98059988,Transportation,4,2
62849,20858,41991,33.18748111,66.81251889,Transportation,4,4
200232,15638,184594,7.809940469,92.19005953,Entertainment,0,0
23465,9512,13953,40.53696996,59.46303004,Housing,3,3
116811,48446,68365,41.4738338,58.5261662,Transportation,4,4
44644,16335,28309,36.58946331,63.41053669,Food,1,1
115389,65428,49961,56.70211199,43.29788801,Transportation,4,4
200688,44550,156138,22.19863669,77.80136331,Entertainment,0,0
31953,13976,17977,43.73924201,56.26075799,Food,1,1
157097,20080,137017,12.78191181,87.21808819,Healthcare,2,0
96053,12236,83817,12.73880045,87.26119955,Transportation,4,4
50829,30457,20372,59.92051781,40.07948219,Food,1,1
138102,44249,93853,32.04081042,67.95918958,Healthcare,2,2
147595,8206,139389,5.559808937,94.44019106,Healthcare,2,2
30833,1085,29748,3.518956962,96.48104304,Food,1,1
229704,35444,194260,15.4302929,84.5697071,Entertainment,0,0
57551,30343,27208,52.72367118,47.27632882,Food,1,4
10526,5011,5515,47.60592818,52.39407182,Housing,3,3
98380,50830,47550,51.66700549,48.33299451,Transportation,4,4
39743,5341,34402,13.43884458,86.56115542,Food,1,1
218320,14600,203720,6.687431294,93.31256871,Entertainment,0,0
216649,5144,211505,2.374347447,97.62565255,Entertainment,0,0
59323,17178,42145,28.95672842,71.04327158,Food,1,4
172742,29055,143687,16.81988167,83.18011833,Healthcare,2,0
50805,26300,24505,51.76655841,48.23344159,Food,1,4
125337,58817,66520,46.92708458,53.07291542,Healthcare,2,4
110112,26124,83988,23.72493461,76.27506539,Transportation,4,2
249305,59228,190077,23.75724514,76.24275486,Entertainment,0,0
14630,5514,9116,37.68967874,62.31032126,Housing,3,3
210884,59266,151618,28.10360198,71.89639802,Entertainment,0,0
33060,15168,17892,45.88021779,54.11978221,Food,1,1
153536,51140,102396,33.30814923,66.69185077,Healthcare,2,0
13337,3743,9594,28.06478218,71.93521782,Housing,3,3
117517,39919,77598,33.9687024,66.0312976,Transportation,4,2
29958,15890,14068,53.04092396,46.95907604,Housing,3,1
40302,13767,26535,34.15959506,65.84040494,Food,1,1
45193,26035,19158,57.60847919,42.39152081,Food,1,1
181982,18548,163434,10.19221681,89.80778319,Entertainment,0,0
12951,161,12790,1.243147247,98.75685275,Housing,3,3
140010,47683,92327,34.05685308,65.94314692,Healthcare,2,2
29849,11909,17940,39.897484,60.102516,Housing,3,1
20486,4956,15530,24.19213121,75.80786879,Housing,3,3
118049,7574,110475,6.415979805,93.5840202,Transportation,4,2
225310,17801,207509,7.900670188,92.09932981,Entertainment,0,0
33646,2276,31370,6.764548535,93.23545147,Food,1,1
66802,11800,55002,17.66414179,82.33585821,Transportation,4,4
18450,8335,10115,45.17615176,54.82384824,Housing,3,3
45770,8815,36955,19.25934018,80.74065982,Food,1,1
96998,29287,67711,30.19340605,69.80659395,Transportation,4,4
126990,60371,66619,47.53996378,52.46003622,Healthcare,2,4
26202,8274,17928,31.57774216,68.42225784,Housing,3,1
46975,14912,32063,31.74454497,68.25545503,Food,1,1
40731,12080,28651,29.65800005,70.34199995,Food,1,1
110345,12938,97407,11.72504418,88.27495582,Transportation,4,2
55174,5700,49474,10.33095299,89.66904701,Food,1,4
114106,16981,97125,14.88177659,85.11822341,Transportation,4,2
116372,29546,86826,25.3892689,74.6107311,Transportation,4,2
90908,37919,52989,41.71140054,58.28859946,Transportation,4,4
97953,56685,41268,57.86959052,42.13040948,Transportation,4,4
48905,9860,39045,20.16153768,79.83846232,Food,1,1
142164,20662,121502,14.53391857,85.46608143,Healthcare,2,2
135010,3568,131442,2.642767202,97.3572328,Healthcare,2,2
17638,1136,16502,6.440639528,93.55936047,Housing,3,3
52039,7593,44446,14.59097984,85.40902016,Food,1,4
19821,9658,10163,48.72609858,51.27390142,Housing,3,3
40946,20132,20814,49.16719582,50.83280418,Food,1,1
15403,8897,6506,57.76147504,42.23852496,Housing,3,3
26680,6638,20042,24.88005997,75.11994003,Housing,3,1
238152,4096,234056,1.719909973,98.28009003,Entertainment,0,0
161097,21266,139831,13.20074241,86.79925759,Healthcare,2,0
117356,24863,92493,21.18596408,78.81403592,Transportation,4,2
69477,29356,40121,42.25283187,57.74716813,Transportation,4,4
113202,34659,78543,30.61695023,69.38304977,Transportation,4,2
176432,42572,133860,24.12940963,75.87059037,Healthcare,2,0
21911,7007,14904,31.97937109,68.02062891,Housing,3,3
19351,8486,10865,43.85303085,56.14696915,Housing,3,3
141960,52128,89832,36.72020287,63.27979713,Healthcare,2,2
239472,13999,225473,5.845777377,94.15422262,Entertainment,0,0
32240,17806,14434,55.22952854,44.77047146,Food,1,1
15736,8913,6823,56.64082359,43.35917641,Housing,3,3
29283,13793,15490,47.10241437,52.89758563,Housing,3,1
107783,41846,65937,38.82430439,61.17569561,Transportation,4,4
173024,5313,167711,3.070672277,96.92932772,Healthcare,2,0
140257,21852,118405,15.57997105,84.42002895,Healthcare,2,2
20536,2404,18132,11.70627191,88.29372809,Housing,3,3
47955,75,47880,0.156396622,99.84360338,Food,1,4
59625,29292,30333,49.12704403,50.87295597,Food,1,4
12391,5726,6665,46.21095957,53.78904043,Housing,3,3
47132,22877,24255,48.53814818,51.46185182,Food,1,1
91958,45909,46049,49.92387829,50.07612171,Transportation,4,4
241766,18288,223478,7.564339072,92.43566093,Entertainment,0,0
12709,348,12361,2.738217012,97.26178299,Housing,3,3
11005,1485,9520,13.49386642,86.50613358,Housing,3,3
27771,6942,20829,24.99729934,75.00270066,Housing,3,1
40619,11215,29404,27.61023166,72.38976834,Food,1,1
112511,25665,86846,22.81110291,77.18889709,Transportation,4,2
246781,55636,191145,22.54468537,77.45531463,Entertainment,0,0
217226,17749,199477,8.170753041,91.82924696,Entertainment,0,0
73792,42903,30889,58.14044883,41.85955117,Transportation,4,4
23608,6443,17165,27.29159607,72.70840393,Housing,3,3
28378,5118,23260,18.03509761,81.96490239,Housing,3,1
32323,8632,23691,26.70544195,73.29455805,Food,1,1
147724,20520,127204,13.89076927,86.10923073,Healthcare,2,2
240937,18206,222731,7.556332153,92.44366785,Entertainment,0,0
86694,49759,36935,57.39612891,42.60387109,Transportation,4,4
96901,37607,59294,38.80971301,61.19028699,Transportation,4,4
231218,11531,219687,4.987068481,95.01293152,Entertainment,0,0
15106,1487,13619,9.843770687,90.15622931,Housing,3,3
30681,14333,16348,46.71620873,53.28379127,Food,1,1
202639,10800,191839,5.329674939,94.67032506,Entertainment,0,0
16944,5705,11239,33.6697356,66.3302644,Housing,3,3
14128,6733,7395,47.65713477,52.34286523,Housing,3,3
58500,30462,28038,52.07179487,47.92820513,Food,1,4
50913,18049,32864,35.45067075,64.54932925,Food,1,4
120959,30526,90433,25.23665044,74.76334956,Healthcare,2,2
57057,2582,54475,4.525299262,95.47470074,Food,1,4
23984,8252,15732,34.40627085,65.59372915,Housing,3,3
15073,2080,12993,13.79950906,86.20049094,Housing,3,3
155890,17335,138555,11.12002053,88.87997947,Healthcare,2,0
13217,342,12875,2.587576606,97.41242339,Housing,3,3
109565,60658,48907,55.36257016,44.63742984,Transportation,4,4
19937,6472,13465,32.46225611,67.53774389,Housing,3,3
157938,30074,127864,19.04164925,80.95835075,Healthcare,2,0
202599,62338,140261,30.76915483,69.23084517,Entertainment,0,0
24034,7913,16121,32.92419073,67.07580927,Housing,3,3
132981,62908,70073,47.30600612,52.69399388,Healthcare,2,4
10078,223,9855,2.212740623,97.78725938,Housing,3,3
30503,4736,25767,15.52634167,84.47365833,Food,1,1
129032,29051,99981,22.51457003,77.48542997,Healthcare,2,2
34682,18498,16184,53.33602445,46.66397555,Food,1,1
84478,21707,62771,25.69544734,74.30455266,Transportation,4,4
157325,42413,114912,26.95884316,73.04115684,Healthcare,2,0
16260,6560,9700,40.34440344,59.65559656,Housing,3,3
22287,6970,15317,31.27383677,68.72616323,Housing,3,3
48963,28812,20151,58.84443355,41.15556645,Food,1,1
17409,7315,10094,42.01849618,57.98150382,Housing,3,3
89105,3825,85280,4.292688401,95.7073116,Transportation,4,4
201613,9708,191905,4.815165689,95.18483431,Entertainment,0,0
81669,36229,45440,44.36077337,55.63922663,Transportation,4,4
235729,7291,228438,3.09295844,96.90704156,Entertainment,0,0
44206,25359,18847,57.36551599,42.63448401,Food,1,1
56015,15297,40718,27.30875658,72.69124342,Food,1,4
244618,4198,240420,1.716145173,98.28385483,Entertainment,0,0
206517,56623,149894,27.4180818,72.5819182,Entertainment,0,0
204941,64479,140462,31.46222571,68.53777429,Entertainment,0,0
176202,11097,165105,6.297885382,93.70211462,Healthcare,2,0
59609,22081,37528,37.04306397,62.95693603,Food,1,4
102219,38708,63511,37.8677154,62.1322846,Transportation,4,2
46981,19041,27940,40.52915008,59.47084992,Food,1,1
38625,531,38094,1.374757282,98.62524272,Food,1,1
143363,18045,125318,12.58692968,87.41307032,Healthcare,2,2
32686,13672,19014,41.8283057,58.1716943,Food,1,1
212175,36460,175715,17.18392836,82.81607164,Entertainment,0,0
119920,2772,117148,2.311541027,97.68845897,Transportation,4,2
36821,15131,21690,41.09339779,58.90660221,Food,1,1
162940,16912,146028,10.37928072,89.62071928,Healthcare,2,0
46791,4044,42747,8.642687696,91.3573123,Food,1,4
95801,36612,59189,38.21672008,61.78327992,Transportation,4,4
14269,7960,6309,55.78526876,44.21473124,Housing,3,3
122770,46238,76532,37.66229535,62.33770465,Healthcare,2,2
127582,11077,116505,8.682259253,91.31774075,Healthcare,2,2
246896,9804,237092,3.970902728,96.02909727,Entertainment,0,0
238837,57562,181275,24.10095588,75.89904412,Entertainment,0,0
80296,46431,33865,57.82479825,42.17520175,Transportation,4,4
74492,39401,35091,52.8929281,47.1070719,Transportation,4,4
133906,9947,123959,7.428345257,92.57165474,Healthcare,2,2
29071,17326,11745,59.59891301,40.40108699,Housing,3,1
173153,57384,115769,33.14063285,66.85936715,Healthcare,2,0
117132,1840,115292,1.570877301,98.4291227,Transportation,4,2
19743,6262,13481,31.71757078,68.28242922,Housing,3,3
202512,64462,138050,31.83120013,68.16879987,Entertainment,0,0
26838,1891,24947,7.045979581,92.95402042,Housing,3,1
66591,2180,64411,3.273715667,96.72628433,Transportation,4,4
158563,28711,129852,18.10699848,81.89300152,Healthcare,2,0
31159,4462,26697,14.32010013,85.67989987,Food,1,1
112045,12112,99933,10.80994243,89.19005757,Transportation,4,2
77754,16086,61668,20.68832472,79.31167528,Transportation,4,4
79487,45657,33830,57.43958132,42.56041868,Transportation,4,4
53525,16456,37069,30.74451191,69.25548809,Food,1,4
233455,41293,192162,17.68777709,82.31222291,Entertainment,0,0
51095,6823,44272,13.3535571,86.6464429,Food,1,4
37135,3865,33270,10.40797092,89.59202908,Food,1,1
89174,21522,67652,24.13483751,75.86516249,Transportation,4,4
110914,29231,81683,26.35465315,73.64534685,Transportation,4,2
121236,64036,57200,52.8192946,47.1807054,Healthcare,2,4
14389,6001,8388,41.70546946,58.29453054,Housing,3,3
18626,9839,8787,52.82400945,47.17599055,Housing,3,3
216091,12552,203539,5.808663943,94.19133606,Entertainment,0,0
228970,52028,176942,22.72262742,77.27737258,Entertainment,0,0
238149,7082,231067,2.973768523,97.02623148,Entertainment,0,0
39588,18575,21013,46.92078408,53.07921592,Food,1,1
113387,45531,67856,40.155397,59.844603,Transportation,4,4
123751,5280,118471,4.266632189,95.73336781,Healthcare,2,2
221753,45242,176511,20.40197878,79.59802122,Entertainment,0,0
169487,34465,135022,20.33489294,79.66510706,Healthcare,2,0
25898,7838,18060,30.26488532,69.73511468,Housing,3,1
13572,5137,8435,37.84998526,62.15001474,Housing,3,3
55834,26653,29181,47.73614643,52.26385357,Food,1,4
19648,9447,10201,48.08122964,51.91877036,Housing,3,3
116881,36605,80276,31.31817832,68.68182168,Transportation,4,2
156453,43075,113378,27.53223013,72.46776987,Healthcare,2,0
20791,2623,18168,12.61603578,87.38396422,Housing,3,3
29623,9564,20059,32.28572393,67.71427607,Housing,3,1
44157,5193,38964,11.7603098,88.2396902,Food,1,1
30400,5853,24547,19.25328947,80.74671053,Food,1,1
35211,18370,16841,52.1711965,47.8288035,Food,1,1
197114,8846,188268,4.487758353,95.51224165,Entertainment,0,0
169775,43312,126463,25.51141216,74.48858784,Healthcare,2,0
163874,54849,109025,33.47022713,66.52977287,Healthcare,2,0
226551,37520,189031,16.56139236,83.43860764,Entertainment,0,0
155133,19803,135330,12.76517569,87.23482431,Healthcare,2,0
191832,2179,189653,1.135889737,98.86411026,Entertainment,0,0
13342,259,13083,1.941238195,98.0587618,Housing,3,3
223584,37374,186210,16.71586518,83.28413482,Entertainment,0,0
50016,8240,41776,16.47472809,83.52527191,Food,1,4
52814,24009,28805,45.45953724,54.54046276,Food,1,4
127819,42699,85120,33.40583168,66.59416832,Healthcare,2,2
231537,7182,224355,3.101880045,96.89811995,Entertainment,0,0
36758,21534,15224,58.58316557,41.41683443,Food,1,1
75593,30283,45310,40.06058762,59.93941238,Transportation,4,4
11282,2871,8411,25.44761567,74.55238433,Housing,3,3
40941,16287,24654,39.78163699,60.21836301,Food,1,1
37623,19466,18157,51.73962736,48.26037264,Food,1,1
76092,23111,52981,30.37244388,69.62755612,Transportation,4,4
199614,67661,131953,33.89591912,66.10408088,Entertainment,0,0
15477,7819,7658,50.52012664,49.47987336,Housing,3,3
244952,21911,223041,8.945017799,91.0549822,Entertainment,0,0
19473,4983,14490,25.58927746,74.41072254,Housing,3,3
36021,9201,26820,25.543433,74.456567,Food,1,1
17908,7454,10454,41.62385526,58.37614474,Housing,3,3
103938,26197,77741,25.20444881,74.79555119,Transportation,4,2
146267,44474,101793,30.40603827,69.59396173,Healthcare,2,2
13823,1666,12157,12.05237647,87.94762353,Housing,3,3
135450,4406,131044,3.252860834,96.74713917,Healthcare,2,2
65290,26408,38882,40.44723541,59.55276459,Transportation,4,4
28046,6888,21158,24.559652,75.440348,Housing,3,1
144999,8070,136929,5.565555625,94.43444438,Healthcare,2,2
230397,60202,170195,26.12968051,73.87031949,Entertainment,0,0
120899,28640,92259,23.68919511,76.31080489,Healthcare,2,2
192592,68957,123635,35.80470632,64.19529368,Entertainment,0,0
216694,7629,209065,3.520632782,96.47936722,Entertainment,0,0
12557,5616,6941,44.72405829,55.27594171,Housing,3,3
159626,22786,136840,14.27461692,85.72538308,Healthcare,2,0
178890,10230,168660,5.718598021,94.28140198,Healthcare,2,0
219932,53125,166807,24.15519342,75.84480658,Entertainment,0,0
17595,6957,10638,39.53964194,60.46035806,Housing,3,3
13199,3052,10147,23.12296386,76.87703614,Housing,3,3
120527,66982,53545,55.57426967,44.42573033,Healthcare,2,4
188727,53970,134757,28.59686213,71.40313787,Entertainment,0,0
85142,5813,79329,6.827417726,93.17258227,Transportation,4,4
157388,69123,88265,43.91885023,56.08114977,Healthcare,2,0
43039,17770,25269,41.28813402,58.71186598,Food,1,1
152996,27203,125793,17.7802034,82.2197966,Healthcare,2,0
53059,14085,38974,26.54592058,73.45407942,Food,1,4
72314,41384,30930,57.22819924,42.77180076,Transportation,4,4
55594,33043,22551,59.4362701,40.5637299,Food,1,1
179440,6363,173077,3.5460321,96.4539679,Healthcare,2,0
146577,27257,119320,18.59568691,81.40431309,Healthcare,2,2
61298,13295,48003,21.68912526,78.31087474,Transportation,4,4
41672,24842,16830,59.61316951,40.38683049,Food,1,1
36708,14815,21893,40.3590498,59.6409502,Food,1,1
33575,8875,24700,26.43335815,73.56664185,Food,1,1
72141,27856,44285,38.61327123,61.38672877,Transportation,4,4
22151,1994,20157,9.001850932,90.99814907,Housing,3,3
153691,13341,140350,8.680404188,91.31959581,Healthcare,2,0
17969,10361,7608,57.66041516,42.33958484,Housing,3,3
28073,8871,19202,31.59975777,68.40024223,Housing,3,1
58271,32839,25432,56.35564861,43.64435139,Food,1,4
31857,2674,29183,8.393759613,91.60624039,Food,1,1
36664,21005,15659,57.29053022,42.70946978,Food,1,1
16296,2345,13951,14.39003436,85.60996564,Housing,3,3
168801,1700,167101,1.007103038,98.99289696,Healthcare,2,0
34559,12861,21698,37.21461848,62.78538152,Food,1,1
156880,29254,127626,18.64737379,81.35262621,Healthcare,2,0
162204,61146,101058,37.69697418,62.30302582,Healthcare,2,0
29540,3375,26165,11.42518619,88.57481381,Housing,3,1
23333,874,22459,3.745767797,96.2542322,Housing,3,3
59362,20453,38909,34.45470166,65.54529834,Food,1,4
11942,1645,10297,13.77491208,86.22508792,Housing,3,3
38994,4592,34402,11.77617069,88.22382931,Food,1,1
175128,7829,167299,4.470444475,95.52955553,Healthcare,2,0
19174,10186,8988,53.12402211,46.87597789,Housing,3,3
181183,22007,159176,12.14628304,87.85371696,Entertainment,0,0
74300,30506,43794,41.05787349,58.94212651,Transportation,4,4
238169,59242,178927,24.87393406,75.12606594,Entertainment,0,0
86723,44051,42672,50.79506013,49.20493987,Transportation,4,4
52738,24515,28223,46.48450832,53.51549168,Food,1,4
228326,25073,203253,10.98122859,89.01877141,Entertainment,0,0
53435,2016,51419,3.772808085,96.22719192,Food,1,4
18435,6936,11499,37.62408462,62.37591538,Housing,3,3
87565,21972,65593,25.09221721,74.90778279,Transportation,4,4
58004,33390,24614,57.56499552,42.43500448,Food,1,4
51098,6876,44222,13.45649536,86.54350464,Food,1,4
224444,65948,158496,29.38283046,70.61716954,Entertainment,0,0
168149,10823,157326,6.436553295,93.56344671,Healthcare,2,0
100921,60473,40448,59.92112643,40.07887357,Transportation,4,4
11444,4092,7352,35.75672842,64.24327158,Housing,3,3
29885,17340,12545,58.02241927,41.97758073,Housing,3,1
89746,34352,55394,38.27691485,61.72308515,Transportation,4,4
114387,24314,90073,21.25591195,78.74408805,Transportation,4,2
32228,7473,24755,23.18791113,76.81208887,Food,1,1
215034,64379,150655,29.93898639,70.06101361,Entertainment,0,0
227428,66527,160901,29.25189511,70.74810489,Entertainment,0,0
158632,11951,146681,7.533788895,92.4662111,Healthcare,2,0
197024,5707,191317,2.896601429,97.10339857,Entertainment,0,0
33171,9790,23381,29.51373187,70.48626813,Food,1,1
15370,9221,6149,59.99349382,40.00650618,Housing,3,3
94408,12945,81463,13.71176172,86.28823828,Transportation,4,4
77302,17318,59984,22.40304261,77.59695739,Transportation,4,4
54994,5622,49372,10.22293341,89.77706659,Food,1,4
63202,33284,29918,52.66289041,47.33710959,Transportation,4,4
115025,2182,112843,1.896978918,98.10302108,Transportation,4,2
248576,9418,239158,3.788780896,96.2112191,Entertainment,0,0
229729,35350,194379,15.38769594,84.61230406,Entertainment,0,0
156781,33831,122950,21.5785076,78.4214924,Healthcare,2,0
64456,35726,28730,55.42695792,44.57304208,Transportation,4,4
112536,6611,105925,5.874564584,94.12543542,Transportation,4,2
42374,16535,25839,39.02156983,60.97843017,Food,1,1
222616,45536,177080,20.45495382,79.54504618,Entertainment,0,0
40606,1201,39405,2.957690982,97.04230902,Food,1,1
43801,22461,21340,51.27965115,48.72034885,Food,1,1
18144,8920,9224,49.1622575,50.8377425,Housing,3,3
236082,20559,215523,8.708414873,91.29158513,Entertainment,0,0
57919,30446,27473,52.56651531,47.43348469,Food,1,4
34317,19257,15060,56.11504502,43.88495498,Food,1,1
14868,3037,11831,20.42641916,79.57358084,Housing,3,3
117162,41752,75410,35.63612775,64.36387225,Transportation,4,2
14297,7872,6425,55.0605022,44.9394978,Housing,3,3
102462,48803,53659,47.630341,52.369659,Transportation,4,4
201493,15162,186331,7.524827165,92.47517283,Entertainment,0,0
49646,8986,40660,18.10014906,81.89985094,Food,1,4
173884,44703,129181,25.70851832,74.29148168,Healthcare,2,0
175953,27255,148698,15.48993197,84.51006803,Healthcare,2,0
17333,9213,8120,53.15294525,46.84705475,Housing,3,3
90951,10543,80408,11.59195611,88.40804389,Transportation,4,4
26722,12813,13909,47.9492553,52.0507447,Housing,3,1
97951,31042,66909,31.69135588,68.30864412,Transportation,4,4
72025,42722,29303,59.31551545,40.68448455,Transportation,4,4
21264,4321,16943,20.32072987,79.67927013,Housing,3,3
194722,51161,143561,26.27386736,73.72613264,Entertainment,0,0
12110,3943,8167,32.55986788,67.44013212,Housing,3,3
15996,4203,11793,26.27531883,73.72468117,Housing,3,3
249850,37801,212049,15.12947769,84.87052231,Entertainment,0,0
240782,43213,197569,17.94693956,82.05306044,Entertainment,0,0
80191,41088,39103,51.23767006,48.76232994,Transportation,4,4
239240,27002,212238,11.28657415,88.71342585,Entertainment,0,0
246415,67815,178600,27.52064606,72.47935394,Entertainment,0,0
235434,64276,171158,27.30106951,72.69893049,Entertainment,0,0
152813,39940,112873,26.1365198,73.8634802,Healthcare,2,0
214967,33264,181703,15.47400299,84.52599701,Entertainment,0,0
70532,23042,47490,32.66885952,67.33114048,Transportation,4,4
155596,42035,113561,27.01547598,72.98452402,Healthcare,2,0
128319,66917,61402,52.14894131,47.85105869,Healthcare,2,4
49189,5041,44148,10.24822623,89.75177377,Food,1,4
179235,39061,140174,21.79317656,78.20682344,Healthcare,2,0
101294,13038,88256,12.87144352,87.12855648,Transportation,4,2
143629,56902,86727,39.61734747,60.38265253,Healthcare,2,2
17000,399,16601,2.347058824,97.65294118,Housing,3,3
184732,33270,151462,18.00987376,81.99012624,Entertainment,0,0
24789,1082,23707,4.364839243,95.63516076,Housing,3,3
83800,46852,36948,55.90930788,44.09069212,Transportation,4,4
216850,9279,207571,4.278994697,95.7210053,Entertainment,0,0
220592,23400,197192,10.60781896,89.39218104,Entertainment,0,0
156082,4481,151601,2.870926821,97.12907318,Healthcare,2,0
124799,61333,63466,49.14542584,50.85457416,Healthcare,2,4
73868,13442,60426,18.19732496,81.80267504,Transportation,4,4
37764,14167,23597,37.51456414,62.48543586,Food,1,1
12620,2379,10241,18.85103011,81.14896989,Housing,3,3
95732,1035,94697,1.081143191,98.91885681,Transportation,4,4
17585,6333,11252,36.013648,63.986352,Housing,3,3
10181,1070,9111,10.50977311,89.49022689,Housing,3,3
124798,34274,90524,27.46358115,72.53641885,Healthcare,2,2
48635,14910,33725,30.65693431,69.34306569,Food,1,1
46033,18873,27160,40.99884865,59.00115135,Food,1,1
162733,30819,131914,18.93838373,81.06161627,Healthcare,2,0
60171,4730,55441,7.860929684,92.13907032,Transportation,4,4
28864,4851,24013,16.80640244,83.19359756,Housing,3,1
183960,40497,143463,22.01402479,77.98597521,Entertainment,0,0
21911,9190,12721,41.94240336,58.05759664,Housing,3,3
164843,29653,135190,17.98863161,82.01136839,Healthcare,2,0
116898,55229,61669,47.24546186,52.75453814,Transportation,4,4
42643,2317,40326,5.433482635,94.56651737,Food,1,1
13316,4455,8861,33.45599279,66.54400721,Housing,3,3
81971,33385,48586,40.72781837,59.27218163,Transportation,4,4
209499,51961,157538,24.80250502,75.19749498,Entertainment,0,0
39399,4587,34812,11.64242747,88.35757253,Food,1,1
210667,60203,150464,28.5773282,71.4226718,Entertainment,0,0
95131,56601,38530,59.49795545,40.50204455,Transportation,4,4
102282,7079,95203,6.921061379,93.07893862,Transportation,4,2
158126,1428,156698,0.903077293,99.09692271,Healthcare,2,0
57693,33632,24061,58.29476713,41.70523287,Food,1,4
78774,8791,69983,11.15977353,88.84022647,Transportation,4,4
55365,16173,39192,29.21159577,70.78840423,Food,1,4
144156,13532,130624,9.387052915,90.61294709,Healthcare,2,2
20028,9878,10150,49.32095067,50.67904933,Housing,3,3
57956,32479,25477,56.04078956,43.95921044,Food,1,4
37186,20080,17106,53.99881676,46.00118324,Food,1,1
49386,11399,37987,23.08144008,76.91855992,Food,1,1
226511,24976,201535,11.02639607,88.97360393,Entertainment,0,0
61257,14940,46317,24.38904941,75.61095059,Transportation,4,4
129492,52560,76932,40.58938004,59.41061996,Healthcare,2,2
24748,13891,10857,56.12978827,43.87021173,Housing,3,3
18753,3595,15158,19.17026609,80.82973391,Housing,3,3
249739,20148,229591,8.067622598,91.9323774,Entertainment,0,0
132503,7226,125277,5.453461431,94.54653857,Healthcare,2,2
66686,23749,42937,35.61317218,64.38682782,Transportation,4,4
226146,63403,162743,28.03631282,71.96368718,Entertainment,0,0
71144,33198,37946,46.66310581,53.33689419,Transportation,4,4
82410,33543,48867,40.70258464,59.29741536,Transportation,4,4
19479,2117,17362,10.86811438,89.13188562,Housing,3,3
12212,1149,11063,9.408778251,90.59122175,Housing,3,3
194967,489,194478,0.250811676,99.74918832,Entertainment,0,0
68585,38549,30036,56.20616753,43.79383247,Transportation,4,4
209148,45774,163374,21.88593723,78.11406277,Entertainment,0,0
46412,18312,28100,39.45531328,60.54468672,Food,1,1
28885,10858,18027,37.59044487,62.40955513,Housing,3,1
34752,16493,18259,47.45913904,52.54086096,Food,1,1
25010,10710,14300,42.82287085,57.17712915,Housing,3,1
23772,3755,20017,15.79589433,84.20410567,Housing,3,3
182119,55814,126305,30.64699455,69.35300545,Entertainment,0,0
60360,12829,47531,21.25414182,78.74585818,Transportation,4,4
240330,50244,190086,20.9062539,79.0937461,Entertainment,0,0
29569,15210,14359,51.43900707,48.56099293,Housing,3,1
43103,5468,37635,12.68589193,87.31410807,Food,1,1
55206,4026,51180,7.292685578,92.70731442,Food,1,4
88063,22300,65763,25.32278028,74.67721972,Transportation,4,4
52531,5254,47277,10.00171327,89.99828673,Food,1,4
168295,19414,148881,11.53569625,88.46430375,Healthcare,2,0
21044,10029,11015,47.65728949,52.34271051,Housing,3,3
15682,1645,14037,10.48973345,89.51026655,Housing,3,3
28612,11039,17573,38.58171397,61.41828603,Housing,3,1
234610,37267,197343,15.88465965,84.11534035,Entertainment,0,0
53155,1075,52080,2.022387358,97.97761264,Food,1,4
159465,31995,127470,20.06396388,79.93603612,Healthcare,2,0
72310,23482,48828,32.47406998,67.52593002,Transportation,4,4
25295,6202,19093,24.51867958,75.48132042,Housing,3,1
11460,2522,8938,22.0069808,77.9930192,Housing,3,3
90625,9672,80953,10.67255172,89.32744828,Transportation,4,4
16880,4125,12755,24.43720379,75.56279621,Housing,3,3
58326,30051,28275,51.52247711,48.47752289,Food,1,4
60905,1872,59033,3.073639274,96.92636073,Transportation,4,4
222697,54888,167809,24.64694181,75.35305819,Entertainment,0,0
116981,55313,61668,47.28374693,52.71625307,Transportation,4,4
167083,39291,127792,23.51585739,76.48414261,Healthcare,2,0
171098,15454,155644,9.032250523,90.96774948,Healthcare,2,0
29331,6701,22630,22.84613549,77.15386451,Housing,3,1
191571,62382,129189,32.56338381,67.43661619,Entertainment,0,0
28822,17218,11604,59.7390882,40.2609118,Housing,3,1
33871,710,33161,2.09618848,97.90381152,Food,1,1
48961,26161,22800,53.43232369,46.56767631,Food,1,1
66382,8839,57543,13.31535657,86.68464343,Transportation,4,4
17088,5260,11828,30.78183521,69.21816479,Housing,3,3
98774,48813,49961,49.41887541,50.58112459,Transportation,4,4
13093,4521,8572,34.52990147,65.47009853,Housing,3,3
83065,19354,63711,23.29982544,76.70017456,Transportation,4,4
106760,64017,42743,59.96346946,40.03653054,Transportation,4,4
50454,14043,36411,27.83327387,72.16672613,Food,1,4
33072,8408,24664,25.42331882,74.57668118,Food,1,1
231189,37982,193207,16.42898235,83.57101765,Entertainment,0,0
10308,4803,5505,46.59487776,53.40512224,Housing,3,3
141110,45258,95852,32.07285097,67.92714903,Healthcare,2,2
56962,2586,54376,4.539868684,95.46013132,Food,1,4
29697,15293,14404,51.49678419,48.50321581,Housing,3,1
50829,5051,45778,9.937240552,90.06275945,Food,1,4
204084,2977,201107,1.458713079,98.54128692,Entertainment,0,0
23250,10356,12894,44.54193548,55.45806452,Housing,3,3
190647,33270,157377,17.45110073,82.54889927,Entertainment,0,0
121427,46861,74566,38.59191119,61.40808881,Healthcare,2,2
26254,1023,25231,3.896549097,96.1034509,Housing,3,1
36059,8999,27060,24.95632158,75.04367842,Food,1,1
225459,23227,202232,10.30209484,89.69790516,Entertainment,0,0
97295,57725,39570,59.32987307,40.67012693,Transportation,4,4
205331,57481,147850,27.99431162,72.00568838,Entertainment,0,0
55416,25590,29826,46.17799913,53.82200087,Food,1,4
112222,35174,77048,31.34323038,68.65676962,Transportation,4,2
48743,3181,45562,6.526065281,93.47393472,Food,1,4
21233,1156,20077,5.444355484,94.55564452,Housing,3,3
72489,15889,56600,21.91918774,78.08081226,Transportation,4,4
234934,27887,207047,11.87014225,88.12985775,Entertainment,0,0
121040,33220,87820,27.44547257,72.55452743,Healthcare,2,2
27305,3609,23696,13.21735946,86.78264054,Housing,3,1
28916,13771,15145,47.62415272,52.37584728,Housing,3,1
34519,4817,29702,13.95463368,86.04536632,Food,1,1
27651,1862,25789,6.733933673,93.26606633,Housing,3,1
66516,16051,50465,24.13103614,75.86896386,Transportation,4,4
118357,59157,59200,49.98183462,50.01816538,Transportation,4,4
79825,28875,50950,36.17287817,63.82712183,Transportation,4,4
58471,32029,26442,54.77758205,45.22241795,Food,1,4
212151,43002,169149,20.26952501,79.73047499,Entertainment,0,0
232511,69193,163318,29.75902215,70.24097785,Entertainment,0,0
70189,31714,38475,45.18371825,54.81628175,Transportation,4,4
164364,30399,133965,18.4949259,81.5050741,Healthcare,2,0
33503,15083,18420,45.01984897,54.98015103,Food,1,1
133034,12911,120123,9.70503781,90.29496219,Healthcare,2,2
24683,2520,22163,10.2094559,89.7905441,Housing,3,3
39403,16284,23119,41.32680253,58.67319747,Food,1,1
227250,35540,191710,15.63916392,84.36083608,Entertainment,0,0
114353,57539,56814,50.31700087,49.68299913,Transportation,4,4
102550,20904,81646,20.38420283,79.61579717,Transportation,4,2
29387,3871,25516,13.17249124,86.82750876,Housing,3,1
121499,21788,99711,17.93265788,82.06734212,Healthcare,2,2
244218,21490,222728,8.799515187,91.20048481,Entertainment,0,0
40624,15209,25415,37.43846002,62.56153998,Food,1,1
27913,16525,11388,59.20180561,40.79819439,Housing,3,1
188141,21254,166887,11.29684651,88.70315349,Entertainment,0,0
63753,8426,55327,13.21663294,86.78336706,Transportation,4,4
188352,46721,141631,24.80515206,75.19484794,Entertainment,0,0
203347,38297,165050,18.83332432,81.16667568,Entertainment,0,0
191955,16144,175811,8.410304498,91.5896955,Entertainment,0,0
25878,10888,14990,42.07434887,57.92565113,Housing,3,1
36138,2672,33466,7.393879019,92.60612098,Food,1,1
17460,9376,8084,53.69988545,46.30011455,Housing,3,3
140539,64929,75610,46.19998719,53.80001281,Healthcare,2,2
55835,24986,30849,44.74970896,55.25029104,Food,1,4
165857,9516,156341,5.737472642,94.26252736,Healthcare,2,0
89976,44565,45411,49.52987463,50.47012537,Transportation,4,4
160431,45199,115232,28.17348268,71.82651732,Healthcare,2,0
56121,1576,54545,2.808217958,97.19178204,Food,1,4
16244,5055,11189,31.11918247,68.88081753,Housing,3,3
15966,4293,11673,26.88838782,73.11161218,Housing,3,3
170179,41981,128198,24.66873116,75.33126884,Healthcare,2,0
209942,52538,157404,25.02500691,74.97499309,Entertainment,0,0
110888,22658,88230,20.43322993,79.56677007,Transportation,4,2
33130,12511,20619,37.76335647,62.23664353,Food,1,1
36639,9960,26679,27.18414804,72.81585196,Food,1,1
15463,3558,11905,23.00976525,76.99023475,Housing,3,3
90291,50932,39359,56.40872291,43.59127709,Transportation,4,4
193573,26262,167311,13.56697473,86.43302527,Entertainment,0,0
13565,7806,5759,57.54515297,42.45484703,Housing,3,3
45555,17775,27780,39.01876852,60.98123148,Food,1,1
13486,5751,7735,42.64422364,57.35577636,Housing,3,3
207143,54395,152748,26.25963706,73.74036294,Entertainment,0,0
238632,392,238240,0.16426967,99.83573033,Entertainment,0,0
16803,2240,14563,13.33095281,86.66904719,Housing,3,3
56807,28109,28698,49.48157797,50.51842203,Food,1,4
207280,18258,189022,8.808375145,91.19162486,Entertainment,0,0
180830,30850,149980,17.06022231,82.93977769,Entertainment,0,0
47695,22084,25611,46.30254744,53.69745256,Food,1,1
168033,30924,137109,18.40352788,81.59647212,Healthcare,2,0
175468,20844,154624,11.87908906,88.12091094,Healthcare,2,0
18858,1157,17701,6.135327182,93.86467282,Housing,3,3
42228,20518,21710,48.58861419,51.41138581,Food,1,1
105543,37058,68485,35.1117554,64.8882446,Transportation,4,2
25976,13231,12745,50.9354789,49.0645211,Housing,3,1
43421,285,43136,0.656364432,99.34363557,Food,1,4
176120,2496,173624,1.417215535,98.58278447,Healthcare,2,0
237459,50360,187099,21.20787167,78.79212833,Entertainment,0,0
158725,51846,106879,32.66404158,67.33595842,Healthcare,2,0
164503,10538,153965,6.405962201,93.5940378,Healthcare,2,0
225462,61215,164247,27.15091678,72.84908322,Entertainment,0,0
155635,32706,122929,21.01455328,78.98544672,Healthcare,2,0
191824,51812,140012,27.01017599,72.98982401,Entertainment,0,0
60123,5569,54554,9.262678176,90.73732182,Transportation,4,4
76549,28999,47550,37.88292466,62.11707534,Transportation,4,4
203147,22363,180784,11.00828464,88.99171536,Entertainment,0,0
52854,1365,51489,2.582585992,97.41741401,Food,1,4
220915,12675,208240,5.737500849,94.26249915,Entertainment,0,0
20861,1177,19684,5.642107282,94.35789272,Housing,3,3
17897,932,16965,5.207576689,94.79242331,Housing,3,3
56360,3926,52434,6.965933286,93.03406671,Food,1,4
11337,3068,8269,27.06183294,72.93816706,Housing,3,3
99494,6494,93000,6.527026755,93.47297324,Transportation,4,4
163996,22590,141406,13.77472621,86.22527379,Healthcare,2,0
182882,63583,119299,34.76722696,65.23277304,Entertainment,0,0
170854,7807,163047,4.569398434,95.43060157,Healthcare,2,0
17082,8523,8559,49.89462592,50.10537408,Housing,3,3
198982,60953,138029,30.63241901,69.36758099,Entertainment,0,0
217504,24588,192916,11.30461969,88.69538031,Entertainment,0,0
120748,40543,80205,33.57653957,66.42346043,Healthcare,2,2
185430,28017,157413,15.10920563,84.89079437,Entertainment,0,0
52441,1411,51030,2.690642818,97.30935718,Food,1,4
182508,38729,143779,21.22043965,78.77956035,Entertainment,0,0
44854,21341,23513,47.57881125,52.42118875,Food,1,1
180472,26971,153501,14.94470056,85.05529944,Entertainment,0,0
11536,1332,10204,11.54646325,88.45353675,Housing,3,3
25320,4365,20955,17.23933649,82.76066351,Housing,3,1
246838,68938,177900,27.9284389,72.0715611,Entertainment,0,0
100958,40280,60678,39.89777927,60.10222073,Transportation,4,4
229052,21569,207483,9.416639016,90.58336098,Entertainment,0,0
245120,66125,178995,26.9765829,73.0234171,Entertainment,0,0
217791,40251,177540,18.48147995,81.51852005,Entertainment,0,0
19676,7325,12351,37.22809514,62.77190486,Housing,3,3
45832,25400,20432,55.41979403,44.58020597,Food,1,1
43275,4953,38322,11.44540728,88.55459272,Food,1,1
44665,15871,28794,35.53341543,64.46658457,Food,1,1
18534,2709,15825,14.61638071,85.38361929,Housing,3,3
27334,8747,18587,32.00043901,67.99956099,Housing,3,1
187983,10024,177959,5.332397078,94.66760292,Entertainment,0,0
248488,31386,217102,12.63079102,87.36920898,Entertainment,0,0
38300,5946,32354,15.52480418,84.47519582,Food,1,1
223026,7672,215354,3.439957673,96.56004233,Entertainment,0,0
110397,49991,60406,45.28293341,54.71706659,Transportation,4,4
21358,2459,18899,11.5132503,88.4867497,Housing,3,3
135732,65687,70045,48.3946306,51.6053694,Healthcare,2,4
37961,3278,34683,8.635178209,91.36482179,Food,1,1
183679,33695,149984,18.34450318,81.65549682,Entertainment,0,0
41997,5285,36712,12.58423221,87.41576779,Food,1,1
83681,3232,80449,3.862286541,96.13771346,Transportation,4,4
194081,31999,162082,16.48744596,83.51255404,Entertainment,0,0
81751,6353,75398,7.771158763,92.22884124,Transportation,4,4
31696,10058,21638,31.73271075,68.26728925,Food,1,1
230212,62764,167448,27.26356576,72.73643424,Entertainment,0,0
159914,20066,139848,12.54799455,87.45200545,Healthcare,2,0
18124,1527,16597,8.42529243,91.57470757,Housing,3,3
118662,361,118301,0.304225447,99.69577455,Transportation,4,2
29516,7699,21817,26.08415774,73.91584226,Housing,3,1
202696,51448,151248,25.38185263,74.61814737,Entertainment,0,0
161692,3574,158118,2.210375281,97.78962472,Healthcare,2,0
18361,9416,8945,51.28260988,48.71739012,Housing,3,3
64069,30418,33651,47.47693893,52.52306107,Transportation,4,4
35357,2133,33224,6.032751647,93.96724835,Food,1,1
175251,27245,148006,15.54627363,84.45372637,Healthcare,2,0
99002,7113,91889,7.184703339,92.81529666,Transportation,4,4
42664,12359,30305,28.96821676,71.03178324,Food,1,1
172070,25478,146592,14.80676469,85.19323531,Healthcare,2,0
75785,37094,38691,48.94636142,51.05363858,Transportation,4,4
166793,58269,108524,34.93491933,65.06508067,Healthcare,2,0
88669,38220,50449,43.10412884,56.89587116,Transportation,4,4
29667,5416,24251,18.25597465,81.74402535,Housing,3,1
15672,1081,14591,6.897651863,93.10234814,Housing,3,3
183821,54554,129267,29.67778437,70.32221563,Entertainment,0,0
18096,4275,13821,23.62400531,76.37599469,Housing,3,3
17802,3992,13810,22.42444669,77.57555331,Housing,3,3
44519,26578,17941,59.70035266,40.29964734,Food,1,1
22505,4602,17903,20.44878916,79.55121084,Housing,3,3
11557,4254,7303,36.80886043,63.19113957,Housing,3,3
54005,21648,32357,40.0851773,59.9148227,Food,1,4
121873,53306,68567,43.73897418,56.26102582,Healthcare,2,4
30048,4574,25474,15.22231097,84.77768903,Food,1,1
208856,4365,204491,2.089956717,97.91004328,Entertainment,0,0
106669,30824,75845,28.89686788,71.10313212,Transportation,4,2
247114,14810,232304,5.993185331,94.00681467,Entertainment,0,0
13306,5423,7883,40.7560499,59.2439501,Housing,3,3
22875,850,22025,3.715846995,96.28415301,Housing,3,3
28501,6922,21579,24.28686713,75.71313287,Housing,3,1
236505,66157,170348,27.97277013,72.02722987,Entertainment,0,0
92705,32090,60615,34.61517717,65.38482283,Transportation,4,4
21997,9738,12259,44.26967314,55.73032686,Housing,3,3
104161,15595,88566,14.97201448,85.02798552,Transportation,4,2
235939,45715,190224,19.37577086,80.62422914,Entertainment,0,0
181653,59278,122375,32.63254667,67.36745333,Entertainment,0,0
28304,6428,21876,22.71057094,77.28942906,Housing,3,1
34401,8670,25731,25.20275573,74.79724427,Food,1,1
243011,13378,229633,5.505100592,94.49489941,Entertainment,0,0
49517,2890,46627,5.836379425,94.16362057,Food,1,4
133235,61731,71504,46.33242016,53.66757984,Healthcare,2,2
163008,37061,125947,22.73569395,77.26430605,Healthcare,2,0
205652,69993,135659,34.03467994,65.96532006,Entertainment,0,0
136066,35481,100585,26.07631591,73.92368409,Healthcare,2,2
185023,66545,118478,35.96579885,64.03420115,Entertainment,0,0
59353,34885,24468,58.77546207,41.22453793,Food,1,4
50738,7689,43049,15.1543222,84.8456778,Food,1,4
75332,23625,51707,31.36117453,68.63882547,Transportation,4,4
149972,388,149584,0.25871496,99.74128504,Healthcare,2,2
211173,59005,152168,27.94154556,72.05845444,Entertainment,0,0
249825,67637,182188,27.07375163,72.92624837,Entertainment,0,0
227633,48140,179493,21.14807607,78.85192393,Entertainment,0,0
162005,6611,155394,4.080738249,95.91926175,Healthcare,2,0
51467,7882,43585,15.31466765,84.68533235,Food,1,4
136773,31905,104868,23.32697243,76.67302757,Healthcare,2,2
50328,2941,47387,5.843665554,94.15633445,Food,1,4
116244,20049,96195,17.2473418,82.7526582,Transportation,4,2
112692,41691,71001,36.99552763,63.00447237,Transportation,4,2
44923,20509,24414,45.65367406,54.34632594,Food,1,1
13424,456,12968,3.396901073,96.60309893,Housing,3,3
95525,17406,78119,18.22140801,81.77859199,Transportation,4,4
161254,30131,131123,18.68542796,81.31457204,Healthcare,2,0
20095,9662,10433,48.08161234,51.91838766,Housing,3,3
17833,10177,7656,57.06835642,42.93164358,Housing,3,3
11914,453,11461,3.802249454,96.19775055,Housing,3,3
23070,302,22768,1.309059384,98.69094062,Housing,3,3
65350,20673,44677,31.63427697,68.36572303,Transportation,4,4
111549,58964,52585,52.85928157,47.14071843,Transportation,4,4
237489,60947,176542,25.66308334,74.33691666,Entertainment,0,0
35212,91,35121,0.258434625,99.74156538,Food,1,1
33392,1989,31403,5.956516531,94.04348347,Food,1,1
172303,1129,171174,0.655241058,99.34475894,Healthcare,2,0
176692,30265,146427,17.12867589,82.87132411,Healthcare,2,0
28114,11148,16966,39.652842,60.347158,Housing,3,1
120638,30822,89816,25.54916361,74.45083639,Healthcare,2,2
238135,18732,219403,7.866126357,92.13387364,Entertainment,0,0
15134,7075,8059,46.74904189,53.25095811,Housing,3,3
150263,55160,95103,36.70897027,63.29102973,Healthcare,2,0
14738,7286,7452,49.43682996,50.56317004,Housing,3,3
188888,36831,152057,19.49885647,80.50114353,Entertainment,0,0
21196,11782,9414,55.58595962,44.41404038,Housing,3,3
48220,27140,21080,56.28369971,43.71630029,Food,1,1
190341,6356,183985,3.339270047,96.66072995,Entertainment,0,0
18731,10693,8038,57.08718168,42.91281832,Housing,3,3
29638,3654,25984,12.32876712,87.67123288,Housing,3,1
148367,39677,108690,26.74246969,73.25753031,Healthcare,2,2
13459,2856,10603,21.22000149,78.77999851,Housing,3,3
44891,13836,31055,30.82132276,69.17867724,Food,1,1
148064,50141,97923,33.86440998,66.13559002,Healthcare,2,2
10531,2275,8256,21.60288672,78.39711328,Housing,3,3
200146,51009,149137,25.4858953,74.5141047,Entertainment,0,0
25418,747,24671,2.938862224,97.06113778,Housing,3,1
203598,6987,196611,3.431762591,96.56823741,Entertainment,0,0
167380,63598,103782,37.99617637,62.00382363,Healthcare,2,0
97961,15606,82355,15.93082962,84.06917038,Transportation,4,4
138867,63096,75771,45.43628076,54.56371924,Healthcare,2,2
14557,1030,13527,7.075633716,92.92436628,Housing,3,3
172775,21903,150872,12.67718131,87.32281869,Healthcare,2,0
72454,7246,65208,10.00082811,89.99917189,Transportation,4,4
29260,3185,26075,10.88516746,89.11483254,Housing,3,1
219627,39646,179981,18.05151461,81.94848539,Entertainment,0,0
144444,16886,127558,11.69034366,88.30965634,Healthcare,2,2
53347,11600,41747,21.74442799,78.25557201,Food,1,4
180727,36402,144325,20.14198211,79.85801789,Entertainment,0,0
221348,5989,215359,2.705694201,97.2943058,Entertainment,0,0
20127,5221,14906,25.94027923,74.05972077,Housing,3,3
29308,2927,26381,9.987034257,90.01296574,Housing,3,1
30455,15489,14966,50.8586439,49.1413561,Food,1,1
13318,5722,7596,42.96440907,57.03559093,Housing,3,3
58946,30582,28364,51.88138296,48.11861704,Food,1,4
231312,29773,201539,12.87135989,87.12864011,Entertainment,0,0
44857,6688,38169,14.90960162,85.09039838,Food,1,1
60810,27721,33089,45.58625226,54.41374774,Transportation,4,4
112532,6060,106472,5.385134895,94.61486511,Transportation,4,2
38542,17996,20546,46.6919205,53.3080795,Food,1,1
173711,59742,113969,34.39160445,65.60839555,Healthcare,2,0
218995,34403,184592,15.70949108,84.29050892,Entertainment,0,0
21629,8759,12870,40.49655555,59.50344445,Housing,3,3
198615,12989,185626,6.539788032,93.46021197,Entertainment,0,0
28891,13573,15318,46.98002838,53.01997162,Housing,3,1
13821,7300,6521,52.81817524,47.18182476,Housing,3,3
10459,2714,7745,25.94894349,74.05105651,Housing,3,3
50740,5541,45199,10.9203784,89.0796216,Food,1,4
64130,34934,29196,54.47372525,45.52627475,Transportation,4,4
12110,3431,8679,28.33195706,71.66804294,Housing,3,3
92513,42832,49681,46.29835807,53.70164193,Transportation,4,4
27243,5044,22199,18.51484785,81.48515215,Housing,3,1
10280,6167,4113,59.99027237,40.00972763,Housing,3,3
57288,20985,36303,36.630708,63.369292,Food,1,4
96593,35996,60597,37.26564037,62.73435963,Transportation,4,4
240364,5247,235117,2.182939209,97.81706079,Entertainment,0,0
11197,1141,10056,10.19022953,89.80977047,Housing,3,3
26255,13490,12765,51.38068939,48.61931061,Housing,3,1
48225,16578,31647,34.37636081,65.62363919,Food,1,1
175808,25771,150037,14.65860484,85.34139516,Healthcare,2,0
166997,4506,162491,2.698252064,97.30174794,Healthcare,2,0
67002,12391,54611,18.49347781,81.50652219,Transportation,4,4
214090,8843,205247,4.130505862,95.86949414,Entertainment,0,0
70540,14579,55961,20.66770627,79.33229373,Transportation,4,4
23986,1107,22879,4.615192195,95.3848078,Housing,3,3
45709,2496,43213,5.460631386,94.53936861,Food,1,4
131397,31608,99789,24.05534373,75.94465627,Healthcare,2,2
38919,13676,25243,35.13964901,64.86035099,Food,1,1
230516,8224,222292,3.567648233,96.43235177,Entertainment,0,0
197211,66618,130593,33.78006298,66.21993702,Entertainment,0,0
150933,26764,124169,17.73237132,82.26762868,Healthcare,2,0
86787,36736,50051,42.32892023,57.67107977,Transportation,4,4
110020,36500,73520,33.17578622,66.82421378,Transportation,4,2
63671,14786,48885,23.22250318,76.77749682,Transportation,4,4
78065,32646,45419,41.81899699,58.18100301,Transportation,4,4
154140,6883,147257,4.465421046,95.53457895,Healthcare,2,0
96299,16249,80050,16.87348778,83.12651222,Transportation,4,4
49099,5135,43964,10.45846148,89.54153852,Food,1,4
29110,3704,25406,12.72414978,87.27585022,Housing,3,1
138356,20842,117514,15.0640377,84.9359623,Healthcare,2,2
134928,42767,92161,31.69616388,68.30383612,Healthcare,2,2
161771,56907,104864,35.177504,64.822496,Healthcare,2,0
49527,5138,44389,10.37413936,89.62586064,Food,1,4
86263,39389,46874,45.66152348,54.33847652,Transportation,4,4
135334,26080,109254,19.27084103,80.72915897,Healthcare,2,2
219805,37105,182700,16.88087168,83.11912832,Entertainment,0,0
11729,4991,6738,42.55264728,57.44735272,Housing,3,3
106934,25516,81418,23.86144725,76.13855275,Transportation,4,2
50927,20989,29938,41.2138944,58.7861056,Food,1,4
13866,4479,9387,32.30203375,67.69796625,Housing,3,3
242738,53785,188953,22.15763498,77.84236502,Entertainment,0,0
29507,12320,17187,41.75280442,58.24719558,Housing,3,1
26206,2159,24047,8.23857132,91.76142868,Housing,3,1
89999,53645,36354,59.60621785,40.39378215,Transportation,4,4
17310,5921,11389,34.20566147,65.79433853,Housing,3,3
74650,27336,47314,36.61888814,63.38111186,Transportation,4,4
161572,64227,97345,39.7513183,60.2486817,Healthcare,2,0
58751,30972,27779,52.71740055,47.28259945,Food,1,4
172160,22285,149875,12.94435409,87.05564591,Healthcare,2,0
70400,10208,60192,14.5,85.5,Transportation,4,4
39271,10532,28739,26.81877212,73.18122788,Food,1,1
80063,47564,32499,59.40821603,40.59178397,Transportation,4,4
239552,30023,209529,12.53297823,87.46702177,Entertainment,0,0
128615,61047,67568,47.46491467,52.53508533,Healthcare,2,4
228482,54102,174380,23.67888937,76.32111063,Entertainment,0,0
92502,46230,46272,49.97729779,50.02270221,Transportation,4,4
165595,24590,141005,14.84948217,85.15051783,Healthcare,2,0
215246,23772,191474,11.04410767,88.95589233,Entertainment,0,0
100153,55426,44727,55.34132777,44.65867223,Transportation,4,4
204498,30523,173975,14.92581835,85.07418165,Entertainment,0,0
187821,62675,125146,33.36953802,66.63046198,Entertainment,0,0
188676,1388,187288,0.735652653,99.26434735,Entertainment,0,0
115997,34345,81652,29.60852436,70.39147564,Transportation,4,2
210240,57298,152942,27.25361492,72.74638508,Entertainment,0,0
97104,54713,42391,56.34474378,43.65525622,Transportation,4,4
19739,5810,13929,29.4341152,70.5658848,Housing,3,3
19427,11039,8388,56.82297833,43.17702167,Housing,3,3
31529,16845,14684,53.42700371,46.57299629,Food,1,1
226600,47279,179321,20.86451898,79.13548102,Entertainment,0,0
33209,5051,28158,15.2097323,84.7902677,Food,1,1
48428,2935,45493,6.060543487,93.93945651,Food,1,4
14279,2118,12161,14.8329715,85.1670285,Housing,3,3
18263,3469,14794,18.99468871,81.00531129,Housing,3,3
33922,1463,32459,4.312835328,95.68716467,Food,1,1
58678,11618,47060,19.79958417,80.20041583,Food,1,4
161600,67700,93900,41.89356436,58.10643564,Healthcare,2,0
71330,24923,46407,34.94041778,65.05958222,Transportation,4,4
45525,9545,35980,20.96650192,79.03349808,Food,1,1
154608,67842,86766,43.88000621,56.11999379,Healthcare,2,0
224339,3688,220651,1.643940643,98.35605936,Entertainment,0,0
82386,23084,59302,28.01932367,71.98067633,Transportation,4,4
28733,3970,24763,13.81686562,86.18313438,Housing,3,1
125643,58301,67342,46.40210756,53.59789244,Healthcare,2,4
72114,27550,44564,38.20340017,61.79659983,Transportation,4,4
169582,57679,111903,34.01245415,65.98754585,Healthcare,2,0
24884,5359,19525,21.5359267,78.4640733,Housing,3,3
142793,35831,106962,25.09296674,74.90703326,Healthcare,2,2
93377,25154,68223,26.9381111,73.0618889,Transportation,4,4
115588,45885,69703,39.69702737,60.30297263,Transportation,4,4
104615,8296,96319,7.930029155,92.06997085,Transportation,4,2
227211,2213,224998,0.973984534,99.02601547,Entertainment,0,0
168956,7716,161240,4.566869481,95.43313052,Healthcare,2,0
52720,30678,22042,58.19044006,41.80955994,Food,1,4
55550,10636,44914,19.14671467,80.85328533,Food,1,4
26422,9267,17155,35.07304519,64.92695481,Housing,3,1
191055,53215,137840,27.85323598,72.14676402,Entertainment,0,0
206340,56038,150302,27.15808859,72.84191141,Entertainment,0,0
139974,18472,121502,13.19673654,86.80326346,Healthcare,2,2
234314,38935,195379,16.61659141,83.38340859,Entertainment,0,0
155578,6406,149172,4.117548754,95.88245125,Healthcare,2,0
222952,43039,179913,19.30415515,80.69584485,Entertainment,0,0
29355,14870,14485,50.65576563,49.34423437,Housing,3,1
242182,17895,224287,7.389071029,92.61092897,Entertainment,0,0
21765,3786,17979,17.39490007,82.60509993,Housing,3,3
17177,230,16947,1.338999825,98.66100017,Housing,3,3
117064,15405,101659,13.15946833,86.84053167,Transportation,4,2
215651,1154,214497,0.535123881,99.46487612,Entertainment,0,0
241066,11214,229852,4.651838086,95.34816191,Entertainment,0,0
31401,7754,23647,24.6934811,75.3065189,Food,1,1
24604,4435,20169,18.0255243,81.9744757,Housing,3,3
34177,8172,26005,23.91081722,76.08918278,Food,1,1
240697,63291,177406,26.29488527,73.70511473,Entertainment,0,0
112475,29042,83433,25.82084908,74.17915092,Transportation,4,2
126114,37801,88313,29.97367461,70.02632539,Healthcare,2,2
150011,18686,131325,12.45641986,87.54358014,Healthcare,2,0
62763,29956,32807,47.72875739,52.27124261,Transportation,4,4
162378,54597,107781,33.62339726,66.37660274,Healthcare,2,0
33361,12463,20898,37.35799287,62.64200713,Food,1,1
169715,32527,137188,19.16566008,80.83433992,Healthcare,2,0
37489,11285,26204,30.1021633,69.8978367,Food,1,1
36350,20669,15681,56.8610729,43.1389271,Food,1,1
44974,24996,19978,55.57877885,44.42122115,Food,1,1
90052,18046,72006,20.03953271,79.96046729,Transportation,4,4
23350,7918,15432,33.91006424,66.08993576,Housing,3,3
122907,32695,90212,26.60141408,73.39858592,Healthcare,2,2
123299,10814,112485,8.770549639,91.22945036,Healthcare,2,2
136586,27319,109267,20.00131785,79.99868215,Healthcare,2,2
28705,2404,26301,8.374847588,91.62515241,Housing,3,1
241341,58390,182951,24.19398279,75.80601721,Entertainment,0,0
52039,17742,34297,34.09366052,65.90633948,Food,1,4
92534,54347,38187,58.73192556,41.26807444,Transportation,4,4
155498,54684,100814,35.16701179,64.83298821,Healthcare,2,0
176714,58734,117980,33.23675544,66.76324456,Healthcare,2,0
107685,22198,85487,20.61382737,79.38617263,Transportation,4,2
219326,61909,157417,28.2269316,71.7730684,Entertainment,0,0
133483,59042,74441,44.23184975,55.76815025,Healthcare,2,2
93057,39892,53165,42.86834951,57.13165049,Transportation,4,4
72763,15758,57005,21.65661119,78.34338881,Transportation,4,4
83467,29378,54089,35.19714378,64.80285622,Transportation,4,4
51611,6199,45412,12.01100541,87.98899459,Food,1,4
172130,47936,124194,27.84871899,72.15128101,Healthcare,2,0
96340,48433,47907,50.27299149,49.72700851,Transportation,4,4
13092,6582,6510,50.27497709,49.72502291,Housing,3,3
84698,34173,50525,40.3468795,59.6531205,Transportation,4,4
104676,3757,100919,3.589170392,96.41082961,Transportation,4,2
47507,22613,24894,47.59930116,52.40069884,Food,1,1
12105,8,12097,0.066088393,99.93391161,Housing,3,3
25820,8398,17422,32.52517428,67.47482572,Housing,3,1
16547,2958,13589,17.87635221,82.12364779,Housing,3,3
184647,43292,141355,23.44581824,76.55418176,Entertainment,0,0
223327,56723,166604,25.39907848,74.60092152,Entertainment,0,0
13707,690,13017,5.033924272,94.96607573,Housing,3,3
16224,3946,12278,24.32199211,75.67800789,Housing,3,3
127268,6594,120674,5.181192444,94.81880756,Healthcare,2,2
39861,10202,29659,25.59393894,74.40606106,Food,1,1
156220,22984,133236,14.71258482,85.28741518,Healthcare,2,0
52988,14955,38033,28.22337133,71.77662867,Food,1,4
41899,7575,34324,18.07919043,81.92080957,Food,1,1
39422,14754,24668,37.42580285,62.57419715,Food,1,1
181919,11131,170788,6.118657205,93.8813428,Entertainment,0,0
249381,46919,202462,18.81418392,81.18581608,Entertainment,0,0
163908,26243,137665,16.01081094,83.98918906,Healthcare,2,0
58246,33312,24934,57.19191017,42.80808983,Food,1,4
99502,8068,91434,8.108379731,91.89162027,Transportation,4,4
52649,11521,41128,21.88265684,78.11734316,Food,1,4
15514,107,15407,0.689699626,99.31030037,Housing,3,3
75853,26872,48981,35.42641689,64.57358311,Transportation,4,4
21293,22,21271,0.10332034,99.89667966,Housing,3,3
12578,6151,6427,48.90284624,51.09715376,Housing,3,3
115671,30304,85367,26.19844213,73.80155787,Transportation,4,2
185657,18371,167286,9.89512919,90.10487081,Entertainment,0,0
101590,37423,64167,36.83728713,63.16271287,Transportation,4,2
15191,6661,8530,43.84833125,56.15166875,Housing,3,3
203988,33191,170797,16.27105516,83.72894484,Entertainment,0,0
36850,19272,17578,52.29850746,47.70149254,Food,1,1
145559,48785,96774,33.5156191,66.4843809,Healthcare,2,2
187892,17196,170696,9.152066081,90.84793392,Entertainment,0,0
149963,5013,144950,3.342824563,96.65717544,Healthcare,2,2
90793,27973,62820,30.80964392,69.19035608,Transportation,4,4
175837,65214,110623,37.08775741,62.91224259,Healthcare,2,0
191607,34678,156929,18.09850371,81.90149629,Entertainment,0,0
20338,4466,15872,21.95889468,78.04110532,Housing,3,3
120043,35089,84954,29.23035912,70.76964088,Healthcare,2,2
27766,11894,15872,42.8365627,57.1634373,Housing,3,1
13358,6583,6775,49.28132954,50.71867046,Housing,3,3
37479,7626,29853,20.34739454,79.65260546,Food,1,1
28023,1594,26429,5.688184705,94.31181529,Housing,3,1
19826,2210,17616,11.14697871,88.85302129,Housing,3,3
159870,18799,141071,11.75892913,88.24107087,Healthcare,2,0
124649,8033,116616,6.444496145,93.55550385,Healthcare,2,2
118409,14727,103682,12.43739918,87.56260082,Transportation,4,2
118625,58343,60282,49.18271865,50.81728135,Transportation,4,4
168971,13318,155653,7.881825875,92.11817412,Healthcare,2,0
18679,9457,9222,50.62904866,49.37095134,Housing,3,3
57266,4338,52928,7.575175497,92.4248245,Food,1,4
95657,6849,88808,7.159956929,92.84004307,Transportation,4,4
199186,58100,141086,29.16871668,70.83128332,Entertainment,0,0
29253,13358,15895,45.66369261,54.33630739,Housing,3,1
175850,46619,129231,26.5106625,73.4893375,Healthcare,2,0
133900,22558,111342,16.84690067,83.15309933,Healthcare,2,2
24956,7640,17316,30.61388043,69.38611957,Housing,3,3
58279,28243,30036,48.46171005,51.53828995,Food,1,4
49016,24866,24150,50.73037376,49.26962624,Food,1,1
223510,63866,159644,28.57411302,71.42588698,Entertainment,0,0
20050,6644,13406,33.13715711,66.86284289,Housing,3,3
99247,7525,91722,7.582093162,92.41790684,Transportation,4,4
222104,51316,170788,23.10449159,76.89550841,Entertainment,0,0
245642,2221,243421,0.90416134,99.09583866,Entertainment,0,0
132399,39976,92423,30.19358152,69.80641848,Healthcare,2,2
103093,10315,92778,10.00552899,89.99447101,Transportation,4,2
205123,37662,167461,18.3606909,81.6393091,Entertainment,0,0
120833,18489,102344,15.30128359,84.69871641,Healthcare,2,2
57008,14673,42335,25.73849284,74.26150716,Food,1,4
27681,2994,24687,10.81608323,89.18391677,Housing,3,1
149502,54310,95192,36.32727321,63.67272679,Healthcare,2,2
14557,8083,6474,55.5265508,44.4734492,Housing,3,3
125448,50906,74542,40.57936356,59.42063644,Healthcare,2,2
66001,34318,31683,51.99618188,48.00381812,Transportation,4,4
19702,10507,9195,53.32961121,46.67038879,Housing,3,3
78356,26051,52305,33.24697534,66.75302466,Transportation,4,4
10158,4749,5409,46.751329,53.248671,Housing,3,3
113445,50997,62448,44.95306095,55.04693905,Transportation,4,4
124976,6382,118594,5.106580463,94.89341954,Healthcare,2,2
12535,3186,9349,25.41683287,74.58316713,Housing,3,3
44812,3892,40920,8.685173614,91.31482639,Food,1,4
54750,15573,39177,28.44383562,71.55616438,Food,1,4
224870,38796,186074,17.25263486,82.74736514,Entertainment,0,0
22221,1902,20319,8.559470771,91.44052923,Housing,3,3
58551,28316,30235,48.36125771,51.63874229,Food,1,4
94664,54352,40312,57.41570185,42.58429815,Transportation,4,4
189756,31403,158353,16.54914733,83.45085267,Entertainment,0,0
114293,59560,54733,52.11167788,47.88832212,Transportation,4,4
45523,8535,36988,18.74876436,81.25123564,Food,1,1
40387,21113,19274,52.27672271,47.72327729,Food,1,1
22597,11857,10740,52.47156702,47.52843298,Housing,3,3
17301,5235,12066,30.25836657,69.74163343,Housing,3,3
198009,46444,151565,23.4554995,76.5445005,Entertainment,0,0
73345,441,72904,0.60126798,99.39873202,Transportation,4,4
34600,3687,30913,10.65606936,89.34393064,Food,1,1
79611,11420,68191,14.34475135,85.65524865,Transportation,4,4
90060,42838,47222,47.56606707,52.43393293,Transportation,4,4
79948,5481,74467,6.855706209,93.14429379,Transportation,4,4
84271,40517,43754,48.07941047,51.92058953,Transportation,4,4
133139,68951,64188,51.78873208,48.21126792,Healthcare,2,4
51382,1095,50287,2.131096493,97.86890351,Food,1,4
182952,19180,163772,10.48362412,89.51637588,Entertainment,0,0
40980,13832,27148,33.75305027,66.24694973,Food,1,1
198147,62935,135212,31.76177283,68.23822717,Entertainment,0,0
28529,8870,19659,31.09117039,68.90882961,Housing,3,1
50454,5777,44677,11.45003369,88.54996631,Food,1,4
28078,8653,19425,30.81772206,69.18227794,Housing,3,1
183344,34218,149126,18.66327777,81.33672223,Entertainment,0,0
161721,31633,130088,19.56023027,80.43976973,Healthcare,2,0
219546,47172,172374,21.4861578,78.5138422,Entertainment,0,0
47163,5095,42068,10.80295995,89.19704005,Food,1,4
104987,49831,55156,47.46397173,52.53602827,Transportation,4,4
173862,46884,126978,26.96621458,73.03378542,Healthcare,2,0
207833,30143,177690,14.50347154,85.49652846,Entertainment,0,0
133706,13523,120183,10.11398142,89.88601858,Healthcare,2,2
96916,4112,92804,4.242849478,95.75715052,Transportation,4,4
84122,15953,68169,18.96412353,81.03587647,Transportation,4,4
70743,40465,30278,57.20000565,42.79999435,Transportation,4,4
175298,31706,143592,18.08691485,81.91308515,Healthcare,2,0
31106,9371,21735,30.1260207,69.8739793,Food,1,1
23171,7127,16044,30.75827543,69.24172457,Housing,3,3
214620,21762,192858,10.13978194,89.86021806,Entertainment,0,0
37530,12654,24876,33.71702638,66.28297362,Food,1,1
74281,16848,57433,22.6814394,77.3185606,Transportation,4,4
27243,4436,22807,16.28308189,83.71691811,Housing,3,1
70681,11895,58786,16.82913371,83.17086629,Transportation,4,4
170401,15324,155077,8.992904971,91.00709503,Healthcare,2,0
23400,13038,10362,55.71794872,44.28205128,Housing,3,3
45636,8929,36707,19.56569375,80.43430625,Food,1,1
61064,28178,32886,46.14502817,53.85497183,Transportation,4,4
27713,7915,19798,28.56060333,71.43939667,Housing,3,1
63310,30843,32467,48.71742221,51.28257779,Transportation,4,4
220091,3187,216904,1.448037403,98.5519626,Entertainment,0,0
196484,49376,147108,25.12978156,74.87021844,Entertainment,0,0
201460,58892,142568,29.23260201,70.76739799,Entertainment,0,0
166291,68516,97775,41.20247037,58.79752963,Healthcare,2,0
11319,5662,5657,50.02208676,49.97791324,Housing,3,3
26103,3561,22542,13.6421101,86.3578899,Housing,3,1
11468,4478,6990,39.04778514,60.95221486,Housing,3,3
35238,16764,18474,47.57364209,52.42635791,Food,1,1
21398,12011,9387,56.13141415,43.86858585,Housing,3,3
59558,19841,39717,33.31374459,66.68625541,Food,1,4
81414,37081,44333,45.54622055,54.45377945,Transportation,4,4
106961,60788,46173,56.83192939,43.16807061,Transportation,4,4
17539,2548,14991,14.52762415,85.47237585,Housing,3,3
53106,12914,40192,24.31740293,75.68259707,Food,1,4
28678,2386,26292,8.319966525,91.68003348,Housing,3,1
46772,17097,29675,36.55392115,63.44607885,Food,1,1
131324,384,130940,0.292406567,99.70759343,Healthcare,2,2
110186,54622,55564,49.57254098,50.42745902,Transportation,4,4
19395,11034,8361,56.89095128,43.10904872,Housing,3,3
244388,19342,225046,7.914463885,92.08553611,Entertainment,0,0
177940,39351,138589,22.11475778,77.88524222,Healthcare,2,0
195131,6439,188692,3.29983447,96.70016553,Entertainment,0,0
168155,31689,136466,18.84511314,81.15488686,Healthcare,2,0
247755,13188,234567,5.323000545,94.67699946,Entertainment,0,0
217396,54687,162709,25.15547664,74.84452336,Entertainment,0,0
137566,22943,114623,16.67781283,83.32218717,Healthcare,2,2
19704,7206,12498,36.57125457,63.42874543,Housing,3,3
52858,14162,38696,26.7925385,73.2074615,Food,1,4
209593,30141,179452,14.38072836,85.61927164,Entertainment,0,0
35733,5355,30378,14.98614726,85.01385274,Food,1,1
50805,27356,23449,53.84509399,46.15490601,Food,1,4
125603,69714,55889,55.50345135,44.49654865,Healthcare,2,4
66286,28896,37390,43.59291555,56.40708445,Transportation,4,4
231756,18281,213475,7.888037419,92.11196258,Entertainment,0,0
48094,2345,45749,4.875868092,95.12413191,Food,1,4
13054,3668,9386,28.09866708,71.90133292,Housing,3,3
176184,63743,112441,36.17978931,63.82021069,Healthcare,2,0
96457,33114,63343,34.33032336,65.66967664,Transportation,4,4
176272,31531,144741,17.88769629,82.11230371,Healthcare,2,0
180195,44741,135454,24.8292128,75.1707872,Entertainment,0,0
38244,6158,32086,16.10187219,83.89812781,Food,1,1
21092,8713,12379,41.30950123,58.69049877,Housing,3,3
45189,3603,41586,7.973179314,92.02682069,Food,1,4
206982,58128,148854,28.08360147,71.91639853,Entertainment,0,0
144786,27154,117632,18.75457572,81.24542428,Healthcare,2,2
167784,42361,125423,25.24734182,74.75265818,Healthcare,2,0
241419,44750,196669,18.53623783,81.46376217,Entertainment,0,0
57161,8230,48931,14.39792866,85.60207134,Food,1,4
73876,31943,41933,43.2386702,56.7613298,Transportation,4,4
127494,43958,83536,34.47848526,65.52151474,Healthcare,2,2
39491,12183,27308,30.8500671,69.1499329,Food,1,1
171835,21454,150381,12.48523293,87.51476707,Healthcare,2,0
17264,1608,15656,9.314179796,90.6858202,Housing,3,3
102722,31487,71235,30.65263527,69.34736473,Transportation,4,2
28970,14248,14722,49.18191232,50.81808768,Housing,3,1
18929,2938,15991,15.52115801,84.47884199,Housing,3,3
218666,12819,205847,5.862365434,94.13763457,Entertainment,0,0
18442,10893,7549,59.06626179,40.93373821,Housing,3,3
119286,53563,65723,44.90300622,55.09699378,Transportation,4,4
218702,454,218248,0.207588408,99.79241159,Entertainment,0,0
158126,28813,129313,18.22154484,81.77845516,Healthcare,2,0
33093,19624,13469,59.29954975,40.70045025,Food,1,1
134384,68944,65440,51.30372663,48.69627337,Healthcare,2,4
111007,29352,81655,26.44157576,73.55842424,Transportation,4,2
14600,1721,12879,11.78767123,88.21232877,Housing,3,3
29490,8328,21162,28.24008138,71.75991862,Housing,3,1
215113,11175,203938,5.194944053,94.80505595,Entertainment,0,0
228355,43115,185240,18.88069015,81.11930985,Entertainment,0,0
217083,37316,179767,17.18973849,82.81026151,Entertainment,0,0
64507,7108,57399,11.01895918,88.98104082,Transportation,4,4
122648,458,122190,0.373426391,99.62657361,Healthcare,2,2
42437,3163,39274,7.453401513,92.54659849,Food,1,1
12341,3355,8986,27.18580342,72.81419658,Housing,3,3
64931,4539,60392,6.990497605,93.00950239,Transportation,4,4
34278,3888,30390,11.34255207,88.65744793,Food,1,1
33425,19340,14085,57.86088257,42.13911743,Food,1,1
179492,62941,116551,35.06618679,64.93381321,Healthcare,2,0
193059,31330,161729,16.22819967,83.77180033,Entertainment,0,0
26024,4317,21707,16.58853366,83.41146634,Housing,3,1
28204,7119,21085,25.24110055,74.75889945,Housing,3,1
45858,6597,39261,14.38571242,85.61428758,Food,1,1
20719,1787,18932,8.624933636,91.37506636,Housing,3,3
217355,23391,193964,10.7616572,89.2383428,Entertainment,0,0
68335,39930,28405,58.43272115,41.56727885,Transportation,4,4
42570,3442,39128,8.085506225,91.91449377,Food,1,1
28494,13188,15306,46.28342809,53.71657191,Housing,3,1
246654,40757,205897,16.52395664,83.47604336,Entertainment,0,0
19456,7502,11954,38.55879934,61.44120066,Housing,3,3
54437,28392,26045,52.15570292,47.84429708,Food,1,4
124984,19470,105514,15.57799398,84.42200602,Healthcare,2,2
49151,8167,40984,16.61614209,83.38385791,Food,1,4
225191,17539,207652,7.78849954,92.21150046,Entertainment,0,0
142411,40286,102125,28.28854513,71.71145487,Healthcare,2,2
26899,14116,12783,52.47778728,47.52221272,Housing,3,1
112019,51673,60346,46.12878172,53.87121828,Transportation,4,4
39781,8188,31593,20.58269023,79.41730977,Food,1,1
153872,17563,136309,11.41403244,88.58596756,Healthcare,2,0
118173,3797,114376,3.213085899,96.7869141,Transportation,4,2
50021,19713,30308,39.40944803,60.59055197,Food,1,4
26722,7949,18773,29.74702492,70.25297508,Housing,3,1
11505,6054,5451,52.62059974,47.37940026,Housing,3,3
61050,9036,52014,14.8009828,85.1990172,Transportation,4,4
56014,9128,46886,16.29592602,83.70407398,Food,1,4
146496,6094,140402,4.159840542,95.84015946,Healthcare,2,2
190678,52932,137746,27.7598884,72.2401116,Entertainment,0,0
71971,19200,52771,26.67741174,73.32258826,Transportation,4,4
20092,8313,11779,41.37467649,58.62532351,Housing,3,3
43733,25258,18475,57.75501338,42.24498662,Food,1,1
155261,52811,102450,34.01433715,65.98566285,Healthcare,2,0
74714,7466,67248,9.992772439,90.00722756,Transportation,4,4
220556,3659,216897,1.6589891,98.3410109,Entertainment,0,0
13892,6370,7522,45.85372876,54.14627124,Housing,3,3
165027,30793,134234,18.65937089,81.34062911,Healthcare,2,0
161774,42200,119574,26.08577398,73.91422602,Healthcare,2,0
21307,7459,13848,35.0072746,64.9927254,Housing,3,3
58378,8737,49641,14.96625441,85.03374559,Food,1,4
101057,46869,54188,46.37877633,53.62122367,Transportation,4,4
226851,46013,180838,20.2833578,79.7166422,Entertainment,0,0
170111,66799,103312,39.26788979,60.73211021,Healthcare,2,0
41621,24182,17439,58.10047812,41.89952188,Food,1,1
28478,16730,11748,58.74710303,41.25289697,Housing,3,1
141246,40745,100501,28.8468346,71.1531654,Healthcare,2,2
116195,21496,94699,18.49993545,81.50006455,Transportation,4,2
183514,1690,181824,0.920910666,99.07908933,Entertainment,0,0
35039,15709,19330,44.83290048,55.16709952,Food,1,1
119624,47841,71783,39.99281081,60.00718919,Transportation,4,2
174718,22057,152661,12.62434323,87.37565677,Healthcare,2,0
129370,22566,106804,17.44299297,82.55700703,Healthcare,2,2
163893,24035,139858,14.66505586,85.33494414,Healthcare,2,0
156647,69351,87296,44.27215331,55.72784669,Healthcare,2,0
178275,50030,128245,28.06338522,71.93661478,Healthcare,2,0
129694,9258,120436,7.138341018,92.86165898,Healthcare,2,2
18465,6154,12311,33.32791768,66.67208232,Housing,3,3
219866,50638,169228,23.03130088,76.96869912,Entertainment,0,0
129546,16548,112998,12.77384095,87.22615905,Healthcare,2,2
60958,16084,44874,26.3853801,73.6146199,Transportation,4,4
65274,38845,26429,59.51067806,40.48932194,Transportation,4,4
108472,37325,71147,34.40980161,65.59019839,Transportation,4,2
20921,4001,16920,19.12432484,80.87567516,Housing,3,3
159293,67159,92134,42.16067247,57.83932753,Healthcare,2,0
12915,7101,5814,54.9825784,45.0174216,Housing,3,3
215016,32813,182203,15.26072478,84.73927522,Entertainment,0,0
24337,10020,14317,41.17187821,58.82812179,Housing,3,3
205745,26717,179028,12.98549175,87.01450825,Entertainment,0,0
226597,64121,162476,28.29737375,71.70262625,Entertainment,0,0
141301,30003,111298,21.23339538,78.76660462,Healthcare,2,2
37177,19726,17451,53.05968744,46.94031256,Food,1,1
190351,32077,158274,16.85150065,83.14849935,Entertainment,0,0
110504,17441,93063,15.78313907,84.21686093,Transportation,4,2
70878,13855,57023,19.54767347,80.45232653,Transportation,4,4
56707,689,56018,1.215017546,98.78498245,Food,1,4
220511,64989,155522,29.47199913,70.52800087,Entertainment,0,0
23237,5821,17416,25.05056591,74.94943409,Housing,3,3
39498,16191,23307,40.99194896,59.00805104,Food,1,1
90699,47190,43509,52.02923957,47.97076043,Transportation,4,4
12397,329,12068,2.653867871,97.34613213,Housing,3,3
59863,15237,44626,25.45311795,74.54688205,Food,1,4
118531,68015,50516,57.38161325,42.61838675,Transportation,4,4
137410,6310,131100,4.592096645,95.40790335,Healthcare,2,2
97796,57119,40677,58.40627429,41.59372571,Transportation,4,4
175943,20873,155070,11.86350125,88.13649875,Healthcare,2,0
51968,25603,26365,49.26685653,50.73314347,Food,1,4
65460,6022,59438,9.199511152,90.80048885,Transportation,4,4
19343,9428,9915,48.74114667,51.25885333,Housing,3,3
113732,5773,107959,5.075968065,94.92403193,Transportation,4,2
73053,24159,48894,33.07051045,66.92948955,Transportation,4,4
157107,37856,119251,24.09568001,75.90431999,Healthcare,2,0
172070,61861,110209,35.95106643,64.04893357,Healthcare,2,0
199422,23305,176117,11.68627333,88.31372667,Entertainment,0,0
140532,43044,97488,30.62932286,69.37067714,Healthcare,2,2
131759,9851,121908,7.476529118,92.52347088,Healthcare,2,2
42648,19061,23587,44.69377228,55.30622772,Food,1,1
154965,52326,102639,33.76633433,66.23366567,Healthcare,2,0
26529,12948,13581,48.80696596,51.19303404,Housing,3,1
62631,8836,53795,14.10802957,85.89197043,Transportation,4,4
19135,7338,11797,38.34857591,61.65142409,Housing,3,3
69331,13050,56281,18.82274884,81.17725116,Transportation,4,4
121472,51214,70258,42.16115648,57.83884352,Healthcare,2,4
61243,32871,28372,53.67307284,46.32692716,Transportation,4,4
63945,13370,50575,20.90859332,79.09140668,Transportation,4,4
47828,20750,27078,43.38462825,56.61537175,Food,1,1
157550,5152,152398,3.270072993,96.72992701,Healthcare,2,0
169218,65746,103472,38.85284071,61.14715929,Healthcare,2,0
208078,8301,199777,3.989369371,96.01063063,Entertainment,0,0
214899,35311,179588,16.43143989,83.56856011,Entertainment,0,0
22677,2329,20348,10.27031794,89.72968206,Housing,3,3
14647,8470,6177,57.82754148,42.17245852,Housing,3,3
166543,66730,99813,40.06773026,59.93226974,Healthcare,2,0
169842,20280,149562,11.94050941,88.05949059,Healthcare,2,0
174921,13994,160927,8.00018294,91.99981706,Healthcare,2,0
56098,14311,41787,25.51071339,74.48928661,Food,1,4
189750,1055,188695,0.55599473,99.44400527,Entertainment,0,0
206079,2102,203977,1.019997186,98.98000281,Entertainment,0,0
116078,18220,97858,15.69634211,84.30365789,Transportation,4,2
34543,1014,33529,2.935471731,97.06452827,Food,1,1
112000,3940,108060,3.517857143,96.48214286,Transportation,4,2
13235,7432,5803,56.15413676,43.84586324,Housing,3,3
71789,4442,67347,6.187577484,93.81242252,Transportation,4,4
179911,66641,113270,37.04109254,62.95890746,Healthcare,2,0
165109,6179,158930,3.742376248,96.25762375,Healthcare,2,0
113319,22142,91177,19.53953,80.46047,Transportation,4,2
170320,9519,160801,5.588891498,94.4111085,Healthcare,2,0
226357,718,225639,0.317198054,99.68280195,Entertainment,0,0
45039,12680,32359,28.15337818,71.84662182,Food,1,1
20169,2000,18169,9.916208042,90.08379196,Housing,3,3
46098,3738,42360,8.108811662,91.89118834,Food,1,4
53412,6634,46778,12.42042987,87.57957013,Food,1,4
17495,6909,10586,39.49128322,60.50871678,Housing,3,3
174621,42888,131733,24.56061986,75.43938014,Healthcare,2,0
24501,9056,15445,36.96175666,63.03824334,Housing,3,3
131121,49105,82016,37.45014147,62.54985853,Healthcare,2,2
136535,66309,70226,48.56556927,51.43443073,Healthcare,2,4
178957,3477,175480,1.942924837,98.05707516,Healthcare,2,0
113313,10826,102487,9.554067053,90.44593295,Transportation,4,2
115074,4633,110441,4.026104941,95.97389506,Transportation,4,2
87092,12356,74736,14.18729619,85.81270381,Transportation,4,4
34938,1198,33740,3.42893125,96.57106875,Food,1,1
17990,3439,14551,19.11617565,80.88382435,Housing,3,3
237075,3286,233789,1.386059264,98.61394074,Entertainment,0,0
52561,2697,49864,5.131180914,94.86881909,Food,1,4
31863,18215,13648,57.16661959,42.83338041,Food,1,1
173258,6666,166592,3.847441388,96.15255861,Healthcare,2,0
110806,18126,92680,16.35831995,83.64168005,Transportation,4,2
202416,58053,144363,28.68004506,71.31995494,Entertainment,0,0
156703,65223,91480,41.62204935,58.37795065,Healthcare,2,0
162217,36875,125342,22.73189616,77.26810384,Healthcare,2,0
94260,1312,92948,1.391894759,98.60810524,Transportation,4,4
93421,18305,75116,19.59409555,80.40590445,Transportation,4,4
29958,9528,20430,31.80452634,68.19547366,Housing,3,1
78095,17552,60543,22.47519047,77.52480953,Transportation,4,4
122867,7376,115491,6.003239275,93.99676073,Healthcare,2,2
181303,4775,176528,2.633712625,97.36628738,Entertainment,0,0
217772,2134,215638,0.979923957,99.02007604,Entertainment,0,0
43642,3421,40221,7.838779158,92.16122084,Food,1,1
53473,9378,44095,17.53782283,82.46217717,Food,1,4
166655,43097,123558,25.8600102,74.1399898,Healthcare,2,0
22788,7250,15538,31.81499035,68.18500965,Housing,3,3
124537,19382,105155,15.56324626,84.43675374,Healthcare,2,2
218891,30646,188245,14.00057563,85.99942437,Entertainment,0,0
42706,7109,35597,16.64637288,83.35362712,Food,1,1
178683,61095,117588,34.19183694,65.80816306,Healthcare,2,0
30546,16702,13844,54.67819027,45.32180973,Food,1,1
176138,4066,172072,2.308417264,97.69158274,Healthcare,2,0
171542,60165,111377,35.07304334,64.92695666,Healthcare,2,0
140845,57123,83722,40.55735028,59.44264972,Healthcare,2,2
102378,10663,91715,10.4153236,89.5846764,Transportation,4,2
10282,4713,5569,45.83738572,54.16261428,Housing,3,3
246774,9801,236973,3.971650174,96.02834983,Entertainment,0,0
116321,10956,105365,9.418763594,90.58123641,Transportation,4,2
95410,46601,48809,48.84288859,51.15711141,Transportation,4,4
208425,8798,199627,4.22118268,95.77881732,Entertainment,0,0
235476,62614,172862,26.59039562,73.40960438,Entertainment,0,0
14879,5940,8939,39.92203777,60.07796223,Housing,3,3
24442,13778,10664,56.37018247,43.62981753,Housing,3,3
143758,56725,87033,39.4586736,60.5413264,Healthcare,2,2
17780,6353,11427,35.73115861,64.26884139,Housing,3,3
122009,63426,58583,51.98468965,48.01531035,Healthcare,2,4
116332,5672,110660,4.875700581,95.12429942,Transportation,4,2
100202,39438,60764,39.35849584,60.64150416,Transportation,4,4
45958,1353,44605,2.943992341,97.05600766,Food,1,4
102848,4180,98668,4.064250156,95.93574984,Transportation,4,2
146346,69387,76959,47.4129802,52.5870198,Healthcare,2,2
200083,42447,157636,21.2146959,78.7853041,Entertainment,0,0
14472,4556,9916,31.48148148,68.51851852,Housing,3,3
153851,46100,107751,29.96405613,70.03594387,Healthcare,2,0
243856,6744,237112,2.765566564,97.23443344,Entertainment,0,0
158996,45893,113103,28.86424816,71.13575184,Healthcare,2,0
11506,5147,6359,44.73318269,55.26681731,Housing,3,3
236234,15852,220382,6.710295724,93.28970428,Entertainment,0,0
119612,22444,97168,18.76400361,81.23599639,Transportation,4,2
150740,3521,147219,2.335810004,97.66419,Healthcare,2,0
15143,7760,7383,51.24479958,48.75520042,Housing,3,3
23535,7096,16439,30.15083918,69.84916082,Housing,3,3
67951,14933,53018,21.97612986,78.02387014,Transportation,4,4
45430,7368,38062,16.21835791,83.78164209,Food,1,1
245693,11767,233926,4.789310237,95.21068976,Entertainment,0,0
25866,14672,11194,56.72311142,43.27688858,Housing,3,1
217592,57840,159752,26.58185963,73.41814037,Entertainment,0,0
42208,14580,27628,34.54321456,65.45678544,Food,1,1
29966,15767,14199,52.61629847,47.38370153,Housing,3,1
35525,11196,24329,31.51583392,68.48416608,Food,1,1
16139,4636,11503,28.72544767,71.27455233,Housing,3,3
138287,39886,98401,28.84291365,71.15708635,Healthcare,2,2
89915,29634,60281,32.95779347,67.04220653,Transportation,4,4
219258,51282,167976,23.38888433,76.61111567,Entertainment,0,0
181141,24317,156824,13.42434899,86.57565101,Entertainment,0,0
174066,1439,172627,0.826697919,99.17330208,Healthcare,2,0
139526,66932,72594,47.97098749,52.02901251,Healthcare,2,2
78785,1815,76970,2.303738021,97.69626198,Transportation,4,4
186486,25037,161449,13.4256727,86.5743273,Entertainment,0,0
52713,21738,30975,41.23840419,58.76159581,Food,1,4
206344,36988,169356,17.92540612,82.07459388,Entertainment,0,0
135003,6494,128509,4.810263476,95.18973652,Healthcare,2,2
25355,4592,20763,18.11082627,81.88917373,Housing,3,1
140612,32695,107917,23.25192729,76.74807271,Healthcare,2,2
248984,13591,235393,5.458583684,94.54141632,Entertainment,0,0
206270,38582,167688,18.70461046,81.29538954,Entertainment,0,0
24676,12357,12319,50.07699789,49.92300211,Housing,3,3
47509,26007,21502,54.74120693,45.25879307,Food,1,1
176964,22167,154797,12.52627653,87.47372347,Healthcare,2,0
101404,18130,83274,17.87897913,82.12102087,Transportation,4,2
201295,51739,149556,25.7030726,74.2969274,Entertainment,0,0
155078,61876,93202,39.89992133,60.10007867,Healthcare,2,0
56737,19670,37067,34.66873469,65.33126531,Food,1,4
139308,4473,134835,3.210870876,96.78912912,Healthcare,2,2
210327,43630,166697,20.74388928,79.25611072,Entertainment,0,0
146922,5879,141043,4.001442943,95.99855706,Healthcare,2,2
144212,29272,114940,20.29789477,79.70210523,Healthcare,2,2
156358,40280,116078,25.76139372,74.23860628,Healthcare,2,0
16934,2961,13973,17.48553207,82.51446793,Housing,3,3
87765,28940,58825,32.97442033,67.02557967,Transportation,4,4
154052,53955,100097,35.02388804,64.97611196,Healthcare,2,0
78067,30263,47804,38.76541945,61.23458055,Transportation,4,4
10389,3891,6498,37.45307537,62.54692463,Housing,3,3
45952,22023,23929,47.9260968,52.0739032,Food,1,1
64611,20319,44292,31.44820541,68.55179459,Transportation,4,4
215460,60413,155047,28.03907918,71.96092082,Entertainment,0,0
96779,23750,73029,24.54044782,75.45955218,Transportation,4,4
199055,36414,162641,18.29343649,81.70656351,Entertainment,0,0
15857,3560,12297,22.45065271,77.54934729,Housing,3,3
212565,14159,198406,6.661021335,93.33897867,Entertainment,0,0
162911,44185,118726,27.122171,72.877829,Healthcare,2,0
159935,31152,128783,19.4779129,80.5220871,Healthcare,2,0
163207,31225,131982,19.13214507,80.86785493,Healthcare,2,0
88297,18184,70113,20.59413117,79.40586883,Transportation,4,4
148625,45092,103533,30.33944491,69.66055509,Healthcare,2,2
123778,58161,65617,46.98815622,53.01184378,Healthcare,2,4
144771,55000,89771,37.99103412,62.00896588,Healthcare,2,2
93556,38077,55479,40.69968789,59.30031211,Transportation,4,4
102965,52706,50259,51.18826786,48.81173214,Transportation,4,4
167691,29613,138078,17.65926615,82.34073385,Healthcare,2,0
75969,2193,73776,2.886703787,97.11329621,Transportation,4,4
249686,4454,245232,1.783840504,98.2161595,Entertainment,0,0
94606,17091,77515,18.06545039,81.93454961,Transportation,4,4
165203,25917,139286,15.68797177,84.31202823,Healthcare,2,0
42484,4697,37787,11.05592694,88.94407306,Food,1,1
202117,3439,198678,1.701489731,98.29851027,Entertainment,0,0
40670,10068,30602,24.75534792,75.24465208,Food,1,1
18110,1496,16614,8.260629486,91.73937051,Housing,3,3
14470,886,13584,6.123013131,93.87698687,Housing,3,3
37045,13758,23287,37.1386152,62.8613848,Food,1,1
88640,47226,41414,53.2784296,46.7215704,Transportation,4,4
91057,6703,84354,7.361323127,92.63867687,Transportation,4,4
37770,14449,23321,38.25522902,61.74477098,Food,1,1
212722,6754,205968,3.175035962,96.82496404,Entertainment,0,0
147234,68260,78974,46.36157409,53.63842591,Healthcare,2,2
42642,4965,37677,11.64345012,88.35654988,Food,1,1
30165,1574,28591,5.217967844,94.78203216,Food,1,1
25692,6808,18884,26.49852094,73.50147906,Housing,3,1
20497,816,19681,3.981070401,96.0189296,Housing,3,3
132987,15598,117389,11.72896599,88.27103401,Healthcare,2,2
155017,67726,87291,43.68940181,56.31059819,Healthcare,2,0
36629,14088,22541,38.46132846,61.53867154,Food,1,1
20258,6980,13278,34.45552374,65.54447626,Housing,3,3
16535,1197,15338,7.239189598,92.7608104,Housing,3,3
193001,25569,167432,13.24811789,86.75188211,Entertainment,0,0
77617,27531,50086,35.47032222,64.52967778,Transportation,4,4
35185,9820,25365,27.90962058,72.09037942,Food,1,1
235750,25625,210125,10.86956522,89.13043478,Entertainment,0,0
132549,51692,80857,38.99840814,61.00159186,Healthcare,2,2
80889,4487,76402,5.547107765,94.45289224,Transportation,4,4
166229,54582,111647,32.83542583,67.16457417,Healthcare,2,0
144820,52552,92268,36.28780555,63.71219445,Healthcare,2,2
10094,2831,7263,28.04636418,71.95363582,Housing,3,3
89076,45899,43177,51.52790875,48.47209125,Transportation,4,4
47886,18732,29154,39.11790502,60.88209498,Food,1,1
73795,43721,30074,59.24656142,40.75343858,Transportation,4,4
219687,46914,172773,21.35492769,78.64507231,Entertainment,0,0
85051,44076,40975,51.82302383,48.17697617,Transportation,4,4
24929,12693,12236,50.91660315,49.08339685,Housing,3,3
244265,55541,188724,22.73800995,77.26199005,Entertainment,0,0
246455,30154,216301,12.23509363,87.76490637,Entertainment,0,0
113289,37843,75446,33.40394919,66.59605081,Transportation,4,2
39604,1297,38307,3.274921725,96.72507827,Food,1,1
28802,1663,27139,5.77390459,94.22609541,Housing,3,1
19958,11551,8407,57.87654074,42.12345926,Housing,3,3
18108,3834,14274,21.17296223,78.82703777,Housing,3,3
199581,59275,140306,29.69972092,70.30027908,Entertainment,0,0
16916,3370,13546,19.92196737,80.07803263,Housing,3,3
30117,15605,14512,51.81458977,48.18541023,Food,1,1
13118,4036,9082,30.7668852,69.2331148,Housing,3,3
14134,6781,7353,47.97651054,52.02348946,Housing,3,3
44704,3772,40932,8.437723694,91.56227631,Food,1,4
241631,23345,218286,9.661425893,90.33857411,Entertainment,0,0
24247,10039,14208,41.40306017,58.59693983,Housing,3,3
225512,3491,222021,1.548032921,98.45196708,Entertainment,0,0
176886,49420,127466,27.9388985,72.0611015,Healthcare,2,0
236284,68623,167661,29.04259281,70.95740719,Entertainment,0,0
24480,6322,18158,25.8251634,74.1748366,Housing,3,3
245100,67553,177547,27.56140351,72.43859649,Entertainment,0,0
43076,7756,35320,18.00538583,81.99461417,Food,1,1
175749,26923,148826,15.31900608,84.68099392,Healthcare,2,0
72387,23673,48714,32.70338597,67.29661403,Transportation,4,4
27278,1669,25609,6.11848376,93.88151624,Housing,3,1
20281,11662,8619,57.50209556,42.49790444,Housing,3,3
14973,7245,7728,48.38709677,51.61290323,Housing,3,3
94908,41582,53326,43.8129557,56.1870443,Transportation,4,4
78287,7012,71275,8.956787206,91.04321279,Transportation,4,4
55007,668,54339,1.214390896,98.7856091,Food,1,4
126983,33168,93815,26.12003182,73.87996818,Healthcare,2,2
242321,23578,218743,9.730068793,90.26993121,Entertainment,0,0
43895,8575,35320,19.53525458,80.46474542,Food,1,1
116716,14176,102540,12.14572124,87.85427876,Transportation,4,2
121012,25587,95425,21.14418405,78.85581595,Healthcare,2,2
17501,9281,8220,53.03125536,46.96874464,Housing,3,3
27576,3358,24218,12.17725558,87.82274442,Housing,3,1
51285,16504,34781,32.1809496,67.8190504,Food,1,4
172614,13291,159323,7.699838947,92.30016105,Healthcare,2,0
15571,2741,12830,17.60323679,82.39676321,Housing,3,3
30125,3361,26764,11.15684647,88.84315353,Food,1,1
104048,9303,94745,8.941065662,91.05893434,Transportation,4,2
80815,27228,53587,33.69176514,66.30823486,Transportation,4,4
46326,513,45813,1.107369512,98.89263049,Food,1,4
172379,59852,112527,34.72116673,65.27883327,Healthcare,2,0
46488,22297,24191,47.96291516,52.03708484,Food,1,1
30555,18186,12369,59.51890034,40.48109966,Food,1,1
192541,57793,134748,30.01594466,69.98405534,Entertainment,0,0
110774,40411,70363,36.48058209,63.51941791,Transportation,4,2
169485,45510,123975,26.8519338,73.1480662,Healthcare,2,0
57254,8043,49211,14.04792678,85.95207322,Food,1,4
16428,3166,13262,19.27197468,80.72802532,Housing,3,3
59084,31701,27383,53.65411956,46.34588044,Food,1,4
16563,7243,9320,43.7300006,56.2699994,Housing,3,3
27041,9575,17466,35.40919345,64.59080655,Housing,3,1
224134,26601,197533,11.86834661,88.13165339,Entertainment,0,0
96044,34213,61831,35.62221482,64.37778518,Transportation,4,4
155772,64737,91035,41.55881673,58.44118327,Healthcare,2,0
33823,15145,18678,44.7772226,55.2227774,Food,1,1
100538,24289,76249,24.15902445,75.84097555,Transportation,4,2
208973,23891,185082,11.43257741,88.56742259,Entertainment,0,0
38468,16402,22066,42.63803681,57.36196319,Food,1,1
15879,1230,14649,7.746079728,92.25392027,Housing,3,3
105695,41018,64677,38.80789063,61.19210937,Transportation,4,4
249904,54005,195899,21.61029835,78.38970165,Entertainment,0,0
156819,7626,149193,4.86293115,95.13706885,Healthcare,2,0
245714,59169,186545,24.08043498,75.91956502,Entertainment,0,0
24257,4642,19615,19.13674403,80.86325597,Housing,3,3
122861,11248,111613,9.155061411,90.84493859,Healthcare,2,2
221411,60018,161393,27.1070543,72.8929457,Entertainment,0,0
96903,20661,76242,21.32132132,78.67867868,Transportation,4,4
29597,3598,25999,12.1566375,87.8433625,Housing,3,1
88529,34739,53790,39.24024896,60.75975104,Transportation,4,4
174999,5129,169870,2.930873891,97.06912611,Healthcare,2,0
14872,3931,10941,26.43222162,73.56777838,Housing,3,3
49158,20540,28618,41.78363644,58.21636356,Food,1,1
29218,10285,18933,35.20090355,64.79909645,Housing,3,1
53294,8432,44862,15.82166848,84.17833152,Food,1,4
117446,53418,64028,45.4830305,54.5169695,Transportation,4,4
18081,341,17740,1.885957635,98.11404236,Housing,3,3
210727,22147,188580,10.50980653,89.49019347,Entertainment,0,0
14401,2329,12072,16.17248802,83.82751198,Housing,3,3
214065,67691,146374,31.62170369,68.37829631,Entertainment,0,0
133615,25982,107633,19.44542155,80.55457845,Healthcare,2,2
28545,282,28263,0.98791382,99.01208618,Housing,3,1
242556,7761,234795,3.199673477,96.80032652,Entertainment,0,0
162088,49490,112598,30.532797,69.467203,Healthcare,2,0
105370,57925,47445,54.97295245,45.02704755,Transportation,4,4
59831,9726,50105,16.25578713,83.74421287,Food,1,4
22255,7790,14465,35.00337003,64.99662997,Housing,3,3
52954,19184,33770,36.2276693,63.7723307,Food,1,4
19888,7248,12640,36.44408689,63.55591311,Housing,3,3
227388,45582,181806,20.04591271,79.95408729,Entertainment,0,0
239960,368,239592,0.153358893,99.84664111,Entertainment,0,0
168032,17529,150503,10.43194153,89.56805847,Healthcare,2,0
10851,5851,5000,53.92129758,46.07870242,Housing,3,3
125910,21259,104651,16.88428242,83.11571758,Healthcare,2,2
47291,6616,40675,13.98997695,86.01002305,Food,1,4
10109,2466,7643,24.39410426,75.60589574,Housing,3,3
19846,4162,15684,20.9714804,79.0285196,Housing,3,3
228770,64248,164522,28.08410194,71.91589806,Entertainment,0,0
76810,16140,60670,21.01288895,78.98711105,Transportation,4,4
56087,3694,52393,6.586196445,93.41380356,Food,1,4
45712,8601,37111,18.81562828,81.18437172,Food,1,1
218234,56854,161380,26.0518526,73.9481474,Entertainment,0,0
124727,14752,109975,11.82743111,88.17256889,Healthcare,2,2
87156,42985,44171,49.31961081,50.68038919,Transportation,4,4
29076,5214,23862,17.93231531,82.06768469,Housing,3,1
102800,7356,95444,7.155642023,92.84435798,Transportation,4,2
216812,14644,202168,6.754238695,93.2457613,Entertainment,0,0
118817,34584,84233,29.10694598,70.89305402,Transportation,4,2
50999,23592,27407,46.25973058,53.74026942,Food,1,4
243315,27458,215857,11.28495983,88.71504017,Entertainment,0,0
148009,54921,93088,37.10652731,62.89347269,Healthcare,2,2
143790,23569,120221,16.39126504,83.60873496,Healthcare,2,2
23082,7686,15396,33.29867429,66.70132571,Housing,3,3
187671,6774,180897,3.609508129,96.39049187,Entertainment,0,0
41388,12305,29083,29.73083986,70.26916014,Food,1,1
68740,35682,33058,51.90864126,48.09135874,Transportation,4,4
82644,45784,36860,55.39906103,44.60093897,Transportation,4,4
192349,7810,184539,4.060327842,95.93967216,Entertainment,0,0
67349,8090,59259,12.0120566,87.9879434,Transportation,4,4
203315,61790,141525,30.39126479,69.60873521,Entertainment,0,0
234573,56524,178049,24.0965499,75.9034501,Entertainment,0,0
43849,18992,24857,43.31227622,56.68772378,Food,1,1
125344,21012,104332,16.76346694,83.23653306,Healthcare,2,2
36920,6612,30308,17.90899242,82.09100758,Food,1,1
213656,27449,186207,12.84728723,87.15271277,Entertainment,0,0
19920,6551,13369,32.88654618,67.11345382,Housing,3,3
70221,35922,34299,51.1556372,48.8443628,Transportation,4,4
150550,15078,135472,10.01527732,89.98472268,Healthcare,2,0
182191,65443,116748,35.91999605,64.08000395,Entertainment,0,0
141031,41728,99303,29.58782112,70.41217888,Healthcare,2,2
180644,16808,163836,9.304488386,90.69551161,Entertainment,0,0
64870,5699,59171,8.785262833,91.21473717,Transportation,4,4
66754,21048,45706,31.53069479,68.46930521,Transportation,4,4
223966,14935,209031,6.668422886,93.33157711,Entertainment,0,0
57958,9126,48832,15.74588495,84.25411505,Food,1,4
29699,15232,14467,51.28792215,48.71207785,Housing,3,1
248767,45639,203128,18.34608288,81.65391712,Entertainment,0,0
237825,10666,227159,4.48481026,95.51518974,Entertainment,0,0
129221,68683,60538,53.15157753,46.84842247,Healthcare,2,4
52511,26943,25568,51.30924949,48.69075051,Food,1,4
147099,55228,91871,37.54478277,62.45521723,Healthcare,2,2
57646,18090,39556,31.38118863,68.61881137,Food,1,4
184239,53527,130712,29.05302352,70.94697648,Entertainment,0,0
72189,3885,68304,5.381706354,94.61829365,Transportation,4,4
21590,4773,16817,22.10745716,77.89254284,Housing,3,3
13188,4583,8605,34.75128905,65.24871095,Housing,3,3
135884,11827,124057,8.703747314,91.29625269,Healthcare,2,2
113996,7434,106562,6.521281448,93.47871855,Transportation,4,2
110138,61195,48943,55.56211299,44.43788701,Transportation,4,4
28651,7075,21576,24.69372797,75.30627203,Housing,3,1
24397,1158,23239,4.746485224,95.25351478,Housing,3,3
21711,8942,12769,41.18649532,58.81350468,Housing,3,3
27484,16170,11314,58.83423083,41.16576917,Housing,3,1
13393,2567,10826,19.16672889,80.83327111,Housing,3,3
85263,935,84328,1.096606969,98.90339303,Transportation,4,4
29337,16856,12481,57.45645431,42.54354569,Housing,3,1
74978,20333,54645,27.11862146,72.88137854,Transportation,4,4
71491,27400,44091,38.32650264,61.67349736,Transportation,4,4
239575,23266,216309,9.711363874,90.28863613,Entertainment,0,0
48010,26476,21534,55.14684441,44.85315559,Food,1,1
127803,20258,107545,15.85095812,84.14904188,Healthcare,2,2
136157,69764,66393,51.23790918,48.76209082,Healthcare,2,4
128172,29956,98216,23.37171925,76.62828075,Healthcare,2,2
63312,8735,54577,13.79675259,86.20324741,Transportation,4,4
139809,5323,134486,3.807337153,96.19266285,Healthcare,2,2
32811,14798,18013,45.10072841,54.89927159,Food,1,1
107968,18189,89779,16.84665827,83.15334173,Transportation,4,2
39739,23516,16223,59.17612421,40.82387579,Food,1,1
18978,3968,15010,20.90842028,79.09157972,Housing,3,3
33276,16895,16381,50.7723284,49.2276716,Food,1,1
46532,27430,19102,58.94868048,41.05131952,Food,1,1
24551,5805,18746,23.64465806,76.35534194,Housing,3,3
173252,9650,163602,5.569921271,94.43007873,Healthcare,2,0
177398,4412,172986,2.487062988,97.51293701,Healthcare,2,0
243506,9202,234304,3.778962325,96.22103767,Entertainment,0,0
42224,17296,24928,40.96248579,59.03751421,Food,1,1
145415,32950,112465,22.65928549,77.34071451,Healthcare,2,2
79494,23148,56346,29.11917881,70.88082119,Transportation,4,4
45235,15390,29845,34.02232784,65.97767216,Food,1,1
28578,12542,16036,43.88690601,56.11309399,Housing,3,1
50475,12453,38022,24.67161961,75.32838039,Food,1,4
114876,66180,48696,57.60994464,42.39005536,Transportation,4,4
122418,37765,84653,30.84922152,69.15077848,Healthcare,2,2
245271,23708,221563,9.666042867,90.33395713,Entertainment,0,0
156694,11405,145289,7.278517365,92.72148263,Healthcare,2,0
177556,25679,151877,14.46247944,85.53752056,Healthcare,2,0
99066,54228,44838,54.73926473,45.26073527,Transportation,4,4
173934,17495,156439,10.05841296,89.94158704,Healthcare,2,0
220409,38288,182121,17.37134146,82.62865854,Entertainment,0,0
31231,18465,12766,59.12394736,40.87605264,Food,1,1
142727,15790,126937,11.06307846,88.93692154,Healthcare,2,2
131240,24875,106365,18.95382505,81.04617495,Healthcare,2,2
22154,7772,14382,35.08170082,64.91829918,Housing,3,3
233881,50517,183364,21.59944587,78.40055413,Entertainment,0,0
14864,8120,6744,54.62863294,45.37136706,Housing,3,3
94599,16755,77844,17.71160372,82.28839628,Transportation,4,4
80496,43293,37203,53.78279666,46.21720334,Transportation,4,4
21490,458,21032,2.131223825,97.86877617,Housing,3,3
67801,36827,30974,54.31630802,45.68369198,Transportation,4,4
41932,19746,22186,47.09052752,52.90947248,Food,1,1
231805,26069,205736,11.24609046,88.75390954,Entertainment,0,0
84530,3307,81223,3.912220513,96.08777949,Transportation,4,4
69564,26225,43339,37.69909723,62.30090277,Transportation,4,4
85727,2918,82809,3.403828432,96.59617157,Transportation,4,4
49422,862,48560,1.744162519,98.25583748,Food,1,4
38453,15544,22909,40.42337399,59.57662601,Food,1,1
180512,15891,164621,8.803292856,91.19670714,Entertainment,0,0
135556,57108,78448,42.12871433,57.87128567,Healthcare,2,2
77079,13863,63216,17.98544351,82.01455649,Transportation,4,4
39417,11089,28328,28.13253165,71.86746835,Food,1,1
20843,10124,10719,48.57266228,51.42733772,Housing,3,3
244626,42846,201780,17.5149003,82.4850997,Entertainment,0,0
26563,4650,21913,17.50555284,82.49444716,Housing,3,1
200116,46777,153339,23.37494253,76.62505747,Entertainment,0,0
117499,17034,100465,14.49714466,85.50285534,Transportation,4,2
217802,64925,152877,29.80918449,70.19081551,Entertainment,0,0
45837,3148,42689,6.867814211,93.13218579,Food,1,4
38055,3886,34169,10.21153593,89.78846407,Food,1,1
238050,68186,169864,28.64356228,71.35643772,Entertainment,0,0
142777,25841,116936,18.09885346,81.90114654,Healthcare,2,2
20369,5981,14388,29.36324807,70.63675193,Housing,3,3
222872,18738,204134,8.407516422,91.59248358,Entertainment,0,0
221582,13840,207742,6.245994711,93.75400529,Entertainment,0,0
60529,28560,31969,47.18399445,52.81600555,Transportation,4,4
93786,4946,88840,5.273708229,94.72629177,Transportation,4,4
175785,36103,139682,20.53815741,79.46184259,Healthcare,2,0
98117,52171,45946,53.17223315,46.82776685,Transportation,4,4
213630,67916,145714,31.79141506,68.20858494,Entertainment,0,0
31760,15433,16327,48.59256927,51.40743073,Food,1,1
47597,25571,22026,53.7239742,46.2760258,Food,1,1
104581,2134,102447,2.040523613,97.95947639,Transportation,4,2
45732,23646,22086,51.70558908,48.29441092,Food,1,1
196060,40345,155715,20.57788432,79.42211568,Entertainment,0,0
163808,1251,162557,0.763698965,99.23630104,Healthcare,2,0
175276,9276,166000,5.292224834,94.70777517,Healthcare,2,0
166865,11581,155284,6.940340994,93.05965901,Healthcare,2,0
96790,53638,43152,55.41688191,44.58311809,Transportation,4,4
232652,51284,181368,22.04322336,77.95677664,Entertainment,0,0
171472,6335,165137,3.694480732,96.30551927,Healthcare,2,0
18106,1080,17026,5.964873523,94.03512648,Housing,3,3
243455,54577,188878,22.41769526,77.58230474,Entertainment,0,0
110474,10280,100194,9.305356917,90.69464308,Transportation,4,2
76543,1591,74952,2.078570215,97.92142978,Transportation,4,4
40712,8935,31777,21.94684614,78.05315386,Food,1,1
11902,3599,8303,30.23861536,69.76138464,Housing,3,3
17832,6787,11045,38.06078959,61.93921041,Housing,3,3
67150,25304,41846,37.6827997,62.3172003,Transportation,4,4
176737,67702,109035,38.30663641,61.69336359,Healthcare,2,0
123967,52322,71645,42.20639364,57.79360636,Healthcare,2,2
152776,34325,118451,22.46753417,77.53246583,Healthcare,2,0
222803,46544,176259,20.89020345,79.10979655,Entertainment,0,0
32068,71,31997,0.221404515,99.77859548,Food,1,1
188834,39115,149719,20.71396041,79.28603959,Entertainment,0,0
35172,9226,25946,26.23109291,73.76890709,Food,1,1
106165,7833,98332,7.378137804,92.6218622,Transportation,4,2
155882,43816,112066,28.108441,71.891559,Healthcare,2,0
56267,2044,54223,3.632679901,96.3673201,Food,1,4
68869,32339,36530,46.95726669,53.04273331,Transportation,4,4
38288,17210,21078,44.94880903,55.05119097,Food,1,1
134303,7691,126612,5.726603278,94.27339672,Healthcare,2,2
78380,37033,41347,47.24802245,52.75197755,Transportation,4,4
10717,560,10157,5.225342913,94.77465709,Housing,3,3
31586,17286,14300,54.72677769,45.27322231,Food,1,1
134160,61427,72733,45.78637448,54.21362552,Healthcare,2,2
160652,1564,159088,0.973532854,99.02646715,Healthcare,2,0
14727,4234,10493,28.74991512,71.25008488,Housing,3,3
38024,14907,23117,39.20418683,60.79581317,Food,1,1
37760,3433,34327,9.091631356,90.90836864,Food,1,1
178972,21199,157773,11.84486959,88.15513041,Healthcare,2,0
42291,13633,28658,32.23617318,67.76382682,Food,1,1
37039,19562,17477,52.81460083,47.18539917,Food,1,1
68287,10343,57944,15.14636754,84.85363246,Transportation,4,4
85076,39509,45567,46.43965396,53.56034604,Transportation,4,4
18020,584,17436,3.240843507,96.75915649,Housing,3,3
135267,27379,107888,20.24070912,79.75929088,Healthcare,2,2
30199,4737,25462,15.68594987,84.31405013,Food,1,1
85501,9119,76382,10.66537233,89.33462767,Transportation,4,4
51836,21869,29967,42.1888263,57.8111737,Food,1,4
242558,43088,199470,17.76399871,82.23600129,Entertainment,0,0
171160,26949,144211,15.74491704,84.25508296,Healthcare,2,0
82589,35091,47498,42.48870915,57.51129085,Transportation,4,4
17447,5146,12301,29.49504213,70.50495787,Housing,3,3
82761,10152,72609,12.26664733,87.73335267,Transportation,4,4
26104,11844,14260,45.37235673,54.62764327,Housing,3,1
51285,17593,33692,34.3043775,65.6956225,Food,1,4
18936,6962,11974,36.76594846,63.23405154,Housing,3,3
17524,1481,16043,8.451266834,91.54873317,Housing,3,3
48503,4876,43627,10.05298641,89.94701359,Food,1,4
232905,14603,218302,6.269938387,93.73006161,Entertainment,0,0
27056,4050,23006,14.96895328,85.03104672,Housing,3,1
70530,1469,69061,2.082801645,97.91719836,Transportation,4,4
81648,34140,47508,41.81363904,58.18636096,Transportation,4,4
15873,6270,9603,39.5010395,60.4989605,Housing,3,3
77842,14628,63214,18.79191182,81.20808818,Transportation,4,4
107188,63420,43768,59.16707094,40.83292906,Transportation,4,4
35375,7363,28012,20.81413428,79.18586572,Food,1,1
42101,10863,31238,25.80223748,74.19776252,Food,1,1
67039,8451,58588,12.60609496,87.39390504,Transportation,4,4
51411,8724,42687,16.96913112,83.03086888,Food,1,4
178364,50674,127690,28.41044157,71.58955843,Healthcare,2,0
82397,26979,55418,32.74269694,67.25730306,Transportation,4,4
141256,5712,135544,4.043722037,95.95627796,Healthcare,2,2
111416,55225,56191,49.56648955,50.43351045,Transportation,4,4
117235,69851,47384,59.58203608,40.41796392,Transportation,4,4
219988,4775,215213,2.17057294,97.82942706,Entertainment,0,0
38862,11978,26884,30.82188256,69.17811744,Food,1,1
18367,1403,16964,7.638699842,92.36130016,Housing,3,3
219756,57890,161866,26.34285298,73.65714702,Entertainment,0,0
14635,7452,7183,50.91902972,49.08097028,Housing,3,3
10855,4712,6143,43.40856748,56.59143252,Housing,3,3
43908,4994,38914,11.37378154,88.62621846,Food,1,1
53446,11418,42028,21.36361935,78.63638065,Food,1,4
123085,23125,99960,18.78782955,81.21217045,Healthcare,2,2
74337,32762,41575,44.07226549,55.92773451,Transportation,4,4
232466,1469,230997,0.631920367,99.36807963,Entertainment,0,0
115220,43861,71359,38.06717584,61.93282416,Transportation,4,2
96283,51234,45049,53.2118858,46.7881142,Transportation,4,4
167848,21633,146215,12.88844669,87.11155331,Healthcare,2,0
227142,61508,165634,27.0790959,72.9209041,Entertainment,0,0
103842,10123,93719,9.748464013,90.25153599,Transportation,4,2
217269,28773,188496,13.24303053,86.75696947,Entertainment,0,0
124083,27236,96847,21.94982391,78.05017609,Healthcare,2,2
31236,4226,27010,13.52926111,86.47073889,Food,1,1
82693,2456,80237,2.970021646,97.02997835,Transportation,4,4
212712,64503,148209,30.32410019,69.67589981,Entertainment,0,0
156763,16910,139853,10.78698417,89.21301583,Healthcare,2,0
25322,6297,19025,24.86770397,75.13229603,Housing,3,1
149639,33395,116244,22.31704302,77.68295698,Healthcare,2,2
185951,27190,158761,14.62213164,85.37786836,Entertainment,0,0
196985,30625,166360,15.54686905,84.45313095,Entertainment,0,0
26589,4398,22191,16.54067472,83.45932528,Housing,3,1
234152,33065,201087,14.12116916,85.87883084,Entertainment,0,0
16649,7861,8788,47.21604901,52.78395099,Housing,3,3
173046,31331,141715,18.10559042,81.89440958,Healthcare,2,0
172522,44744,127778,25.93524304,74.06475696,Healthcare,2,0
218188,26301,191887,12.05428346,87.94571654,Entertainment,0,0
60860,24641,36219,40.48800526,59.51199474,Transportation,4,4
12654,2213,10441,17.48854117,82.51145883,Housing,3,3
23805,8986,14819,37.74837219,62.25162781,Housing,3,3
128760,25864,102896,20.08698354,79.91301646,Healthcare,2,2
92656,5941,86715,6.411889138,93.58811086,Transportation,4,4
114213,56674,57539,49.62132157,50.37867843,Transportation,4,4
50646,3106,47540,6.13276468,93.86723532,Food,1,4
132984,4691,128293,3.527492029,96.47250797,Healthcare,2,2
40069,17992,22077,44.90254311,55.09745689,Food,1,1
27224,11834,15390,43.46899794,56.53100206,Housing,3,1
241919,3312,238607,1.369053278,98.63094672,Entertainment,0,0
40202,1993,38209,4.957464803,95.0425352,Food,1,1
180217,18870,161347,10.47071031,89.52928969,Entertainment,0,0
206083,59046,147037,28.65156272,71.34843728,Entertainment,0,0
133394,58500,74894,43.85504595,56.14495405,Healthcare,2,2
138846,20244,118602,14.58018236,85.41981764,Healthcare,2,2
98918,46914,52004,47.42716189,52.57283811,Transportation,4,4
109046,10507,98539,9.635383233,90.36461677,Transportation,4,2
47069,19202,27867,40.79542799,59.20457201,Food,1,1
114045,34723,79322,30.44675347,69.55324653,Transportation,4,2
205123,67029,138094,32.67746669,67.32253331,Entertainment,0,0
75686,33445,42241,44.18914991,55.81085009,Transportation,4,4
115984,37588,78396,32.40791833,67.59208167,Transportation,4,2
89004,50693,38311,56.95586715,43.04413285,Transportation,4,4
39928,13500,26428,33.81085955,66.18914045,Food,1,1
82617,32362,50255,39.1711149,60.8288851,Transportation,4,4
88220,16338,71882,18.51961007,81.48038993,Transportation,4,4
114579,30002,84577,26.18455389,73.81544611,Transportation,4,2
20094,3412,16682,16.98019309,83.01980691,Housing,3,3
210249,60595,149654,28.82058892,71.17941108,Entertainment,0,0
189106,36149,152957,19.11573403,80.88426597,Entertainment,0,0
56393,5084,51309,9.015303318,90.98469668,Food,1,4
43246,18631,24615,43.08144106,56.91855894,Food,1,1
58486,28152,30334,48.13459631,51.86540369,Food,1,4
216127,25967,190160,12.01469506,87.98530494,Entertainment,0,0
61709,24636,37073,39.92286376,60.07713624,Transportation,4,4
52878,10946,41932,20.70048035,79.29951965,Food,1,4
15094,4716,10378,31.24420299,68.75579701,Housing,3,3
31056,1844,29212,5.937660999,94.062339,Food,1,1
82182,29298,52884,35.65014237,64.34985763,Transportation,4,4
224968,14750,210218,6.556488034,93.44351197,Entertainment,0,0
229201,54621,174580,23.83104786,76.16895214,Entertainment,0,0
177429,56847,120582,32.03929459,67.96070541,Healthcare,2,0
25735,2185,23550,8.490382747,91.50961725,Housing,3,1
249907,13306,236601,5.32438067,94.67561933,Entertainment,0,0
54826,2733,52093,4.984861197,95.0151388,Food,1,4
27363,12125,15238,44.31166173,55.68833827,Housing,3,1
50141,18155,31986,36.20789374,63.79210626,Food,1,4
153863,30553,123310,19.85727563,80.14272437,Healthcare,2,0
25859,12710,13149,49.15116594,50.84883406,Housing,3,1
228670,39535,189135,17.28910657,82.71089343,Entertainment,0,0
188163,14738,173425,7.832570697,92.1674293,Entertainment,0,0
10881,2328,8553,21.39509236,78.60490764,Housing,3,3
195929,4482,191447,2.287563352,97.71243665,Entertainment,0,0
79617,9450,70167,11.86932439,88.13067561,Transportation,4,4
28568,9253,19315,32.38938673,67.61061327,Housing,3,1
86062,39749,46313,46.18647022,53.81352978,Transportation,4,4
177509,21751,155758,12.2534632,87.7465368,Healthcare,2,0
122881,28585,94296,23.26234324,76.73765676,Healthcare,2,2
13434,6708,6726,49.93300581,50.06699419,Housing,3,3
41987,11448,30539,27.2655822,72.7344178,Food,1,1
157748,69344,88404,43.95871897,56.04128103,Healthcare,2,0
128163,24350,103813,18.99924315,81.00075685,Healthcare,2,2
46953,28023,18930,59.68308734,40.31691266,Food,1,1
119273,39763,79510,33.33780487,66.66219513,Transportation,4,2
232988,49113,183875,21.07962642,78.92037358,Entertainment,0,0
11649,3656,7993,31.38466821,68.61533179,Housing,3,3
127889,22361,105528,17.48469376,82.51530624,Healthcare,2,2
23422,2068,21354,8.829305781,91.17069422,Housing,3,3
32512,5256,27256,16.16633858,83.83366142,Food,1,1
96511,20249,76262,20.98102807,79.01897193,Transportation,4,4
40529,18554,21975,45.77956525,54.22043475,Food,1,1
49194,13963,35231,28.38354271,71.61645729,Food,1,1
21046,7569,13477,35.96407868,64.03592132,Housing,3,3
240658,55132,185526,22.90885821,77.09114179,Entertainment,0,0
240555,28891,211664,12.01014321,87.98985679,Entertainment,0,0
52863,2031,50832,3.842006697,96.1579933,Food,1,4
36537,290,36247,0.793715959,99.20628404,Food,1,1
239494,45889,193605,19.16081405,80.83918595,Entertainment,0,0
26739,11489,15250,42.96720147,57.03279853,Housing,3,1
88092,10039,78053,11.3960405,88.6039595,Transportation,4,4
200743,67611,133132,33.6803774,66.3196226,Entertainment,0,0
33251,1531,31720,4.604372801,95.3956272,Food,1,1
26671,5824,20847,21.83645158,78.16354842,Housing,3,1
193510,26563,166947,13.72693918,86.27306082,Entertainment,0,0
64281,12621,51660,19.6341065,80.3658935,Transportation,4,4
26759,13685,13074,51.14167196,48.85832804,Housing,3,1
95745,39209,56536,40.95148572,59.04851428,Transportation,4,4
87453,30095,57358,34.41277029,65.58722971,Transportation,4,4
147851,39970,107881,27.03397339,72.96602661,Healthcare,2,2
12127,3582,8545,29.53739589,70.46260411,Housing,3,3
10651,1209,9442,11.35104685,88.64895315,Housing,3,3
218244,26296,191948,12.0488994,87.9511006,Entertainment,0,0
130517,66494,64023,50.94661998,49.05338002,Healthcare,2,4
15745,9139,6606,58.04382344,41.95617656,Housing,3,3
130297,63720,66577,48.90365856,51.09634144,Healthcare,2,4
51959,5197,46762,10.00211705,89.99788295,Food,1,4
32143,9018,23125,28.05587531,71.94412469,Food,1,1
47589,21935,25654,46.09258442,53.90741558,Food,1,1
120791,19053,101738,15.77352617,84.22647383,Healthcare,2,2
44994,15328,29666,34.06676446,65.93323554,Food,1,1
156459,3985,152474,2.546993142,97.45300686,Healthcare,2,0
70874,17103,53771,24.13155741,75.86844259,Transportation,4,4
17763,9785,7978,55.08641558,44.91358442,Housing,3,3
59229,17544,41685,29.62062503,70.37937497,Food,1,4
145292,53492,91800,36.81689288,63.18310712,Healthcare,2,2
17065,5746,11319,33.67125696,66.32874304,Housing,3,3
207416,54271,153145,26.16529101,73.83470899,Entertainment,0,0
146196,45461,100735,31.09592602,68.90407398,Healthcare,2,2
10907,205,10702,1.879526909,98.12047309,Housing,3,3
186986,39113,147873,20.9176088,79.0823912,Entertainment,0,0
190785,14951,175834,7.836569961,92.16343004,Entertainment,0,0
162153,43336,118817,26.72537665,73.27462335,Healthcare,2,0
225959,8310,217649,3.677658336,96.32234166,Entertainment,0,0
46944,18299,28645,38.98048739,61.01951261,Food,1,1
243204,64150,179054,26.37703327,73.62296673,Entertainment,0,0
28949,1452,27497,5.015717296,94.9842827,Housing,3,1
45309,4764,40545,10.51446732,89.48553268,Food,1,4
32713,1235,31478,3.775257543,96.22474246,Food,1,1
117862,16959,100903,14.38886155,85.61113845,Transportation,4,2
138548,21388,117160,15.43724918,84.56275082,Healthcare,2,2
44264,21156,23108,47.79504789,52.20495211,Food,1,1
173037,17539,155498,10.13598248,89.86401752,Healthcare,2,0
177777,52759,125018,29.67706734,70.32293266,Healthcare,2,0
143142,56503,86639,39.47339006,60.52660994,Healthcare,2,2
136572,47083,89489,34.47485575,65.52514425,Healthcare,2,2
129128,58019,71109,44.93138591,55.06861409,Healthcare,2,2
140036,29740,110296,21.2373961,78.7626039,Healthcare,2,2
226466,16834,209632,7.433345403,92.5666546,Entertainment,0,0
24224,3816,20408,15.75297226,84.24702774,Housing,3,3
30565,14675,15890,48.01243252,51.98756748,Food,1,1
133693,43154,90539,32.27842894,67.72157106,Healthcare,2,2
210351,7324,203027,3.481799469,96.51820053,Entertainment,0,0
127673,45237,82436,35.43192374,64.56807626,Healthcare,2,2
244927,57965,186962,23.66623525,76.33376475,Entertainment,0,0
69383,37950,31433,54.69639537,45.30360463,Transportation,4,4
195896,65338,130558,33.35341201,66.64658799,Entertainment,0,0
174480,4378,170102,2.509170105,97.49082989,Healthcare,2,0
74402,6157,68245,8.27531518,91.72468482,Transportation,4,4
84778,28253,56525,33.32586284,66.67413716,Transportation,4,4
113417,57098,56319,50.34342294,49.65657706,Transportation,4,4
56175,7860,48315,13.99198932,86.00801068,Food,1,4
235959,40501,195458,17.16442263,82.83557737,Entertainment,0,0
92251,14925,77326,16.17868641,83.82131359,Transportation,4,4
59103,22786,36317,38.55303453,61.44696547,Food,1,4
92975,7488,85487,8.053777897,91.9462221,Transportation,4,4
238645,10156,228489,4.255693603,95.7443064,Entertainment,0,0
151535,37669,113866,24.85828356,75.14171644,Healthcare,2,0
220754,63155,157599,28.60876813,71.39123187,Entertainment,0,0
10458,1334,9124,12.75578504,87.24421496,Housing,3,3
202426,14888,187538,7.35478644,92.64521356,Entertainment,0,0
121430,21236,100194,17.48826484,82.51173516,Healthcare,2,2
184427,44507,139920,24.13258362,75.86741638,Entertainment,0,0
226339,34375,191964,15.1873959,84.8126041,Entertainment,0,0
27059,3318,23741,12.26209394,87.73790606,Housing,3,1
190078,30842,159236,16.22597039,83.77402961,Entertainment,0,0
228634,11661,216973,5.100291295,94.8997087,Entertainment,0,0
37638,18847,18791,50.0743929,49.9256071,Food,1,1
180468,27715,152753,15.35729326,84.64270674,Entertainment,0,0
22315,349,21966,1.563970423,98.43602958,Housing,3,3
14501,4692,9809,32.35638921,67.64361079,Housing,3,3
214057,65643,148414,30.66613098,69.33386902,Entertainment,0,0
142135,57808,84327,40.67119288,59.32880712,Healthcare,2,2
245791,38371,207420,15.61123068,84.38876932,Entertainment,0,0
16085,2917,13168,18.1349083,81.8650917,Housing,3,3
16597,1274,15323,7.67608604,92.32391396,Housing,3,3
191145,43564,147581,22.79107484,77.20892516,Entertainment,0,0
107967,41277,66690,38.23112618,61.76887382,Transportation,4,2
120288,14555,105733,12.10012636,87.89987364,Healthcare,2,2
117444,43743,73701,37.24583631,62.75416369,Transportation,4,2
107856,23838,84018,22.10169114,77.89830886,Transportation,4,2
244358,33802,210556,13.83298275,86.16701725,Entertainment,0,0
73144,32125,41019,43.92021218,56.07978782,Transportation,4,4
101003,60526,40477,59.92495272,40.07504728,Transportation,4,4
65363,33974,31389,51.97741842,48.02258158,Transportation,4,4
51099,17237,33862,33.73255837,66.26744163,Food,1,4
114001,51233,62768,44.94083385,55.05916615,Transportation,4,4
68914,13656,55258,19.81600255,80.18399745,Transportation,4,4
103168,35400,67768,34.31296526,65.68703474,Transportation,4,2
93041,19993,73048,21.48837609,78.51162391,Transportation,4,4
157595,59785,97810,37.93584822,62.06415178,Healthcare,2,0
57375,3377,53998,5.88583878,94.11416122,Food,1,4
144374,33149,111225,22.96050535,77.03949465,Healthcare,2,2
11258,180,11078,1.598863031,98.40113697,Housing,3,3
95585,15308,80277,16.01506513,83.98493487,Transportation,4,4
181336,66361,114975,36.59560154,63.40439846,Entertainment,0,0
56342,11541,44801,20.48383089,79.51616911,Food,1,4
88553,28516,60037,32.202184,67.797816,Transportation,4,4
236307,66405,169902,28.10115655,71.89884345,Entertainment,0,0
60498,10512,49986,17.37578102,82.62421898,Transportation,4,4
14932,8726,6206,58.43825342,41.56174658,Housing,3,3
219328,18513,200815,8.440782755,91.55921725,Entertainment,0,0
123661,25160,98501,20.34594577,79.65405423,Healthcare,2,2
72234,24057,48177,33.30426115,66.69573885,Transportation,4,4
167227,9336,157891,5.582830524,94.41716948,Healthcare,2,0
73733,18160,55573,24.6294061,75.3705939,Transportation,4,4
59063,5366,53697,9.085214093,90.91478591,Food,1,4
191015,38028,152987,19.90838416,80.09161584,Entertainment,0,0
34728,2118,32610,6.098825155,93.90117484,Food,1,1
219245,50532,168713,23.0481881,76.9518119,Entertainment,0,0
51921,30105,21816,57.98231929,42.01768071,Food,1,4
98883,35,98848,0.035395366,99.96460463,Transportation,4,4
245547,22228,223319,9.052442099,90.9475579,Entertainment,0,0
34961,14198,20763,40.61096651,59.38903349,Food,1,1
24428,3622,20806,14.82724742,85.17275258,Housing,3,3
175223,67917,107306,38.76032256,61.23967744,Healthcare,2,0
38570,2537,36033,6.577651024,93.42234898,Food,1,1
50315,393,49922,0.781079201,99.2189208,Food,1,4
52150,18109,34041,34.72483221,65.27516779,Food,1,4
87956,21678,66278,24.64641412,75.35358588,Transportation,4,4
14446,6897,7549,47.74331995,52.25668005,Housing,3,3
156675,16126,140549,10.29264401,89.70735599,Healthcare,2,0
121785,42342,79443,34.76782855,65.23217145,Healthcare,2,2
10604,6115,4489,57.66691814,42.33308186,Housing,3,3
193395,33334,160061,17.23622638,82.76377362,Entertainment,0,0
113174,32982,80192,29.14273596,70.85726404,Transportation,4,2
237249,29956,207293,12.62639674,87.37360326,Entertainment,0,0
19839,3601,16238,18.15111649,81.84888351,Housing,3,3
156597,34482,122115,22.01957892,77.98042108,Healthcare,2,0
19350,11476,7874,59.30749354,40.69250646,Housing,3,3
165509,21763,143746,13.14913388,86.85086612,Healthcare,2,0
181353,52091,129262,28.72353917,71.27646083,Entertainment,0,0
94769,34751,60018,36.66916397,63.33083603,Transportation,4,4
49990,9107,40883,18.21764353,81.78235647,Food,1,4
149898,62453,87445,41.66366463,58.33633537,Healthcare,2,2
131604,50745,80859,38.55885839,61.44114161,Healthcare,2,2
167695,25070,142625,14.94975998,85.05024002,Healthcare,2,0
19819,8606,11213,43.42297795,56.57702205,Housing,3,3
247242,5032,242210,2.03525291,97.96474709,Entertainment,0,0
156750,30500,126250,19.45773525,80.54226475,Healthcare,2,0
177679,46745,130934,26.30868026,73.69131974,Healthcare,2,0
119010,15311,103699,12.86530544,87.13469456,Transportation,4,2
25426,9714,15712,38.20498702,61.79501298,Housing,3,1
215088,46711,168377,21.71715763,78.28284237,Entertainment,0,0
149785,40751,109034,27.20632907,72.79367093,Healthcare,2,2
55951,6605,49346,11.80497221,88.19502779,Food,1,4
195481,9449,186032,4.833717855,95.16628215,Entertainment,0,0
28846,10664,18182,36.9687305,63.0312695,Housing,3,1
195052,57650,137402,29.55622091,70.44377909,Entertainment,0,0
96033,1056,94977,1.099622005,98.900378,Transportation,4,4
154176,36913,117263,23.9421181,76.0578819,Healthcare,2,0
145689,42543,103146,29.20124375,70.79875625,Healthcare,2,2
44154,9328,34826,21.12605879,78.87394121,Food,1,1
154637,67248,87389,43.48765173,56.51234827,Healthcare,2,0
25547,8599,16948,33.65952949,66.34047051,Housing,3,1
38755,9147,29608,23.60211586,76.39788414,Food,1,1
41753,3964,37789,9.49392858,90.50607142,Food,1,1
239948,66261,173687,27.61473319,72.38526681,Entertainment,0,0
149605,9819,139786,6.563283313,93.43671669,Healthcare,2,2
45770,12426,33344,27.14878742,72.85121258,Food,1,1
108152,43689,64463,40.39592425,59.60407575,Transportation,4,4
20192,4700,15492,23.27654517,76.72345483,Housing,3,3
29957,5971,23986,19.93190239,80.06809761,Housing,3,1
158748,9975,148773,6.28354373,93.71645627,Healthcare,2,0
172661,2407,170254,1.394061195,98.6059388,Healthcare,2,0
49506,12286,37220,24.81719388,75.18280612,Food,1,1
77063,44495,32568,57.73847372,42.26152628,Transportation,4,4
16413,4980,11433,30.34180223,69.65819777,Housing,3,3
86369,37056,49313,42.90428279,57.09571721,Transportation,4,4
193099,44831,148268,23.21658838,76.78341162,Entertainment,0,0
141855,43691,98164,30.79976032,69.20023968,Healthcare,2,2
26239,7858,18381,29.94778764,70.05221236,Housing,3,1
177045,17580,159465,9.929678895,90.0703211,Healthcare,2,0
75817,36880,38937,48.64344408,51.35655592,Transportation,4,4
39828,15082,24746,37.86783168,62.13216832,Food,1,1
178136,28224,149912,15.84407419,84.15592581,Healthcare,2,0
169495,30924,138571,18.24478598,81.75521402,Healthcare,2,0
158560,58027,100533,36.59624117,63.40375883,Healthcare,2,0
148473,14191,134282,9.557966768,90.44203323,Healthcare,2,2
132782,23443,109339,17.65525448,82.34474552,Healthcare,2,2
185491,2982,182509,1.607625168,98.39237483,Entertainment,0,0
189012,19308,169704,10.21522443,89.78477557,Entertainment,0,0
47804,4068,43736,8.509748138,91.49025186,Food,1,4
46276,13907,32369,30.05229493,69.94770507,Food,1,1
39664,8077,31587,20.36355385,79.63644615,Food,1,1
18423,9617,8806,52.20105303,47.79894697,Housing,3,3
176711,37536,139175,21.24146205,78.75853795,Healthcare,2,0
112876,50593,62283,44.8217513,55.1782487,Transportation,4,4
96826,52628,44198,54.3531696,45.6468304,Transportation,4,4
17477,6977,10500,39.92103908,60.07896092,Housing,3,3
223545,64810,158735,28.99192556,71.00807444,Entertainment,0,0
189904,59827,130077,31.50381245,68.49618755,Entertainment,0,0
35893,14886,21007,41.47326777,58.52673223,Food,1,1
199176,17237,181939,8.654155119,91.34584488,Entertainment,0,0
225541,24296,201245,10.77232078,89.22767922,Entertainment,0,0
22123,1525,20598,6.893278488,93.10672151,Housing,3,3
242317,60896,181421,25.1307172,74.8692828,Entertainment,0,0
99123,47584,51539,48.00500388,51.99499612,Transportation,4,4
66697,39401,27296,59.07462105,40.92537895,Transportation,4,4
28977,10282,18695,35.48331435,64.51668565,Housing,3,1
12878,924,11954,7.175027178,92.82497282,Housing,3,3
48113,10191,37922,21.18138549,78.81861451,Food,1,1
97794,6779,91015,6.931918114,93.06808189,Transportation,4,4
38922,241,38681,0.619187092,99.38081291,Food,1,1
227347,44981,182366,19.78517421,80.21482579,Entertainment,0,0
40971,22704,18267,55.41480559,44.58519441,Food,1,1
56422,33027,23395,58.53567757,41.46432243,Food,1,4
182923,66004,116919,36.082942,63.917058,Entertainment,0,0
92763,11868,80895,12.79389412,87.20610588,Transportation,4,4
168568,27302,141266,16.19643111,83.80356889,Healthcare,2,0
10881,3155,7726,28.99549674,71.00450326,Housing,3,3
159123,56924,102199,35.77358396,64.22641604,Healthcare,2,0
91133,12656,78477,13.88739535,86.11260465,Transportation,4,4
187832,5806,182026,3.091060096,96.9089399,Entertainment,0,0
167745,23118,144627,13.78163284,86.21836716,Healthcare,2,0
31412,3359,28053,10.69336559,89.30663441,Food,1,1
25220,11002,14218,43.62410785,56.37589215,Housing,3,1
12751,1081,11670,8.47776645,91.52223355,Housing,3,3
139493,14345,125148,10.28367015,89.71632985,Healthcare,2,2
38243,4443,33800,11.61781241,88.38218759,Food,1,1
24989,2380,22609,9.524190644,90.47580936,Housing,3,3
152039,4369,147670,2.873604799,97.1263952,Healthcare,2,0
22957,2233,20724,9.72688069,90.27311931,Housing,3,3
71332,4775,66557,6.694050356,93.30594964,Transportation,4,4
136187,58563,77624,43.0019018,56.9980982,Healthcare,2,2
48741,3181,45560,6.526333067,93.47366693,Food,1,4
23113,1951,21162,8.441137022,91.55886298,Housing,3,3
202917,2495,200422,1.229566769,98.77043323,Entertainment,0,0
35001,7321,27680,20.91654524,79.08345476,Food,1,1
99513,7456,92057,7.492488419,92.50751158,Transportation,4,4
23656,12529,11127,52.96330741,47.03669259,Housing,3,3
144471,14559,129912,10.07745499,89.92254501,Healthcare,2,2
36787,10056,26731,27.33574361,72.66425639,Food,1,1
11265,6676,4589,59.26320462,40.73679538,Housing,3,3
41040,12316,28724,30.00974659,69.99025341,Food,1,1
57543,98,57445,0.170307422,99.82969258,Food,1,4
78202,30091,48111,38.47855554,61.52144446,Transportation,4,4
118109,44618,73491,37.77696873,62.22303127,Transportation,4,2
204613,1980,202633,0.96768045,99.03231955,Entertainment,0,0
202456,2959,199497,1.46155214,98.53844786,Entertainment,0,0
239297,50690,188607,21.18288152,78.81711848,Entertainment,0,0
23531,5596,17935,23.78139476,76.21860524,Housing,3,3
15060,8804,6256,58.45949535,41.54050465,Housing,3,3
24761,10171,14590,41.07669319,58.92330681,Housing,3,3
41998,20992,21006,49.98333254,50.01666746,Food,1,1
29926,12886,17040,43.05954688,56.94045312,Housing,3,1
24429,4726,19703,19.34585943,80.65414057,Housing,3,3
17688,1705,15983,9.639303483,90.36069652,Housing,3,3
174190,52447,121743,30.1090763,69.8909237,Healthcare,2,0
22824,8108,14716,35.52400981,64.47599019,Housing,3,3
107266,10112,97154,9.427031865,90.57296814,Transportation,4,2
44187,17165,27022,38.846267,61.153733,Food,1,1
51626,19174,32452,37.14020067,62.85979933,Food,1,4
118266,66698,51568,56.3965975,43.6034025,Transportation,4,4
114274,57607,56667,50.41129216,49.58870784,Transportation,4,4
164599,35338,129261,21.46914623,78.53085377,Healthcare,2,0
134208,41701,92507,31.07191822,68.92808178,Healthcare,2,2
10795,5224,5571,48.39277443,51.60722557,Housing,3,3
205568,41931,163637,20.39762998,79.60237002,Entertainment,0,0
18424,4492,13932,24.38124186,75.61875814,Housing,3,3
26854,12342,14512,45.95963357,54.04036643,Housing,3,1
180996,20765,160231,11.47262923,88.52737077,Entertainment,0,0
227809,45300,182509,19.88507917,80.11492083,Entertainment,0,0
27831,6125,21706,22.00783299,77.99216701,Housing,3,1
121297,40459,80838,33.35531794,66.64468206,Healthcare,2,2
246884,52958,193926,21.45055978,78.54944022,Entertainment,0,0
21843,2452,19391,11.22556425,88.77443575,Housing,3,3
43492,3279,40213,7.539317576,92.46068242,Food,1,1
39103,12575,26528,32.1586579,67.8413421,Food,1,1
100767,47007,53760,46.64920063,53.35079937,Transportation,4,4
193799,41179,152620,21.24830365,78.75169635,Entertainment,0,0
32652,19347,13305,59.25211319,40.74788681,Food,1,1
120971,17659,103312,14.5977135,85.4022865,Healthcare,2,2
97935,21545,76390,21.99928524,78.00071476,Transportation,4,4
48854,15690,33164,32.11610104,67.88389896,Food,1,1
209323,41691,167632,19.91706597,80.08293403,Entertainment,0,0
69173,26982,42191,39.0065488,60.9934512,Transportation,4,4
45180,20698,24482,45.81230633,54.18769367,Food,1,1
72187,40347,31840,55.89233519,44.10766481,Transportation,4,4
167773,13213,154560,7.875522283,92.12447772,Healthcare,2,0
64478,20922,43556,32.44827693,67.55172307,Transportation,4,4
66226,18564,47662,28.03128681,71.96871319,Transportation,4,4
137343,16017,121326,11.66204321,88.33795679,Healthcare,2,2
23954,9253,14701,38.62820406,61.37179594,Housing,3,3
34802,5122,29680,14.71754497,85.28245503,Food,1,1
77168,2870,74298,3.7191582,96.2808418,Transportation,4,4
33287,12517,20770,37.60326854,62.39673146,Food,1,1
50635,7811,42824,15.42608867,84.57391133,Food,1,4
70858,13404,57454,18.91670665,81.08329335,Transportation,4,4
47156,22529,24627,47.77546866,52.22453134,Food,1,1
79779,43666,36113,54.73370185,45.26629815,Transportation,4,4
179043,45281,133762,25.29057266,74.70942734,Healthcare,2,0
160764,46743,114021,29.0755393,70.9244607,Healthcare,2,0
55002,28953,26049,52.639904,47.360096,Food,1,4
237552,58541,179011,24.64344649,75.35655351,Entertainment,0,0
34319,1520,32799,4.42903348,95.57096652,Food,1,1
18964,9871,9093,52.05125501,47.94874499,Housing,3,3
220694,10479,210215,4.748203395,95.25179661,Entertainment,0,0
161917,16438,145479,10.15211497,89.84788503,Healthcare,2,0
183103,9709,173394,5.302480025,94.69751998,Entertainment,0,0
158451,57863,100588,36.51791406,63.48208594,Healthcare,2,0
203144,56711,146433,27.91665026,72.08334974,Entertainment,0,0
119194,23097,96097,19.37765324,80.62234676,Transportation,4,2
212772,23154,189618,10.88207095,89.11792905,Entertainment,0,0
86992,45106,41886,51.8507449,48.1492551,Transportation,4,4
104592,54780,49812,52.37494263,47.62505737,Transportation,4,4
28295,16600,11695,58.66760912,41.33239088,Housing,3,1
29304,14235,15069,48.57698608,51.42301392,Housing,3,1
182025,58580,123445,32.18239253,67.81760747,Entertainment,0,0
81861,5452,76409,6.660070119,93.33992988,Transportation,4,4
145294,51033,94261,35.12395557,64.87604443,Healthcare,2,2
10544,610,9934,5.785280728,94.21471927,Housing,3,3
150318,213,150105,0.141699597,99.8583004,Healthcare,2,0
74246,38769,35477,52.21695445,47.78304555,Transportation,4,4
54930,9885,45045,17.9956308,82.0043692,Food,1,4
112910,9247,103663,8.189708617,91.81029138,Transportation,4,2
21585,16,21569,0.07412555,99.92587445,Housing,3,3
141874,18329,123545,12.91921,87.08079,Healthcare,2,2
42845,22121,20724,51.63029525,48.36970475,Food,1,1
230371,47419,182952,20.58375403,79.41624597,Entertainment,0,0
32869,8975,23894,27.30536372,72.69463628,Food,1,1
10373,5872,4501,56.60850284,43.39149716,Housing,3,3
14169,2622,11547,18.50518738,81.49481262,Housing,3,3
12662,2127,10535,16.79829411,83.20170589,Housing,3,3
215061,58944,156117,27.40803772,72.59196228,Entertainment,0,0
128535,58595,69940,45.58680515,54.41319485,Healthcare,2,4
73041,24977,48064,34.1958626,65.8041374,Transportation,4,4
205308,5001,200307,2.435852475,97.56414752,Entertainment,0,0
76535,17080,59455,22.31658718,77.68341282,Transportation,4,4
27006,10904,16102,40.37621269,59.62378731,Housing,3,1
82460,48701,33759,59.06015038,40.93984962,Transportation,4,4
122477,4984,117493,4.069335467,95.93066453,Healthcare,2,2
19735,3064,16671,15.52571573,84.47428427,Housing,3,3
35895,20541,15354,57.22524028,42.77475972,Food,1,1
19751,4655,15096,23.56842692,76.43157308,Housing,3,3
27405,13698,13707,49.98357964,50.01642036,Housing,3,1
119589,9732,109857,8.137872212,91.86212779,Transportation,4,2
228129,24396,203733,10.69394948,89.30605052,Entertainment,0,0
51331,27044,24287,52.68551168,47.31448832,Food,1,4
171259,63242,108017,36.92769431,63.07230569,Healthcare,2,0
244925,17099,227826,6.981320812,93.01867919,Entertainment,0,0
176639,36219,140420,20.50453184,79.49546816,Healthcare,2,0
32438,18877,13561,58.19409335,41.80590665,Food,1,1
124873,20853,104020,16.69936656,83.30063344,Healthcare,2,2
99287,2747,96540,2.766726762,97.23327324,Transportation,4,4
41073,992,40081,2.41521194,97.58478806,Food,1,1
162368,45847,116521,28.23647517,71.76352483,Healthcare,2,0
152692,56657,96035,37.10541482,62.89458518,Healthcare,2,0
109706,55520,54186,50.60798862,49.39201138,Transportation,4,4
101577,5168,96409,5.087765931,94.91223407,Transportation,4,2
90018,26633,63385,29.58630496,70.41369504,Transportation,4,4
115743,38187,77556,32.99292398,67.00707602,Transportation,4,2
233633,50936,182697,21.80171466,78.19828534,Entertainment,0,0
91491,19605,71886,21.42833721,78.57166279,Transportation,4,4
32163,9141,23022,28.42085626,71.57914374,Food,1,1
184701,10257,174444,5.553299657,94.44670034,Entertainment,0,0
245707,3537,242170,1.439519428,98.56048057,Entertainment,0,0
70291,18737,51554,26.65632869,73.34367131,Transportation,4,4
154469,15372,139097,9.951511306,90.04848869,Healthcare,2,0
77927,29953,47974,38.43725538,61.56274462,Transportation,4,4
40644,12140,28504,29.86910737,70.13089263,Food,1,1
52387,21676,30711,41.37667742,58.62332258,Food,1,4
98373,45299,53074,46.04820428,53.95179572,Transportation,4,4
79525,40764,38761,51.2593524,48.7406476,Transportation,4,4
46386,7612,38774,16.41012374,83.58987626,Food,1,1
62227,15564,46663,25.01165089,74.98834911,Transportation,4,4
33231,7617,25614,22.9213686,77.0786314,Food,1,1
19485,7743,11742,39.7382602,60.2617398,Housing,3,3
99507,32798,66709,32.96049524,67.03950476,Transportation,4,4
92842,26230,66612,28.25229961,71.74770039,Transportation,4,4
36998,4682,32316,12.65473809,87.34526191,Food,1,1
130087,45351,84736,34.86205386,65.13794614,Healthcare,2,2
123981,48236,75745,38.9059614,61.0940386,Healthcare,2,2
48089,25970,22119,54.00403419,45.99596581,Food,1,1
133100,43533,89567,32.70698723,67.29301277,Healthcare,2,2
93187,482,92705,0.517239529,99.48276047,Transportation,4,4
191193,7898,183295,4.130904374,95.86909563,Entertainment,0,0
201831,48839,152992,24.19796761,75.80203239,Entertainment,0,0
51511,22675,28836,44.01972394,55.98027606,Food,1,4
226717,55241,171476,24.36561881,75.63438119,Entertainment,0,0
153612,20037,133575,13.04390282,86.95609718,Healthcare,2,0
141365,34899,106466,24.68715736,75.31284264,Healthcare,2,2
76435,9049,67386,11.8388173,88.1611827,Transportation,4,4
60934,18093,42841,29.69278235,70.30721765,Transportation,4,4
44952,4995,39957,11.11185264,88.88814736,Food,1,1
118028,43096,74932,36.51336971,63.48663029,Transportation,4,2
60144,25984,34160,43.20297952,56.79702048,Transportation,4,4
247668,55280,192388,22.32020285,77.67979715,Entertainment,0,0
109941,63402,46539,57.66911343,42.33088657,Transportation,4,4
95572,27534,68038,28.80969322,71.19030678,Transportation,4,4
16614,1870,14744,11.25556759,88.74443241,Housing,3,3
120632,31788,88844,26.35121692,73.64878308,Healthcare,2,2
172149,45225,126924,26.27084677,73.72915323,Healthcare,2,0
166890,51825,115065,31.05338846,68.94661154,Healthcare,2,0
26556,1197,25359,4.507455942,95.49254406,Housing,3,1
96269,36239,60030,37.64347817,62.35652183,Transportation,4,4
89070,33976,55094,38.14527899,61.85472101,Transportation,4,4
59111,16859,42252,28.52091827,71.47908173,Food,1,4
93713,15389,78324,16.42141432,83.57858568,Transportation,4,4
25745,14178,11567,55.07088755,44.92911245,Housing,3,1
46061,13286,32775,28.84435857,71.15564143,Food,1,1
128638,64635,64003,50.24565059,49.75434941,Healthcare,2,4
64600,31224,33376,48.33436533,51.66563467,Transportation,4,4
37111,5147,31964,13.8692032,86.1307968,Food,1,1
48897,20039,28858,40.98206434,59.01793566,Food,1,1
170384,29878,140506,17.5356841,82.4643159,Healthcare,2,0
78050,25986,52064,33.29404228,66.70595772,Transportation,4,4
110602,54953,55649,49.68535831,50.31464169,Transportation,4,4
247799,39152,208647,15.79990234,84.20009766,Entertainment,0,0
227140,54390,172750,23.94558422,76.05441578,Entertainment,0,0
29012,14395,14617,49.6173997,50.3826003,Housing,3,1
72892,42136,30756,57.80606925,42.19393075,Transportation,4,4
137369,23094,114275,16.81165328,83.18834672,Healthcare,2,2
57362,20233,37129,35.27248004,64.72751996,Food,1,4
32751,7941,24810,24.24658789,75.75341211,Food,1,1
14142,8463,5679,59.84302079,40.15697921,Housing,3,3
75595,34320,41275,45.39982803,54.60017197,Transportation,4,4
246438,21942,224496,8.903659338,91.09634066,Entertainment,0,0
25110,13880,11230,55.27678216,44.72321784,Housing,3,1
45673,2792,42881,6.113020822,93.88697918,Food,1,4
24859,10157,14702,40.85844161,59.14155839,Housing,3,3
58438,24831,33607,42.49118724,57.50881276,Food,1,4
38433,3573,34860,9.29669815,90.70330185,Food,1,1
23825,13217,10608,55.47534103,44.52465897,Housing,3,3
20829,8801,12028,42.25358875,57.74641125,Housing,3,3
17850,5743,12107,32.17366947,67.82633053,Housing,3,3
45688,13257,32431,29.01637191,70.98362809,Food,1,1
54159,30307,23852,55.95930501,44.04069499,Food,1,4
106289,24656,81633,23.19713235,76.80286765,Transportation,4,2
20408,9705,10703,47.55488044,52.44511956,Housing,3,3
95793,33194,62599,34.65180128,65.34819872,Transportation,4,4
65266,3535,61731,5.416296387,94.58370361,Transportation,4,4
146445,10787,135658,7.365905289,92.63409471,Healthcare,2,2
59525,31130,28395,52.29735405,47.70264595,Food,1,4
83634,672,82962,0.803500969,99.19649903,Transportation,4,4
245515,21543,223972,8.774616622,91.22538338,Entertainment,0,0
127402,59851,67551,46.97806942,53.02193058,Healthcare,2,4
108477,22538,85939,20.77675452,79.22324548,Transportation,4,2
149762,61491,88271,41.05914718,58.94085282,Healthcare,2,2
54499,20106,34393,36.89242004,63.10757996,Food,1,4
146663,47500,99163,32.38717332,67.61282668,Healthcare,2,2
142908,61202,81706,42.82615389,57.17384611,Healthcare,2,2
113460,32641,80819,28.76872907,71.23127093,Transportation,4,2
100934,59030,41904,58.48376167,41.51623833,Transportation,4,4
189618,32884,156734,17.34223544,82.65776456,Entertainment,0,0
234708,13676,221032,5.826814595,94.1731854,Entertainment,0,0
125742,41332,84410,32.87048083,67.12951917,Healthcare,2,2
40921,4085,36836,9.982649495,90.0173505,Food,1,1
188245,31930,156315,16.9619379,83.0380621,Entertainment,0,0
18708,2224,16484,11.88796237,88.11203763,Housing,3,3
31905,12321,19584,38.61777151,61.38222849,Food,1,1
245294,62545,182749,25.49797386,74.50202614,Entertainment,0,0
119895,38459,81436,32.07723425,67.92276575,Transportation,4,2
36218,8160,28058,22.53023359,77.46976641,Food,1,1
36890,7749,29141,21.0056926,78.9943074,Food,1,1
10416,2751,7665,26.41129032,73.58870968,Housing,3,3
127329,12820,114509,10.06840547,89.93159453,Healthcare,2,2
122201,63939,58262,52.32281242,47.67718758,Healthcare,2,4
69495,8395,61100,12.08000576,87.91999424,Transportation,4,4
28831,13325,15506,46.21761299,53.78238701,Housing,3,1
13924,3373,10551,24.22436082,75.77563918,Housing,3,3
30297,5060,25237,16.70132356,83.29867644,Food,1,1
19198,3467,15731,18.05917283,81.94082717,Housing,3,3
55151,20790,34361,37.69650596,62.30349404,Food,1,4
53857,8677,45180,16.11118332,83.88881668,Food,1,4
224010,10388,213622,4.637292978,95.36270702,Entertainment,0,0
15912,6220,9692,39.08999497,60.91000503,Housing,3,3
116930,60878,56052,52.06362781,47.93637219,Transportation,4,4
55466,6158,49308,11.1022969,88.8977031,Food,1,4
39785,3724,36061,9.360311675,90.63968832,Food,1,1
49695,10081,39614,20.28574303,79.71425697,Food,1,1
124082,31152,92930,25.1059783,74.8940217,Healthcare,2,2
233802,65042,168760,27.81926587,72.18073413,Entertainment,0,0
111629,42043,69586,37.66315205,62.33684795,Transportation,4,2
15138,3059,12079,20.20742502,79.79257498,Housing,3,3
10170,6048,4122,59.46902655,40.53097345,Housing,3,3
37960,18830,19130,49.60484721,50.39515279,Food,1,1
75267,7405,67862,9.838308953,90.16169105,Transportation,4,4
53572,15696,37876,29.29888748,70.70111252,Food,1,4
203189,53497,149692,26.32868905,73.67131095,Entertainment,0,0
18285,10719,7566,58.62182116,41.37817884,Housing,3,3
10438,2587,7851,24.78444146,75.21555854,Housing,3,3
216132,9740,206392,4.506505284,95.49349472,Entertainment,0,0
15561,4988,10573,32.05449521,67.94550479,Housing,3,3
15553,4861,10692,31.25442037,68.74557963,Housing,3,3
162440,63438,99002,39.05318887,60.94681113,Healthcare,2,0
162440,30759,131681,18.93560699,81.06439301,Healthcare,2,0
118789,40374,78415,33.98799552,66.01200448,Transportation,4,2
179319,62207,117112,34.69069089,65.30930911,Healthcare,2,0
139378,43926,95452,31.51573419,68.48426581,Healthcare,2,2
75856,472,75384,0.622231597,99.3777684,Transportation,4,4
110620,20307,90313,18.35743988,81.64256012,Transportation,4,2
152095,37274,114821,24.50705151,75.49294849,Healthcare,2,0
154693,40986,113707,26.49505795,73.50494205,Healthcare,2,0
17384,3295,14089,18.95421077,81.04578923,Housing,3,3
23700,5763,17937,24.3164557,75.6835443,Housing,3,3
21889,3970,17919,18.13696377,81.86303623,Housing,3,3
246679,36981,209698,14.99154772,85.00845228,Entertainment,0,0
55934,6058,49876,10.8306218,89.1693782,Food,1,4
25026,4321,20705,17.26604331,82.73395669,Housing,3,1
41651,21139,20512,50.75268301,49.24731699,Food,1,1
199203,22557,176646,11.32362464,88.67637536,Entertainment,0,0
17104,6849,10255,40.04326473,59.95673527,Housing,3,3
152618,21139,131479,13.85092191,86.14907809,Healthcare,2,0
174172,20934,153238,12.01915348,87.98084652,Healthcare,2,0
69755,36891,32864,52.88653143,47.11346857,Transportation,4,4
146671,61100,85571,41.65786011,58.34213989,Healthcare,2,2
183437,61027,122410,33.26864264,66.73135736,Entertainment,0,0
28415,10067,18348,35.42847088,64.57152912,Housing,3,1
209485,67954,141531,32.43859942,67.56140058,Entertainment,0,0
243332,62613,180719,25.73151086,74.26848914,Entertainment,0,0
37226,15115,22111,40.60334175,59.39665825,Food,1,1
11433,483,10950,4.224612962,95.77538704,Housing,3,3
10933,1925,9008,17.60724412,82.39275588,Housing,3,3
12999,2425,10574,18.65528118,81.34471882,Housing,3,3
68868,17360,51508,25.20764361,74.79235639,Transportation,4,4
218327,67972,150355,31.13311684,68.86688316,Entertainment,0,0
28896,8517,20379,29.47466777,70.52533223,Housing,3,1
222564,56478,166086,25.3760716,74.6239284,Entertainment,0,0
27879,1561,26318,5.599196528,94.40080347,Housing,3,1
54391,8695,45696,15.98610064,84.01389936,Food,1,4
247311,52580,194731,21.26067987,78.73932013,Entertainment,0,0
246734,30135,216599,12.21355792,87.78644208,Entertainment,0,0
166431,53957,112474,32.42004194,67.57995806,Healthcare,2,0
112231,382,111849,0.340369417,99.65963058,Transportation,4,2
38523,8952,29571,23.23806557,76.76193443,Food,1,1
25242,11303,13939,44.7785437,55.2214563,Housing,3,1
56301,5164,51137,9.172128381,90.82787162,Food,1,4
142190,56451,85739,39.70110416,60.29889584,Healthcare,2,2
17992,4981,13011,27.68452646,72.31547354,Housing,3,3
75350,5718,69632,7.588586596,92.4114134,Transportation,4,4
153275,1773,151502,1.156744414,98.84325559,Healthcare,2,0
43451,17221,26230,39.63314999,60.36685001,Food,1,1
190267,6403,183864,3.365270909,96.63472909,Entertainment,0,0
118277,27591,90686,23.32744321,76.67255679,Transportation,4,2
17229,9084,8145,52.72505659,47.27494341,Housing,3,3
126748,22085,104663,17.42433806,82.57566194,Healthcare,2,2
108190,34046,74144,31.46871245,68.53128755,Transportation,4,2
41503,6188,35315,14.90976556,85.09023444,Food,1,1
191733,60446,131287,31.52613269,68.47386731,Entertainment,0,0
33445,36,33409,0.107639408,99.89236059,Food,1,1
38927,2278,36649,5.851979346,94.14802065,Food,1,1
140566,19816,120750,14.09729238,85.90270762,Healthcare,2,2
42161,24907,17254,59.07592325,40.92407675,Food,1,1
57506,10863,46643,18.89020276,81.10979724,Food,1,4
182101,13312,168789,7.310228939,92.68977106,Entertainment,0,0
10962,1870,9092,17.05893085,82.94106915,Housing,3,3
180976,62519,118457,34.54546459,65.45453541,Entertainment,0,0
110473,21874,88599,19.8003132,80.1996868,Transportation,4,2
124500,34750,89750,27.91164659,72.08835341,Healthcare,2,2
14712,8505,6207,57.80995106,42.19004894,Housing,3,3
115452,40712,74740,35.26313966,64.73686034,Transportation,4,2
148119,67775,80344,45.75712771,54.24287229,Healthcare,2,2
196547,42478,154069,21.61213348,78.38786652,Entertainment,0,0
227607,47357,180250,20.80647783,79.19352217,Entertainment,0,0
161058,48617,112441,30.18601994,69.81398006,Healthcare,2,0
21501,6670,14831,31.02181294,68.97818706,Housing,3,3
142587,19242,123345,13.49491889,86.50508111,Healthcare,2,2
184774,49677,135097,26.88527607,73.11472393,Entertainment,0,0
215323,16379,198944,7.606711777,92.39328822,Entertainment,0,0
56167,876,55291,1.559634661,98.44036534,Food,1,4
37409,11201,26208,29.94199257,70.05800743,Food,1,1
37033,10338,26695,27.91564281,72.08435719,Food,1,1
31982,8129,23853,25.4174223,74.5825777,Food,1,1
103530,18504,85026,17.87308027,82.12691973,Transportation,4,2
25933,8487,17446,32.72664173,67.27335827,Housing,3,1
181839,65266,116573,35.89219034,64.10780966,Entertainment,0,0
20776,12293,8483,59.16923373,40.83076627,Housing,3,3
183673,47499,136174,25.86063275,74.13936725,Entertainment,0,0
53148,25860,27288,48.65658162,51.34341838,Food,1,4
38376,22527,15849,58.70075047,41.29924953,Food,1,1
17639,4461,13178,25.29054935,74.70945065,Housing,3,3
25160,14029,11131,55.75914149,44.24085851,Housing,3,1
169759,4775,164984,2.812811103,97.1871889,Healthcare,2,0
22374,6827,15547,30.51309556,69.48690444,Housing,3,3
47567,11568,35999,24.31938108,75.68061892,Food,1,1
57672,671,57001,1.16347621,98.83652379,Food,1,4
115614,51026,64588,44.13479336,55.86520664,Transportation,4,4
100563,49387,51176,49.11050784,50.88949216,Transportation,4,4
206583,6101,200482,2.953292381,97.04670762,Entertainment,0,0
54687,24736,29951,45.23195641,54.76804359,Food,1,4
89662,5782,83880,6.448662756,93.55133724,Transportation,4,4
86099,37588,48511,43.65672075,56.34327925,Transportation,4,4
24256,5371,18885,22.14297493,77.85702507,Housing,3,3
131135,30996,100139,23.63671026,76.36328974,Healthcare,2,2
210504,24311,186193,11.54894919,88.45105081,Entertainment,0,0
179037,33372,145665,18.63972252,81.36027748,Healthcare,2,0
27695,12089,15606,43.65047843,56.34952157,Housing,3,1
75619,30528,45091,40.37080628,59.62919372,Transportation,4,4
104758,39612,65146,37.81286393,62.18713607,Transportation,4,2
34877,7616,27261,21.83674055,78.16325945,Food,1,1
50693,25765,24928,50.82555777,49.17444223,Food,1,4
234376,69551,164825,29.67496672,70.32503328,Entertainment,0,0
54480,20740,33740,38.06901615,61.93098385,Food,1,4
151524,11088,140436,7.317652649,92.68234735,Healthcare,2,0
221832,14178,207654,6.391323163,93.60867684,Entertainment,0,0
202929,66825,136104,32.93023668,67.06976332,Entertainment,0,0
194667,45865,148802,23.56074733,76.43925267,Entertainment,0,0
156087,12501,143586,8.008994984,91.99100502,Healthcare,2,0
57004,4879,52125,8.559048488,91.44095151,Food,1,4
189750,11399,178351,6.007378129,93.99262187,Entertainment,0,0
108852,14046,94806,12.90375923,87.09624077,Transportation,4,2
117301,58747,58554,50.08226699,49.91773301,Transportation,4,4
16703,4454,12249,26.66586841,73.33413159,Housing,3,3
126003,40262,85741,31.95320746,68.04679254,Healthcare,2,2
205724,13178,192546,6.405669732,93.59433027,Entertainment,0,0
156984,28185,128799,17.95405901,82.04594099,Healthcare,2,0
15543,703,14840,4.52293637,95.47706363,Housing,3,3
38744,23186,15558,59.84410489,40.15589511,Food,1,1
31129,12028,19101,38.63921103,61.36078897,Food,1,1
19559,11396,8163,58.26473746,41.73526254,Housing,3,3
143411,40466,102945,28.21680345,71.78319655,Healthcare,2,2
59156,25833,33323,43.66928122,56.33071878,Food,1,4
230823,24702,206121,10.7017065,89.2982935,Entertainment,0,0
159279,7118,152161,4.468887926,95.53111207,Healthcare,2,0
133980,35667,98313,26.62113748,73.37886252,Healthcare,2,2
98028,49639,48389,50.63757294,49.36242706,Transportation,4,4
171269,9481,161788,5.535736181,94.46426382,Healthcare,2,0
209306,68555,140751,32.75348055,67.24651945,Entertainment,0,0
187295,10221,177074,5.457166502,94.5428335,Entertainment,0,0
167263,11711,155552,7.00154846,92.99845154,Healthcare,2,0
159745,5578,154167,3.49181508,96.50818492,Healthcare,2,0
27146,14761,12385,54.37633537,45.62366463,Housing,3,1
159057,24718,134339,15.54034088,84.45965912,Healthcare,2,0
111386,45317,66069,40.68464619,59.31535381,Transportation,4,4
223023,60632,162391,27.18643369,72.81356631,Entertainment,0,0
212541,3244,209297,1.52629375,98.47370625,Entertainment,0,0
54299,27582,26717,50.79651559,49.20348441,Food,1,4
166260,19331,146929,11.62696981,88.37303019,Healthcare,2,0
249616,48499,201117,19.42944363,80.57055637,Entertainment,0,0
98449,41171,57278,41.81962234,58.18037766,Transportation,4,4
43682,4706,38976,10.77331624,89.22668376,Food,1,1
23318,4009,19309,17.19272665,82.80727335,Housing,3,3
37146,18102,19044,48.73203037,51.26796963,Food,1,1
60270,11737,48533,19.47403352,80.52596648,Transportation,4,4
146691,23546,123145,16.05142783,83.94857217,Healthcare,2,2
132040,30736,101304,23.27779461,76.72220539,Healthcare,2,2
149796,50454,99342,33.68180726,66.31819274,Healthcare,2,2
28115,10332,17783,36.74906633,63.25093367,Housing,3,1
26196,11467,14729,43.7738586,56.2261414,Housing,3,1
222728,58936,163792,26.46097482,73.53902518,Entertainment,0,0
140030,27312,112718,19.50439192,80.49560808,Healthcare,2,2
117768,20645,97123,17.53022892,82.46977108,Transportation,4,2
76117,17944,58173,23.5742344,76.4257656,Transportation,4,4
66343,22281,44062,33.584553,66.415447,Transportation,4,4
42965,2916,40049,6.786919586,93.21308041,Food,1,1
227542,43996,183546,19.3353315,80.6646685,Entertainment,0,0
130066,9478,120588,7.287069642,92.71293036,Healthcare,2,2
33742,12379,21363,36.68721475,63.31278525,Food,1,1
30708,17224,13484,56.08961834,43.91038166,Food,1,1
36473,2041,34432,5.59592027,94.40407973,Food,1,1
214389,29405,184984,13.71572236,86.28427764,Entertainment,0,0
169274,44601,124673,26.34840554,73.65159446,Healthcare,2,0
112987,2872,110115,2.54188535,97.45811465,Transportation,4,2
194055,23113,170942,11.91054083,88.08945917,Entertainment,0,0
61327,28556,32771,46.56350384,53.43649616,Transportation,4,4
209068,35779,173289,17.1135707,82.8864293,Entertainment,0,0
219620,62397,157223,28.41134687,71.58865313,Entertainment,0,0
167226,23727,143499,14.18858312,85.81141688,Healthcare,2,0
140579,44422,96157,31.59931426,68.40068574,Healthcare,2,2
162552,66113,96439,40.67190807,59.32809193,Healthcare,2,0
39983,18201,21782,45.52184678,54.47815322,Food,1,1
114472,42155,72317,36.82559927,63.17440073,Transportation,4,2
20230,4718,15512,23.32179931,76.67820069,Housing,3,3
234683,45262,189421,19.28644171,80.71355829,Entertainment,0,0
146766,48935,97831,33.34219097,66.65780903,Healthcare,2,2
150810,49722,101088,32.9699622,67.0300378,Healthcare,2,0
11015,5857,5158,53.17294598,46.82705402,Housing,3,3
48243,19888,28355,41.22463363,58.77536637,Food,1,1
87605,33395,54210,38.11997032,61.88002968,Transportation,4,4
168661,51586,117075,30.58561256,69.41438744,Healthcare,2,0
150297,3222,147075,2.143755364,97.85624464,Healthcare,2,0
95443,23141,72302,24.24588498,75.75411502,Transportation,4,4
110558,25456,85102,23.02501854,76.97498146,Transportation,4,2
184968,9682,175286,5.234418927,94.76558107,Entertainment,0,0
85961,26814,59147,31.19321553,68.80678447,Transportation,4,4
41842,4010,37832,9.583671909,90.41632809,Food,1,1
36103,17843,18260,49.42248567,50.57751433,Food,1,1
22938,5773,17165,25.16784375,74.83215625,Housing,3,3
150277,21031,129246,13.99482289,86.00517711,Healthcare,2,0
21870,1239,20631,5.665294925,94.33470508,Housing,3,3
210092,37258,172834,17.73413552,82.26586448,Entertainment,0,0
92737,27893,64844,30.07753108,69.92246892,Transportation,4,4
158700,47882,110818,30.17139256,69.82860744,Healthcare,2,0
222610,10113,212497,4.5429226,95.4570774,Entertainment,0,0
64677,5302,59375,8.197659137,91.80234086,Transportation,4,4
40734,23622,17112,57.99086758,42.00913242,Food,1,1
39646,8504,31142,21.449831,78.550169,Food,1,1
138036,22218,115818,16.0958011,83.9041989,Healthcare,2,2
243678,28874,214804,11.84924367,88.15075633,Entertainment,0,0
137379,3605,133774,2.624127414,97.37587259,Healthcare,2,2
158028,11799,146229,7.46639836,92.53360164,Healthcare,2,0
29350,12439,16911,42.38160136,57.61839864,Housing,3,1
55938,10322,45616,18.45257249,81.54742751,Food,1,4
177447,63013,114434,35.51088494,64.48911506,Healthcare,2,0
146164,52228,93936,35.7324649,64.2675351,Healthcare,2,2
55069,31432,23637,57.07748461,42.92251539,Food,1,4
211899,34976,176923,16.5059769,83.4940231,Entertainment,0,0
58285,6414,51871,11.00454662,88.99545338,Food,1,4
188749,6102,182647,3.23286481,96.76713519,Entertainment,0,0
37222,1749,35473,4.698834023,95.30116598,Food,1,1
42796,12479,30317,29.15926722,70.84073278,Food,1,1
181932,7061,174871,3.881120419,96.11887958,Entertainment,0,0
221035,55055,165980,24.90782003,75.09217997,Entertainment,0,0
59229,15544,43685,26.24390079,73.75609921,Food,1,4
129039,25064,103975,19.42358512,80.57641488,Healthcare,2,2
51135,12422,38713,24.29255891,75.70744109,Food,1,4
100119,54665,45454,54.60002597,45.39997403,Transportation,4,4
135515,51634,83881,38.10205512,61.89794488,Healthcare,2,2
17083,8131,8952,47.59702628,52.40297372,Housing,3,3
41439,23448,17991,56.58437704,43.41562296,Food,1,1
109393,46642,62751,42.63709744,57.36290256,Transportation,4,4
37328,928,36400,2.486069438,97.51393056,Food,1,1
202806,61618,141188,30.38273029,69.61726971,Entertainment,0,0
158385,695,157690,0.43880418,99.56119582,Healthcare,2,0
106709,25334,81375,23.74120271,76.25879729,Transportation,4,2
154772,20900,133872,13.50373453,86.49626547,Healthcare,2,0
55602,28554,27048,51.35426783,48.64573217,Food,1,4
196452,59229,137223,30.14934946,69.85065054,Entertainment,0,0
35844,15242,20602,42.5231559,57.4768441,Food,1,1
116405,39350,77055,33.80438985,66.19561015,Transportation,4,2
82041,19954,62087,24.32198535,75.67801465,Transportation,4,4
54229,5194,49035,9.577901123,90.42209888,Food,1,4
107866,56664,51202,52.53184507,47.46815493,Transportation,4,4
38741,14931,23810,38.54056426,61.45943574,Food,1,1
46976,15652,31324,33.31914169,66.68085831,Food,1,1
121975,56860,65115,46.61610986,53.38389014,Healthcare,2,4
38778,17898,20880,46.15503636,53.84496364,Food,1,1
204045,12793,191252,6.26969541,93.73030459,Entertainment,0,0
37142,16668,20474,44.87642023,55.12357977,Food,1,1
178887,6844,172043,3.825878907,96.17412109,Healthcare,2,0
169114,15921,153193,9.414359544,90.58564046,Healthcare,2,0
36614,10446,26168,28.53007046,71.46992954,Food,1,1
24970,4538,20432,18.17380857,81.82619143,Housing,3,3
82724,39217,43507,47.40704028,52.59295972,Transportation,4,4
41469,9933,31536,23.95283224,76.04716776,Food,1,1
32371,4700,27671,14.51916839,85.48083161,Food,1,1
55023,717,54306,1.303091434,98.69690857,Food,1,4
249834,64048,185786,25.63622245,74.36377755,Entertainment,0,0
97653,35695,61958,36.55289648,63.44710352,Transportation,4,4
105968,49522,56446,46.73297599,53.26702401,Transportation,4,4
65625,5935,59690,9.043809524,90.95619048,Transportation,4,4
47370,7723,39647,16.30356766,83.69643234,Food,1,1
124282,4815,119467,3.874253713,96.12574629,Healthcare,2,2
55556,19608,35948,35.29411765,64.70588235,Food,1,4
235914,37138,198776,15.74217723,84.25782277,Entertainment,0,0
199295,34776,164519,17.44950952,82.55049048,Entertainment,0,0
56729,26618,30111,46.92132772,53.07867228,Food,1,4
24641,3306,21335,13.41666328,86.58333672,Housing,3,3
83133,31804,51329,38.25676927,61.74323073,Transportation,4,4
168894,11789,157105,6.980117707,93.01988229,Healthcare,2,0
36091,14266,21825,39.52786013,60.47213987,Food,1,1
19984,7958,12026,39.82185749,60.17814251,Housing,3,3
63240,5223,58017,8.259013283,91.74098672,Transportation,4,4
90436,48199,42237,53.2962537,46.7037463,Transportation,4,4
204435,45490,158945,22.2515714,77.7484286,Entertainment,0,0
51434,18080,33354,35.15184508,64.84815492,Food,1,4
170511,29838,140673,17.49916428,82.50083572,Healthcare,2,0
167106,34695,132411,20.76227065,79.23772935,Healthcare,2,0
136374,31213,105161,22.88779386,77.11220614,Healthcare,2,2
143366,9707,133659,6.770782473,93.22921753,Healthcare,2,2
120309,52601,67708,43.72158359,56.27841641,Healthcare,2,4
103348,3930,99418,3.80268607,96.19731393,Transportation,4,2
34187,96,34091,0.280808494,99.71919151,Food,1,1
26634,6529,20105,24.51377938,75.48622062,Housing,3,1
20061,8498,11563,42.36079956,57.63920044,Housing,3,3
228019,19367,208652,8.493590446,91.50640955,Entertainment,0,0
68046,32698,35348,48.05278782,51.94721218,Transportation,4,4
27440,760,26680,2.7696793,97.2303207,Housing,3,1
201344,28381,172963,14.09577638,85.90422362,Entertainment,0,0
67118,6431,60687,9.581632349,90.41836765,Transportation,4,4
228235,61652,166583,27.01250904,72.98749096,Entertainment,0,0
130287,2272,128015,1.74384244,98.25615756,Healthcare,2,2
133068,54710,78358,41.11431749,58.88568251,Healthcare,2,2
18408,10897,7511,59.19708822,40.80291178,Housing,3,3
14824,2496,12328,16.83756071,83.16243929,Housing,3,3
220727,44542,176185,20.17967897,79.82032103,Entertainment,0,0
122232,68243,53989,55.83071536,44.16928464,Healthcare,2,4
232213,52412,179801,22.57065711,77.42934289,Entertainment,0,0
47638,21755,25883,45.6673244,54.3326756,Food,1,1
116915,26127,90788,22.34700423,77.65299577,Transportation,4,2
76487,7520,68967,9.831736112,90.16826389,Transportation,4,4
27173,12332,14841,45.38328488,54.61671512,Housing,3,1
39450,18419,21031,46.68948035,53.31051965,Food,1,1
56178,26216,29962,46.66595464,53.33404536,Food,1,4
30447,14266,16181,46.85519099,53.14480901,Food,1,1
234880,68442,166438,29.13913488,70.86086512,Entertainment,0,0
56321,9954,46367,17.67369187,82.32630813,Food,1,4
18105,979,17126,5.407346037,94.59265396,Housing,3,3
41880,20225,21655,48.29274117,51.70725883,Food,1,1
162826,42567,120259,26.14263078,73.85736922,Healthcare,2,0
17407,1624,15783,9.329580054,90.67041995,Housing,3,3
99752,15093,84659,15.1305237,84.8694763,Transportation,4,4
246186,29815,216371,12.11076178,87.88923822,Entertainment,0,0
126699,37455,89244,29.5621907,70.4378093,Healthcare,2,2
200925,59200,141725,29.46373025,70.53626975,Entertainment,0,0
206598,19400,187198,9.390216749,90.60978325,Entertainment,0,0
123783,57931,65852,46.80044917,53.19955083,Healthcare,2,4
216618,56884,159734,26.26005226,73.73994774,Entertainment,0,0
166856,1170,165686,0.701203433,99.29879657,Healthcare,2,0
44254,357,43897,0.806706738,99.19329326,Food,1,4
40573,8711,31862,21.46994307,78.53005693,Food,1,1
110103,21318,88785,19.36187025,80.63812975,Transportation,4,2
64925,22766,42159,35.06507509,64.93492491,Transportation,4,4
136633,32667,103966,23.9085726,76.0914274,Healthcare,2,2
39157,6868,32289,17.53964808,82.46035192,Food,1,1
131705,15484,116221,11.7565772,88.2434228,Healthcare,2,2
59632,19918,39714,33.40152938,66.59847062,Food,1,4
227830,37294,190536,16.36922267,83.63077733,Entertainment,0,0
192744,6677,186067,3.464180467,96.53581953,Entertainment,0,0
212637,44495,168142,20.92533284,79.07466716,Entertainment,0,0
13912,4171,9741,29.9813111,70.0186889,Housing,3,3
95063,30373,64690,31.95039079,68.04960921,Transportation,4,4
243443,40256,203187,16.53610907,83.46389093,Entertainment,0,0
70969,4784,66185,6.74097141,93.25902859,Transportation,4,4
43348,22715,20633,52.40149488,47.59850512,Food,1,1
11951,3986,7965,33.3528575,66.6471425,Housing,3,3
138938,35511,103427,25.55888238,74.44111762,Healthcare,2,2
48837,17892,30945,36.63615701,63.36384299,Food,1,1
73242,17618,55624,24.05450425,75.94549575,Transportation,4,4
222601,33833,188768,15.1989434,84.8010566,Entertainment,0,0
145136,3515,141621,2.421866387,97.57813361,Healthcare,2,2
27296,140,27156,0.512895662,99.48710434,Housing,3,1
29839,4132,25707,13.84764905,86.15235095,Housing,3,1
22222,8700,13522,39.1503915,60.8496085,Housing,3,3
125553,21809,103744,17.37035356,82.62964644,Healthcare,2,2
241895,4694,237201,1.940511379,98.05948862,Entertainment,0,0
19833,2365,17468,11.92457016,88.07542984,Housing,3,3
249992,23528,226464,9.411501168,90.58849883,Entertainment,0,0
58820,23339,35481,39.67868072,60.32131928,Food,1,4
78020,14411,63609,18.4709049,81.5290951,Transportation,4,4
98470,29534,68936,29.99289124,70.00710876,Transportation,4,4
35985,13369,22616,37.15159094,62.84840906,Food,1,1
214810,26706,188104,12.43238211,87.56761789,Entertainment,0,0
139633,26834,112799,19.21752021,80.78247979,Healthcare,2,2
87399,19912,67487,22.78286937,77.21713063,Transportation,4,4
20960,8582,12378,40.94465649,59.05534351,Housing,3,3
31613,11306,20307,35.76376807,64.23623193,Food,1,1
58786,16378,42408,27.86037492,72.13962508,Food,1,4
40057,21968,18089,54.84185036,45.15814964,Food,1,1
108356,7050,101306,6.506330983,93.49366902,Transportation,4,2
211394,57439,153955,27.17153751,72.82846249,Entertainment,0,0
29470,140,29330,0.475059382,99.52494062,Housing,3,1
181480,37018,144462,20.39783998,79.60216002,Entertainment,0,0
235209,59526,175683,25.30770506,74.69229494,Entertainment,0,0
54515,30478,24037,55.90754838,44.09245162,Food,1,4
47376,20276,27100,42.7980412,57.2019588,Food,1,1
85427,49253,36174,57.65507392,42.34492608,Transportation,4,4
16550,9629,6921,58.18126888,41.81873112,Housing,3,3
31440,2119,29321,6.739821883,93.26017812,Food,1,1
23350,9522,13828,40.77944325,59.22055675,Housing,3,3
120808,62508,58300,51.74160652,48.25839348,Healthcare,2,4
183653,41340,142313,22.50984193,77.49015807,Entertainment,0,0
153200,7490,145710,4.889033943,95.11096606,Healthcare,2,0
142456,16800,125656,11.79311507,88.20688493,Healthcare,2,2
85284,24461,60823,28.68181605,71.31818395,Transportation,4,4
24181,9887,14294,40.88747364,59.11252636,Housing,3,3
208983,67602,141381,32.34808573,67.65191427,Entertainment,0,0
198175,20969,177206,10.5810521,89.4189479,Entertainment,0,0
21456,1218,20238,5.676733781,94.32326622,Housing,3,3
57146,11993,45153,20.98659574,79.01340426,Food,1,4
146249,60091,86158,41.08814419,58.91185581,Healthcare,2,2
172504,53112,119392,30.78885127,69.21114873,Healthcare,2,0
202188,8576,193612,4.24159693,95.75840307,Entertainment,0,0
222486,14851,207635,6.675026743,93.32497326,Entertainment,0,0
51181,14611,36570,28.54770325,71.45229675,Food,1,4
19666,2778,16888,14.12590257,85.87409743,Housing,3,3
65530,31889,33641,48.66320769,51.33679231,Transportation,4,4
26556,11914,14642,44.86368429,55.13631571,Housing,3,1
180758,45121,135637,24.96210403,75.03789597,Entertainment,0,0
34653,9084,25569,26.21418059,73.78581941,Food,1,1
45419,61,45358,0.134305027,99.86569497,Food,1,4
155346,64333,91013,41.41271742,58.58728258,Healthcare,2,0
49302,22078,27224,44.78114478,55.21885522,Food,1,1
218443,6131,212312,2.806681835,97.19331817,Entertainment,0,0
89061,16658,72403,18.70403431,81.29596569,Transportation,4,4
213213,39409,173804,18.48339454,81.51660546,Entertainment,0,0
57943,34624,23319,59.75527674,40.24472326,Food,1,1
108571,47656,60915,43.89385748,56.10614252,Transportation,4,4
124562,21672,102890,17.39856457,82.60143543,Healthcare,2,2
52875,10011,42864,18.93333333,81.06666667,Food,1,4
24438,6774,17664,27.71912595,72.28087405,Housing,3,3
83918,32295,51623,38.48399628,61.51600372,Transportation,4,4
21735,11421,10314,52.54658385,47.45341615,Housing,3,3
208123,14460,193663,6.947814514,93.05218549,Entertainment,0,0
172192,36963,135229,21.46615406,78.53384594,Healthcare,2,0
227586,9678,217908,4.252458411,95.74754159,Entertainment,0,0
46888,14967,31921,31.92074731,68.07925269,Food,1,1
39074,4375,34699,11.19670369,88.80329631,Food,1,1
55084,14520,40564,26.35974149,73.64025851,Food,1,4
84239,24587,59652,29.18719358,70.81280642,Transportation,4,4
130582,57975,72607,44.39739015,55.60260985,Healthcare,2,2
11329,4626,6703,40.83325978,59.16674022,Housing,3,3
183364,68888,114476,37.56898846,62.43101154,Entertainment,0,0
184658,62086,122572,33.62215555,66.37784445,Entertainment,0,0
203839,57067,146772,27.99611458,72.00388542,Entertainment,0,0
115365,34827,80538,30.18853205,69.81146795,Transportation,4,2
224172,11260,212912,5.022928823,94.97707118,Entertainment,0,0
77503,5811,71692,7.49777428,92.50222572,Transportation,4,4
10251,6138,4113,59.87708516,40.12291484,Housing,3,3
41604,5418,36186,13.02278627,86.97721373,Food,1,1
42543,10469,32074,24.60804363,75.39195637,Food,1,1
77650,15245,62405,19.63296845,80.36703155,Transportation,4,4
248257,6200,242057,2.497411956,97.50258804,Entertainment,0,0
56996,11242,45754,19.72419117,80.27580883,Food,1,4
56729,13339,43390,23.51354686,76.48645314,Food,1,4
171387,14879,156508,8.681521936,91.31847806,Healthcare,2,0
202342,56032,146310,27.69172984,72.30827016,Entertainment,0,0
245761,22539,223222,9.171105261,90.82889474,Entertainment,0,0
148575,25711,122864,17.30506478,82.69493522,Healthcare,2,2
122332,59105,63227,48.31524049,51.68475951,Healthcare,2,4
48636,6248,42388,12.84645119,87.15354881,Food,1,4
245827,6704,239123,2.727121105,97.27287889,Entertainment,0,0
56123,25838,30285,46.03816617,53.96183383,Food,1,4
150974,63109,87865,41.8012373,58.1987627,Healthcare,2,0
40335,22593,17742,56.01338788,43.98661212,Food,1,1
36704,9960,26744,27.13600697,72.86399303,Food,1,1
58821,9788,49033,16.64031553,83.35968447,Food,1,4
120365,34786,85579,28.90042787,71.09957213,Healthcare,2,2
22088,7856,14232,35.56682361,64.43317639,Housing,3,3
19978,8187,11791,40.98007809,59.01992191,Housing,3,3
60621,29115,31506,48.02791112,51.97208888,Transportation,4,4
225710,37323,188387,16.5358203,83.4641797,Entertainment,0,0
168397,60977,107420,36.21026503,63.78973497,Healthcare,2,0
130817,9287,121530,7.099230222,92.90076978,Healthcare,2,2
35058,8910,26148,25.41502653,74.58497347,Food,1,1
223565,26453,197112,11.83235301,88.16764699,Entertainment,0,0
58276,17457,40819,29.95572792,70.04427208,Food,1,4
125321,47236,78085,37.69200693,62.30799307,Healthcare,2,2
228857,49117,179740,21.46187357,78.53812643,Entertainment,0,0
15313,3426,11887,22.373147,77.626853,Housing,3,3
141374,43431,97943,30.7206417,69.2793583,Healthcare,2,2
126441,35122,91319,27.77738234,72.22261766,Healthcare,2,2
36974,8379,28595,22.6618705,77.3381295,Food,1,1
17560,8105,9455,46.15603645,53.84396355,Housing,3,3
227320,14160,213160,6.229104346,93.77089565,Entertainment,0,0
211241,42033,169208,19.89812584,80.10187416,Entertainment,0,0
189676,2492,187184,1.313819355,98.68618064,Entertainment,0,0
102009,37691,64318,36.9487006,63.0512994,Transportation,4,2
224567,57151,167416,25.44942044,74.55057956,Entertainment,0,0
52667,24120,28547,45.7971785,54.2028215,Food,1,4
177799,35041,142758,19.70820983,80.29179017,Healthcare,2,0
12844,3551,9293,27.64715042,72.35284958,Housing,3,3
52922,15006,37916,28.35493746,71.64506254,Food,1,4
92927,33634,59293,36.19400174,63.80599826,Transportation,4,4
176165,59804,116361,33.94771947,66.05228053,Healthcare,2,0
11032,2902,8130,26.30529369,73.69470631,Housing,3,3
202058,50191,151867,24.83989746,75.16010254,Entertainment,0,0
47098,15663,31435,33.25618922,66.74381078,Food,1,1
189661,61175,128486,32.25491799,67.74508201,Entertainment,0,0
16223,1944,14279,11.98298712,88.01701288,Housing,3,3
111035,36519,74516,32.8896294,67.1103706,Transportation,4,2
16484,6430,10054,39.00752245,60.99247755,Housing,3,3
123273,42625,80648,34.57772586,65.42227414,Healthcare,2,2
239422,67173,172249,28.05631897,71.94368103,Entertainment,0,0
57263,2619,54644,4.573633935,95.42636607,Food,1,4
17353,1923,15430,11.08165735,88.91834265,Housing,3,3
82472,33873,48599,41.07212145,58.92787855,Transportation,4,4
116350,39823,76527,34.22690159,65.77309841,Transportation,4,2
121314,23563,97751,19.42314984,80.57685016,Healthcare,2,2
19103,3311,15792,17.33235617,82.66764383,Housing,3,3
239310,19594,219716,8.187706322,91.81229368,Entertainment,0,0
166111,45715,120396,27.52075419,72.47924581,Healthcare,2,0
17102,1549,15553,9.057420185,90.94257982,Housing,3,3
14360,3546,10814,24.69359331,75.30640669,Housing,3,3
12844,6058,6786,47.1659919,52.8340081,Housing,3,3
42509,11855,30654,27.88821191,72.11178809,Food,1,1
54441,7786,46655,14.30172113,85.69827887,Food,1,4
45494,16115,29379,35.42225348,64.57774652,Food,1,1
44149,16681,27468,37.78341525,62.21658475,Food,1,1
245907,39615,206292,16.10974881,83.89025119,Entertainment,0,0
40194,8123,32071,20.209484,79.790516,Food,1,1
204439,1479,202960,0.723443179,99.27655682,Entertainment,0,0
41396,16427,24969,39.68257803,60.31742197,Food,1,1
86339,8923,77416,10.33484289,89.66515711,Transportation,4,4
73516,27579,45937,37.51428261,62.48571739,Transportation,4,4
37530,7923,29607,21.11111111,78.88888889,Food,1,1
69015,14961,54054,21.67789611,78.32210389,Transportation,4,4
12393,5473,6920,44.16202695,55.83797305,Housing,3,3
35147,17366,17781,49.40962244,50.59037756,Food,1,1
194202,6652,187550,3.42529943,96.57470057,Entertainment,0,0
218596,44949,173647,20.56259035,79.43740965,Entertainment,0,0
83055,5416,77639,6.520980073,93.47901993,Transportation,4,4
109671,29767,79904,27.14208861,72.85791139,Transportation,4,2
242312,42602,199710,17.58146522,82.41853478,Entertainment,0,0
241876,3715,238161,1.535910963,98.46408904,Entertainment,0,0
85659,14015,71644,16.36138643,83.63861357,Transportation,4,4
149948,21381,128567,14.2589431,85.7410569,Healthcare,2,2
235095,64228,170867,27.32001957,72.67998043,Entertainment,0,0
131972,65624,66348,49.72569939,50.27430061,Healthcare,2,4
17446,4032,13414,23.11131491,76.88868509,Housing,3,3
248204,42054,206150,16.94332082,83.05667918,Entertainment,0,0
13677,2876,10801,21.02800322,78.97199678,Housing,3,3
117563,63068,54495,53.64613016,46.35386984,Transportation,4,4
10151,3665,6486,36.10481726,63.89518274,Housing,3,3
49319,9045,40274,18.33978791,81.66021209,Food,1,1
142063,3434,138629,2.417237423,97.58276258,Healthcare,2,2
63330,7199,56131,11.36744039,88.63255961,Transportation,4,4
152028,56008,96020,36.840582,63.159418,Healthcare,2,0
62328,8416,53912,13.50275959,86.49724041,Transportation,4,4
46377,131,46246,0.282467602,99.7175324,Food,1,4
237429,3683,233746,1.551200569,98.44879943,Entertainment,0,0
119581,44817,74764,37.47836195,62.52163805,Transportation,4,2
114165,15948,98217,13.96925503,86.03074497,Transportation,4,2
234037,24674,209363,10.54277742,89.45722258,Entertainment,0,0
70743,32119,38624,45.40237197,54.59762803,Transportation,4,4
12720,1976,10744,15.53459119,84.46540881,Housing,3,3
104976,26303,78673,25.05620332,74.94379668,Transportation,4,2
93709,21405,72304,22.84198956,77.15801044,Transportation,4,4
30902,12436,18466,40.24334994,59.75665006,Food,1,1
93382,44583,48799,47.74260564,52.25739436,Transportation,4,4
155367,53026,102341,34.1295127,65.8704873,Healthcare,2,0
52099,9787,42312,18.78538935,81.21461065,Food,1,4
190437,31812,158625,16.704737,83.295263,Entertainment,0,0
84158,31947,52211,37.96074051,62.03925949,Transportation,4,4
22007,5410,16597,24.5830872,75.4169128,Housing,3,3
154731,28356,126375,18.32599802,81.67400198,Healthcare,2,0
37514,22472,15042,59.90296956,40.09703044,Food,1,1
67335,4283,63052,6.360733645,93.63926635,Transportation,4,4
163024,50034,112990,30.69118657,69.30881343,Healthcare,2,0
111637,46669,64968,41.80424053,58.19575947,Transportation,4,4
39720,19663,20057,49.5040282,50.4959718,Food,1,1
122494,43362,79132,35.39928486,64.60071514,Healthcare,2,2
31649,3595,28054,11.35896869,88.64103131,Food,1,1
88731,36493,52238,41.12767804,58.87232196,Transportation,4,4
25638,10820,14818,42.20297995,57.79702005,Housing,3,1
120151,7809,112342,6.499321687,93.50067831,Healthcare,2,2
28549,14548,14001,50.95800203,49.04199797,Housing,3,1
207261,51550,155711,24.87202127,75.12797873,Entertainment,0,0
45489,22712,22777,49.92855416,50.07144584,Food,1,1
159823,44709,115114,27.97407132,72.02592868,Healthcare,2,0
52097,12823,39274,24.61370136,75.38629864,Food,1,4
244193,57511,186682,23.55145315,76.44854685,Entertainment,0,0
30481,11953,18528,39.2145927,60.7854073,Food,1,1
20857,1664,19193,7.978136837,92.02186316,Housing,3,3
45377,12157,33220,26.79110563,73.20889437,Food,1,1
27165,6518,20647,23.99411007,76.00588993,Housing,3,1
101479,11952,89527,11.77780625,88.22219375,Transportation,4,2
89523,32398,57125,36.18958257,63.81041743,Transportation,4,4
67305,13398,53907,19.90639626,80.09360374,Transportation,4,4
218731,54596,164135,24.96033941,75.03966059,Entertainment,0,0
180182,58271,121911,32.34007837,67.65992163,Entertainment,0,0
151217,63663,87554,42.10042522,57.89957478,Healthcare,2,0
56819,25785,31034,45.38094651,54.61905349,Food,1,4
170579,2784,167795,1.632088358,98.36791164,Healthcare,2,0
236198,21061,215137,8.916671606,91.08332839,Entertainment,0,0
189222,7207,182015,3.808753739,96.19124626,Entertainment,0,0
194123,66085,128038,34.04284912,65.95715088,Entertainment,0,0
17203,1814,15389,10.54467244,89.45532756,Housing,3,3
43613,16073,27540,36.85369041,63.14630959,Food,1,1
154901,18553,136348,11.97732745,88.02267255,Healthcare,2,0
155305,66221,89084,42.63932262,57.36067738,Healthcare,2,0
14288,4493,9795,31.44596865,68.55403135,Housing,3,3
202750,35251,167499,17.3864365,82.6135635,Entertainment,0,0
37407,6516,30891,17.41919962,82.58080038,Food,1,1
176704,39703,137001,22.46864813,77.53135187,Healthcare,2,0
30026,2603,27423,8.6691534,91.3308466,Food,1,1
219551,29085,190466,13.24749147,86.75250853,Entertainment,0,0
47223,15079,32144,31.93147407,68.06852593,Food,1,1
26355,946,25409,3.589451717,96.41054828,Housing,3,1
248686,3736,244950,1.502296068,98.49770393,Entertainment,0,0
28971,4804,24167,16.58209934,83.41790066,Housing,3,1
97181,14080,83101,14.48842881,85.51157119,Transportation,4,4
221183,42095,179088,19.03175199,80.96824801,Entertainment,0,0
68879,34840,34039,50.58145443,49.41854557,Transportation,4,4
67238,3044,64194,4.52720188,95.47279812,Transportation,4,4
109520,47459,62061,43.33363769,56.66636231,Transportation,4,4
92669,6488,86181,7.001262558,92.99873744,Transportation,4,4
91091,40482,50609,44.44127301,55.55872699,Transportation,4,4
121673,25035,96638,20.57564127,79.42435873,Healthcare,2,2
42178,19847,22331,47.05533691,52.94466309,Food,1,1
14442,2905,11537,20.11494253,79.88505747,Housing,3,3
237917,8905,229012,3.742901936,96.25709806,Entertainment,0,0
107955,57708,50247,53.4556065,46.5443935,Transportation,4,4
27799,15816,11983,56.89413288,43.10586712,Housing,3,1
231291,17400,213891,7.522990518,92.47700948,Entertainment,0,0
153386,64671,88715,42.16225731,57.83774269,Healthcare,2,0
69463,15102,54361,21.74107079,78.25892921,Transportation,4,4
19635,3997,15638,20.35650624,79.64349376,Housing,3,3
214184,55778,158406,26.04209465,73.95790535,Entertainment,0,0
215785,43434,172351,20.12836851,79.87163149,Entertainment,0,0
11662,6477,5185,55.5393586,44.4606414,Housing,3,3
122994,61597,61397,50.08130478,49.91869522,Healthcare,2,4
23173,8278,14895,35.72260821,64.27739179,Housing,3,3
15981,6995,8986,43.77072774,56.22927226,Housing,3,3
227799,69393,158406,30.46238131,69.53761869,Entertainment,0,0
200750,10096,190654,5.029140722,94.97085928,Entertainment,0,0
179897,22359,157538,12.42877869,87.57122131,Healthcare,2,0
154970,33997,120973,21.93779441,78.06220559,Healthcare,2,0
178807,15249,163558,8.528189612,91.47181039,Healthcare,2,0
224000,3514,220486,1.56875,98.43125,Entertainment,0,0
41692,23456,18236,56.2601938,43.7398062,Food,1,1
183911,33267,150644,18.0886407,81.9113593,Entertainment,0,0
136381,5456,130925,4.000557262,95.99944274,Healthcare,2,2
47186,13849,33337,29.34980715,70.65019285,Food,1,1
26265,15472,10793,58.90729107,41.09270893,Housing,3,1
208048,9122,198926,4.3845651,95.6154349,Entertainment,0,0
204937,62121,142816,30.3122423,69.6877577,Entertainment,0,0
41041,1373,39668,3.345435053,96.65456495,Food,1,1
21362,6968,14394,32.61866866,67.38133134,Housing,3,3
46657,27773,18884,59.52590179,40.47409821,Food,1,1
249052,65750,183302,26.40010921,73.59989079,Entertainment,0,0
235594,56738,178856,24.08295627,75.91704373,Entertainment,0,0
73561,5042,68519,6.854175446,93.14582455,Transportation,4,4
50706,27876,22830,54.97574252,45.02425748,Food,1,4
112857,35864,76993,31.77826807,68.22173193,Transportation,4,2
27943,7902,20041,28.27899653,71.72100347,Housing,3,1
15972,3509,12463,21.96969697,78.03030303,Housing,3,3
46064,26117,19947,56.69720389,43.30279611,Food,1,1
53591,31512,22079,58.80091806,41.19908194,Food,1,1
153797,6846,146951,4.451322197,95.5486778,Healthcare,2,0
174130,21582,152548,12.39418825,87.60581175,Healthcare,2,0
174725,5334,169391,3.052797253,96.94720275,Healthcare,2,0
46731,21095,25636,45.14134087,54.85865913,Food,1,1
231743,21791,209952,9.403088766,90.59691123,Entertainment,0,0
142839,55848,86991,39.09856552,60.90143448,Healthcare,2,2
20282,7689,12593,37.91046248,62.08953752,Housing,3,3
71364,11181,60183,15.66756348,84.33243652,Transportation,4,4
129869,25634,104235,19.73835172,80.26164828,Healthcare,2,2
106580,15526,91054,14.56746106,85.43253894,Transportation,4,2
34817,1432,33385,4.112933337,95.88706666,Food,1,1
220679,10952,209727,4.962864613,95.03713539,Entertainment,0,0
111246,61293,49953,55.09681247,44.90318753,Transportation,4,4
76432,40114,36318,52.48325309,47.51674691,Transportation,4,4
23312,9806,13506,42.06417296,57.93582704,Housing,3,3
118840,42977,75863,36.16374958,63.83625042,Transportation,4,2
232490,56687,175803,24.38255409,75.61744591,Entertainment,0,0
215126,42404,172722,19.71123899,80.28876101,Entertainment,0,0
55156,29878,25278,54.16999057,45.83000943,Food,1,4
61838,11463,50375,18.53714544,81.46285456,Transportation,4,4
53288,10849,42439,20.3591803,79.6408197,Food,1,4
234531,12610,221921,5.376687943,94.62331206,Entertainment,0,0
65659,31431,34228,47.87005589,52.12994411,Transportation,4,4
20987,2599,18388,12.38385667,87.61614333,Housing,3,3
124659,25962,98697,20.82641446,79.17358554,Healthcare,2,2
48889,26796,22093,54.80987543,45.19012457,Food,1,1
38382,7390,30992,19.25381689,80.74618311,Food,1,1
139490,5198,134292,3.726432002,96.273568,Healthcare,2,2
19309,7952,11357,41.18286809,58.81713191,Housing,3,3
165249,14642,150607,8.860567991,91.13943201,Healthcare,2,0
10930,5328,5602,48.74656908,51.25343092,Housing,3,3
103150,18131,85019,17.57731459,82.42268541,Transportation,4,2
79260,39004,40256,49.2101943,50.7898057,Transportation,4,4
33900,19296,14604,56.92035398,43.07964602,Food,1,1
49928,23251,26677,46.56905945,53.43094055,Food,1,1
56725,27414,29311,48.32789775,51.67210225,Food,1,4
30932,15447,15485,49.93857494,50.06142506,Food,1,1
216125,29732,186393,13.75685367,86.24314633,Entertainment,0,0
168733,25787,142946,15.28272478,84.71727522,Healthcare,2,0
27942,10432,17510,37.33447856,62.66552144,Housing,3,1
227781,3449,224332,1.514173702,98.4858263,Entertainment,0,0
27306,13033,14273,47.72943675,52.27056325,Housing,3,1
34384,17433,16951,50.7009074,49.2990926,Food,1,1
65953,21031,44922,31.88785954,68.11214046,Transportation,4,4
29795,14037,15758,47.11193153,52.88806847,Housing,3,1
105545,61129,44416,57.91747596,42.08252404,Transportation,4,4
139860,41190,98670,29.45087945,70.54912055,Healthcare,2,2
247438,60901,186537,24.61263023,75.38736977,Entertainment,0,0
177402,33194,144208,18.71117575,81.28882425,Healthcare,2,0
13978,7292,6686,52.16769209,47.83230791,Housing,3,3
27773,11418,16355,41.11187124,58.88812876,Housing,3,1
31172,5722,25450,18.35621712,81.64378288,Food,1,1
18325,1306,17019,7.126875853,92.87312415,Housing,3,3
64049,4172,59877,6.5137629,93.4862371,Transportation,4,4
43758,4394,39364,10.04159239,89.95840761,Food,1,1
164282,29984,134298,18.25154308,81.74845692,Healthcare,2,0
41254,240,41014,0.581761769,99.41823823,Food,1,4
38928,23031,15897,59.16307028,40.83692972,Food,1,1
197569,62358,135211,31.56264394,68.43735606,Entertainment,0,0
58285,29490,28795,50.59620829,49.40379171,Food,1,4
38149,6881,31268,18.03717004,81.96282996,Food,1,1
187670,18204,169466,9.700005329,90.29999467,Entertainment,0,0
54084,12151,41933,22.46690334,77.53309666,Food,1,4
113859,62689,51170,55.05844949,44.94155051,Transportation,4,4
17071,535,16536,3.13396989,96.86603011,Housing,3,3
28843,7781,21062,26.97708283,73.02291717,Housing,3,1
191009,13237,177772,6.930039946,93.06996005,Entertainment,0,0
37997,7258,30739,19.10150801,80.89849199,Food,1,1
153328,11440,141888,7.461129083,92.53887092,Healthcare,2,0
18522,196,18326,1.058201058,98.94179894,Housing,3,3
17215,2457,14758,14.27243683,85.72756317,Housing,3,3
15015,5494,9521,36.59007659,63.40992341,Housing,3,3
186018,48353,137665,25.99372104,74.00627896,Entertainment,0,0
149977,2407,147570,1.604912753,98.39508725,Healthcare,2,2
80787,9524,71263,11.78902546,88.21097454,Transportation,4,4
36906,18357,18549,49.73987969,50.26012031,Food,1,1
34038,10957,23081,32.19049298,67.80950702,Food,1,1
39250,14289,24961,36.40509554,63.59490446,Food,1,1
79135,7817,71318,9.878056486,90.12194351,Transportation,4,4
105025,25110,79915,23.90859319,76.09140681,Transportation,4,2
232533,8920,223613,3.836014673,96.16398533,Entertainment,0,0
112397,15291,97106,13.60445563,86.39554437,Transportation,4,2
128348,11154,117194,8.690435379,91.30956462,Healthcare,2,2
15474,5810,9664,37.54685279,62.45314721,Housing,3,3
45171,5714,39457,12.64970888,87.35029112,Food,1,1
51388,16769,34619,32.63213202,67.36786798,Food,1,4
138073,5619,132454,4.069586378,95.93041362,Healthcare,2,2
11223,4059,7164,36.16680032,63.83319968,Housing,3,3
145339,37237,108102,25.62079002,74.37920998,Healthcare,2,2
35676,18911,16765,53.00762417,46.99237583,Food,1,1
246087,48542,197545,19.72554422,80.27445578,Entertainment,0,0
144506,1222,143284,0.845639627,99.15436037,Healthcare,2,2
77844,34496,43348,44.31426956,55.68573044,Transportation,4,4
56959,29254,27705,51.35975,48.64025,Food,1,4
175821,2628,173193,1.494701998,98.505298,Healthcare,2,0
51807,19606,32201,37.84430675,62.15569325,Food,1,4
16483,6481,10002,39.31929867,60.68070133,Housing,3,3
26312,10567,15745,40.1603831,59.8396169,Housing,3,1
249371,69884,179487,28.02410866,71.97589134,Entertainment,0,0
46084,19789,26295,42.94115094,57.05884906,Food,1,1
104297,14917,89380,14.30242481,85.69757519,Transportation,4,2
133627,1890,131737,1.414384817,98.58561518,Healthcare,2,2
20819,5429,15390,26.07714107,73.92285893,Housing,3,3
38051,9660,28391,25.38698063,74.61301937,Food,1,1
47222,24281,22941,51.41883021,48.58116979,Food,1,1
218481,46104,172377,21.1020638,78.8979362,Entertainment,0,0
174944,23003,151941,13.14877904,86.85122096,Healthcare,2,0
192799,36258,156541,18.80611414,81.19388586,Entertainment,0,0
69073,8343,60730,12.07852562,87.92147438,Transportation,4,4
229418,16413,213005,7.154190168,92.84580983,Entertainment,0,0
54545,29998,24547,54.99679164,45.00320836,Food,1,4
135308,69272,66036,51.19579034,48.80420966,Healthcare,2,4
82642,7507,75135,9.083758864,90.91624114,Transportation,4,4
58069,30342,27727,52.25163168,47.74836832,Food,1,4
53536,6697,46839,12.50933951,87.49066049,Food,1,4
240841,63663,177178,26.43362218,73.56637782,Entertainment,0,0
234133,25519,208614,10.89936062,89.10063938,Entertainment,0,0
72277,26989,45288,37.34106286,62.65893714,Transportation,4,4
24656,14644,10012,59.39325114,40.60674886,Housing,3,3
249915,51646,198269,20.66542624,79.33457376,Entertainment,0,0
141591,6945,134646,4.904972774,95.09502723,Healthcare,2,2
64641,34464,30177,53.31600687,46.68399313,Transportation,4,4
55089,13048,42041,23.68530923,76.31469077,Food,1,4
15415,6134,9281,39.79240999,60.20759001,Housing,3,3
149880,19323,130557,12.89231385,87.10768615,Healthcare,2,2
233782,49341,184441,21.10555988,78.89444012,Entertainment,0,0
85388,11439,73949,13.39649599,86.60350401,Transportation,4,4
119644,62364,57280,52.12463642,47.87536358,Transportation,4,4
85001,20936,64065,24.63029847,75.36970153,Transportation,4,4
209075,58878,150197,28.16118618,71.83881382,Entertainment,0,0
69840,14302,55538,20.47823597,79.52176403,Transportation,4,4
59506,27306,32200,45.88780963,54.11219037,Food,1,4
230655,3791,226864,1.643580239,98.35641976,Entertainment,0,0
79471,13560,65911,17.06282795,82.93717205,Transportation,4,4
106074,50973,55101,48.05418859,51.94581141,Transportation,4,4
12110,3046,9064,25.15276631,74.84723369,Housing,3,3
198604,61338,137266,30.88457433,69.11542567,Entertainment,0,0
89872,23716,66156,26.38864162,73.61135838,Transportation,4,4
13224,214,13010,1.618269812,98.38173019,Housing,3,3
138066,23217,114849,16.81587067,83.18412933,Healthcare,2,2
142739,3187,139552,2.232746481,97.76725352,Healthcare,2,2
15890,4186,11704,26.34361233,73.65638767,Housing,3,3
146765,56771,89994,38.68156577,61.31843423,Healthcare,2,2
50009,22502,27507,44.99590074,55.00409926,Food,1,4
47180,14244,32936,30.1907588,69.8092412,Food,1,1
121884,11310,110574,9.279314758,90.72068524,Healthcare,2,2
57132,1210,55922,2.117902401,97.8820976,Food,1,4
53569,22163,31406,41.3728089,58.6271911,Food,1,4
28326,15819,12507,55.84621902,44.15378098,Housing,3,1
24019,6491,17528,27.02443899,72.97556101,Housing,3,3
18226,5373,12853,29.47986393,70.52013607,Housing,3,3
89401,35238,54163,39.41566649,60.58433351,Transportation,4,4
14021,6875,7146,49.03359247,50.96640753,Housing,3,3
56766,2645,54121,4.659479266,95.34052073,Food,1,4
174092,49555,124537,28.46483469,71.53516531,Healthcare,2,0
44226,7731,36495,17.48066748,82.51933252,Food,1,1
36582,17579,19003,48.05368761,51.94631239,Food,1,1
10395,6029,4366,57.999038,42.000962,Housing,3,3
178916,45246,133670,25.28896242,74.71103758,Healthcare,2,0
49173,3842,45331,7.813230838,92.18676916,Food,1,4
18943,5350,13593,28.2426226,71.7573774,Housing,3,3
164468,64013,100455,38.92124912,61.07875088,Healthcare,2,0
14236,3967,10269,27.86597359,72.13402641,Housing,3,3
190775,2944,187831,1.543179138,98.45682086,Entertainment,0,0
24935,10980,13955,44.03448967,55.96551033,Housing,3,3
132956,2205,130751,1.658443395,98.34155661,Healthcare,2,2
43326,3082,40244,7.113511517,92.88648848,Food,1,1
246103,12647,233456,5.138905255,94.86109474,Entertainment,0,0
112165,47136,65029,42.02380422,57.97619578,Transportation,4,4
16477,9553,6924,57.97778722,42.02221278,Housing,3,3
47726,10097,37629,21.15618321,78.84381679,Food,1,1
171733,26620,145113,15.50080648,84.49919352,Healthcare,2,0
238147,54829,183318,23.02317476,76.97682524,Entertainment,0,0
167126,46437,120689,27.78562282,72.21437718,Healthcare,2,0
206849,24649,182200,11.91642212,88.08357788,Entertainment,0,0
120399,22145,98254,18.39300991,81.60699009,Healthcare,2,2
97853,14575,83278,14.89479117,85.10520883,Transportation,4,4
32893,9150,23743,27.81746876,72.18253124,Food,1,1
17202,4779,12423,27.7816533,72.2183467,Housing,3,3
69554,23320,46234,33.52790637,66.47209363,Transportation,4,4
120208,59690,60518,49.65559697,50.34440303,Healthcare,2,4
15707,5107,10600,32.51416566,67.48583434,Housing,3,3
241101,67361,173740,27.93891357,72.06108643,Entertainment,0,0
24473,8711,15762,35.59432844,64.40567156,Housing,3,3
231109,28373,202736,12.27689099,87.72310901,Entertainment,0,0
11342,801,10541,7.062246517,92.93775348,Housing,3,3
240350,68198,172152,28.37445392,71.62554608,Entertainment,0,0
12192,6570,5622,53.88779528,46.11220472,Housing,3,3
18325,7249,11076,39.5579809,60.4420191,Housing,3,3
11978,5879,6099,49.08164969,50.91835031,Housing,3,3
12110,715,11395,5.904211396,94.0957886,Housing,3,3
62141,15832,46309,25.47754301,74.52245699,Transportation,4,4
28607,6070,22537,21.21858286,78.78141714,Housing,3,1
223430,56099,167331,25.10808754,74.89191246,Entertainment,0,0
126807,19378,107429,15.28149077,84.71850923,Healthcare,2,2
108145,45992,62153,42.52808729,57.47191271,Transportation,4,4
36177,14813,21364,40.94590486,59.05409514,Food,1,1
28682,11518,17164,40.15759013,59.84240987,Housing,3,1
140154,25979,114175,18.53603893,81.46396107,Healthcare,2,2
119795,9411,110384,7.855920531,92.14407947,Transportation,4,2
14610,4425,10185,30.28747433,69.71252567,Housing,3,3
54559,29687,24872,54.41265419,45.58734581,Food,1,4
103922,12707,91215,12.22743981,87.77256019,Transportation,4,2
176634,64496,112138,36.51392144,63.48607856,Healthcare,2,0
236580,62014,174566,26.21269761,73.78730239,Entertainment,0,0
58499,650,57849,1.111130105,98.8888699,Food,1,4
19292,9468,9824,49.07733776,50.92266224,Housing,3,3
131886,57941,73945,43.93263879,56.06736121,Healthcare,2,2
33718,15084,18634,44.73574945,55.26425055,Food,1,1
51305,25195,26110,49.10827405,50.89172595,Food,1,4
86669,27616,59053,31.86375751,68.13624249,Transportation,4,4
231046,31762,199284,13.74704604,86.25295396,Entertainment,0,0
59679,14744,44935,24.7055078,75.2944922,Food,1,4
233827,27873,205954,11.92035137,88.07964863,Entertainment,0,0
128406,3570,124836,2.780243914,97.21975609,Healthcare,2,2
216353,61479,154874,28.41606079,71.58393921,Entertainment,0,0
199685,47276,152409,23.67528858,76.32471142,Entertainment,0,0
108410,43086,65324,39.74356609,60.25643391,Transportation,4,4
89678,46120,43558,51.42844399,48.57155601,Transportation,4,4
13330,7775,5555,58.32708177,41.67291823,Housing,3,3
40645,8528,32117,20.98167056,79.01832944,Food,1,1
121918,48846,73072,40.06463361,59.93536639,Healthcare,2,2
171410,5314,166096,3.100169185,96.89983082,Healthcare,2,0
18072,10333,7739,57.17684816,42.82315184,Housing,3,3
134911,51976,82935,38.52613945,61.47386055,Healthcare,2,2
57521,16547,40974,28.76688514,71.23311486,Food,1,4
10639,4590,6049,43.14315255,56.85684745,Housing,3,3
220851,26682,194169,12.08144858,87.91855142,Entertainment,0,0
222958,36036,186922,16.16268535,83.83731465,Entertainment,0,0
32979,12928,20051,39.20070348,60.79929652,Food,1,1
52369,8409,43960,16.05720942,83.94279058,Food,1,4
179661,2583,177078,1.437707683,98.56229232,Healthcare,2,0
97093,37650,59443,38.7772548,61.2227452,Transportation,4,4
211705,65183,146522,30.78954205,69.21045795,Entertainment,0,0
83677,50034,33643,59.79420868,40.20579132,Transportation,4,4
19998,747,19251,3.735373537,96.26462646,Housing,3,3
161318,33198,128120,20.5792286,79.4207714,Healthcare,2,0
138937,14386,124551,10.35433326,89.64566674,Healthcare,2,2
49550,20671,28879,41.71745711,58.28254289,Food,1,1
201682,68240,133442,33.83544392,66.16455608,Entertainment,0,0
54774,15075,39699,27.52218206,72.47781794,Food,1,4
24870,12375,12495,49.75874548,50.24125452,Housing,3,3
165892,42784,123108,25.79027319,74.20972681,Healthcare,2,0
84137,44423,39714,52.79841211,47.20158789,Transportation,4,4
162241,13464,148777,8.298765417,91.70123458,Healthcare,2,0
10683,6308,4375,59.04708415,40.95291585,Housing,3,3
83056,33425,49631,40.24393181,59.75606819,Transportation,4,4
166145,14556,151589,8.761021999,91.238978,Healthcare,2,0
55937,3083,52854,5.511557645,94.48844235,Food,1,4
16319,699,15620,4.283350696,95.7166493,Housing,3,3
42248,15082,27166,35.6987313,64.3012687,Food,1,1
22409,9931,12478,44.31701548,55.68298452,Housing,3,3
19201,1051,18150,5.473673246,94.52632675,Housing,3,3
137341,21297,116044,15.50665861,84.49334139,Healthcare,2,2
65797,22839,42958,34.71130903,65.28869097,Transportation,4,4
16142,6235,9907,38.62594474,61.37405526,Housing,3,3
198198,40220,157978,20.29283847,79.70716153,Entertainment,0,0
59100,3383,55717,5.724196277,94.27580372,Food,1,4
25199,7235,17964,28.7114568,71.2885432,Housing,3,1
53241,24656,28585,46.31017449,53.68982551,Food,1,4
56704,17485,39219,30.83556716,69.16443284,Food,1,4
24621,10399,14222,42.23630234,57.76369766,Housing,3,3
65698,11264,54434,17.14511857,82.85488143,Transportation,4,4
138887,15044,123843,10.83182731,89.16817269,Healthcare,2,2
228870,21630,207240,9.450779919,90.54922008,Entertainment,0,0
22875,469,22406,2.050273224,97.94972678,Housing,3,3
42960,13343,29617,31.05912477,68.94087523,Food,1,1
240627,45,240582,0.018701143,99.98129886,Entertainment,0,0
162505,43389,119116,26.70010154,73.29989846,Healthcare,2,0
68767,24444,44323,35.5461195,64.4538805,Transportation,4,4
32024,15516,16508,48.45116163,51.54883837,Food,1,1
86298,33518,52780,38.83983406,61.16016594,Transportation,4,4
219102,63655,155447,29.05267866,70.94732134,Entertainment,0,0
121974,13732,108242,11.25813698,88.74186302,Healthcare,2,2
226627,24093,202534,10.63112515,89.36887485,Entertainment,0,0
44645,15659,28986,35.07447643,64.92552357,Food,1,1
19794,11578,8216,58.49247247,41.50752753,Housing,3,3
229485,14095,215390,6.142013639,93.85798636,Entertainment,0,0
137483,6746,130737,4.906788476,95.09321152,Healthcare,2,2
46525,4459,42066,9.584094573,90.41590543,Food,1,4
45206,762,44444,1.685616954,98.31438305,Food,1,4
39984,6220,33764,15.55622249,84.44377751,Food,1,1
119286,25096,94190,21.03851248,78.96148752,Transportation,4,2
190567,14600,175967,7.661347453,92.33865255,Entertainment,0,0
172320,54000,118320,31.33704735,68.66295265,Healthcare,2,0
205310,33490,171820,16.31191856,83.68808144,Entertainment,0,0
27747,2894,24853,10.42995639,89.57004361,Housing,3,1
31031,15556,15475,50.13051465,49.86948535,Food,1,1
179144,31174,147970,17.40164337,82.59835663,Healthcare,2,0
33109,8375,24734,25.29523694,74.70476306,Food,1,1
90428,4471,85957,4.944265051,95.05573495,Transportation,4,4
22138,6571,15567,29.68199476,70.31800524,Housing,3,3
148753,29295,119458,19.69372046,80.30627954,Healthcare,2,2
79227,37032,42195,46.74164111,53.25835889,Transportation,4,4
27915,73,27842,0.26150815,99.73849185,Housing,3,1
16047,8827,7220,55.00716645,44.99283355,Housing,3,3
35284,3942,31342,11.1722027,88.8277973,Food,1,1
126055,48202,77853,38.23886399,61.76113601,Healthcare,2,2
173862,46745,127117,26.88626612,73.11373388,Healthcare,2,0
44253,24348,19905,55.01999864,44.98000136,Food,1,1
46530,7310,39220,15.71029443,84.28970557,Food,1,1
104075,29233,74842,28.08839779,71.91160221,Transportation,4,2
202839,2655,200184,1.308919882,98.69108012,Entertainment,0,0
71826,42368,29458,58.98699635,41.01300365,Transportation,4,4
46327,14679,31648,31.68562609,68.31437391,Food,1,1
28639,10245,18394,35.7728971,64.2271029,Housing,3,1
193909,56377,137532,29.07394706,70.92605294,Entertainment,0,0
16297,4769,11528,29.26305455,70.73694545,Housing,3,3
57734,25077,32657,43.43541068,56.56458932,Food,1,4
135585,16777,118808,12.37378766,87.62621234,Healthcare,2,2
120496,5662,114834,4.698911167,95.30108883,Healthcare,2,2
32516,2672,29844,8.217492927,91.78250707,Food,1,1
44984,3749,41235,8.334074338,91.66592566,Food,1,4
89119,36839,52280,41.33686419,58.66313581,Transportation,4,4
199130,32646,166484,16.39431527,83.60568473,Entertainment,0,0
246113,27787,218326,11.29034224,88.70965776,Entertainment,0,0
40290,5417,34873,13.44502358,86.55497642,Food,1,1
47787,5303,42484,11.09716032,88.90283968,Food,1,4
220453,6528,213925,2.961175398,97.0388246,Entertainment,0,0
129249,53597,75652,41.46801909,58.53198091,Healthcare,2,2
25002,7779,17223,31.11351092,68.88648908,Housing,3,3
104094,35710,68384,34.30553154,65.69446846,Transportation,4,2
148283,17632,130651,11.89077642,88.10922358,Healthcare,2,2
14966,6904,8062,46.13123079,53.86876921,Housing,3,3
148826,37300,111526,25.06282504,74.93717496,Healthcare,2,2
183546,45576,137970,24.8308326,75.1691674,Entertainment,0,0
80922,13999,66923,17.29937471,82.70062529,Transportation,4,4
222227,54240,167987,24.40747524,75.59252476,Entertainment,0,0
84139,17832,66307,21.19350123,78.80649877,Transportation,4,4
117916,69566,48350,58.99623461,41.00376539,Transportation,4,4
19965,650,19315,3.255697471,96.74430253,Housing,3,3
89328,14244,75084,15.9457281,84.0542719,Transportation,4,4
190849,32172,158677,16.85730604,83.14269396,Entertainment,0,0
25476,8932,16544,35.06044905,64.93955095,Housing,3,1
45191,22912,22279,50.70036069,49.29963931,Food,1,1
213582,47402,166180,22.19381783,77.80618217,Entertainment,0,0
184263,35883,148380,19.47379561,80.52620439,Entertainment,0,0
98286,43417,54869,44.17414484,55.82585516,Transportation,4,4
122848,28931,93917,23.55024095,76.44975905,Healthcare,2,2
109920,15282,94638,13.90283843,86.09716157,Transportation,4,2
140514,67631,72883,48.13114707,51.86885293,Healthcare,2,2
225829,66159,159670,29.29606029,70.70393971,Entertainment,0,0
41724,1254,40470,3.005464481,96.99453552,Food,1,1
232332,37613,194719,16.18933251,83.81066749,Entertainment,0,0
15947,4563,11384,28.61353233,71.38646767,Housing,3,3
198071,53028,145043,26.77221804,73.22778196,Entertainment,0,0
22069,4912,17157,22.25746522,77.74253478,Housing,3,3
42719,19884,22835,46.54603338,53.45396662,Food,1,1
138236,10582,127654,7.65502474,92.34497526,Healthcare,2,2
47506,4971,42535,10.4639414,89.5360586,Food,1,4
131947,37568,94379,28.47203802,71.52796198,Healthcare,2,2
245875,59356,186519,24.14072191,75.85927809,Entertainment,0,0
207610,48487,159123,23.35484803,76.64515197,Entertainment,0,0
77842,33,77809,0.042393566,99.95760643,Transportation,4,4
41537,849,40688,2.043960806,97.95603919,Food,1,4
241540,64999,176541,26.91024261,73.08975739,Entertainment,0,0
70056,3729,66327,5.32288455,94.67711545,Transportation,4,4
12996,4837,8159,37.21914435,62.78085565,Housing,3,3
107201,50304,56897,46.9249354,53.0750646,Transportation,4,4
13304,4773,8531,35.87642814,64.12357186,Housing,3,3
19465,2959,16506,15.20164398,84.79835602,Housing,3,3
18973,5810,13163,30.6224635,69.3775365,Housing,3,3
59718,35049,24669,58.69084698,41.30915302,Food,1,4
20587,3306,17281,16.05867781,83.94132219,Housing,3,3
169504,48896,120608,28.8465169,71.1534831,Healthcare,2,0
167431,23671,143760,14.13776421,85.86223579,Healthcare,2,0
60887,16876,44011,27.71691823,72.28308177,Transportation,4,4
94068,35501,58567,37.7397202,62.2602798,Transportation,4,4
94830,14108,80722,14.87714858,85.12285142,Transportation,4,4
211502,38386,173116,18.14923736,81.85076264,Entertainment,0,0
50843,17459,33384,34.33904372,65.66095628,Food,1,4
50574,20873,29701,41.2721952,58.7278048,Food,1,4
21278,6128,15150,28.79969922,71.20030078,Housing,3,3
167845,21584,146261,12.85948345,87.14051655,Healthcare,2,0
203110,19728,183382,9.712963419,90.28703658,Entertainment,0,0
200179,20282,179897,10.13193192,89.86806808,Entertainment,0,0
175897,21727,154170,12.35211516,87.64788484,Healthcare,2,0
37160,17080,20080,45.96340151,54.03659849,Food,1,1
27230,4509,22721,16.55894234,83.44105766,Housing,3,1
175688,8773,166915,4.993511224,95.00648878,Healthcare,2,0
149478,54672,94806,36.57528198,63.42471802,Healthcare,2,2
179689,56555,123134,31.47382422,68.52617578,Healthcare,2,0
37544,5755,31789,15.32868101,84.67131899,Food,1,1
213536,26382,187154,12.35482542,87.64517458,Entertainment,0,0
21168,6719,14449,31.74130763,68.25869237,Housing,3,3
233839,48479,185360,20.73178554,79.26821446,Entertainment,0,0
230781,12836,217945,5.561983006,94.43801699,Entertainment,0,0
183716,36202,147514,19.70541488,80.29458512,Entertainment,0,0
190253,43948,146305,23.09976715,76.90023285,Entertainment,0,0
79835,29801,50034,37.32823949,62.67176051,Transportation,4,4
221052,27689,193363,12.52601198,87.47398802,Entertainment,0,0
218583,62581,156002,28.63031434,71.36968566,Entertainment,0,0
132078,67177,64901,50.86161208,49.13838792,Healthcare,2,4
54191,16962,37229,31.30040044,68.69959956,Food,1,4
212193,58460,153733,27.55039045,72.44960955,Entertainment,0,0
78498,11128,67370,14.17615735,85.82384265,Transportation,4,4
29645,4344,25301,14.65339855,85.34660145,Housing,3,1
78286,46417,31869,59.29157193,40.70842807,Transportation,4,4
64984,11908,53076,18.32451065,81.67548935,Transportation,4,4
34160,14378,19782,42.09016393,57.90983607,Food,1,1
167471,17696,149775,10.56660556,89.43339444,Healthcare,2,0
150139,60738,89401,40.45451215,59.54548785,Healthcare,2,0
120711,35760,84951,29.62447499,70.37552501,Healthcare,2,2
38435,15055,23380,39.17002732,60.82997268,Food,1,1
166380,68795,97585,41.34811876,58.65188124,Healthcare,2,0
39804,20315,19489,51.03758416,48.96241584,Food,1,1
125261,31250,94011,24.94790877,75.05209123,Healthcare,2,2
171967,67689,104278,39.36162171,60.63837829,Healthcare,2,0
157830,8325,149505,5.274662612,94.72533739,Healthcare,2,0
206587,11211,195376,5.426769351,94.57323065,Entertainment,0,0
214341,15838,198503,7.389160263,92.61083974,Entertainment,0,0
242089,27443,214646,11.33591365,88.66408635,Entertainment,0,0
119726,1435,118291,1.198570068,98.80142993,Transportation,4,2
44399,11663,32736,26.26860965,73.73139035,Food,1,1
22394,837,21557,3.737608288,96.26239171,Housing,3,3
38008,16323,21685,42.94622185,57.05377815,Food,1,1
227710,8940,218770,3.926046287,96.07395371,Entertainment,0,0
101838,2105,99733,2.067008386,97.93299161,Transportation,4,2
51609,23987,27622,46.47832742,53.52167258,Food,1,4
234533,63972,170561,27.27633212,72.72366788,Entertainment,0,0
50443,7828,42615,15.51850604,84.48149396,Food,1,4
28572,6562,22010,22.96654067,77.03345933,Housing,3,1
92614,33048,59566,35.68358995,64.31641005,Transportation,4,4
122349,27524,94825,22.49630156,77.50369844,Healthcare,2,2
164871,20155,144716,12.22470901,87.77529099,Healthcare,2,0
75581,29521,46060,39.05875815,60.94124185,Transportation,4,4
194896,317,194579,0.16265085,99.83734915,Entertainment,0,0
75585,17011,58574,22.50578819,77.49421181,Transportation,4,4
56296,7184,49112,12.7611198,87.2388802,Food,1,4
15397,4028,11369,26.16094044,73.83905956,Housing,3,3
41011,9938,31073,24.23252298,75.76747702,Food,1,1
189646,60700,128946,32.00700252,67.99299748,Entertainment,0,0
15805,4622,11183,29.24391016,70.75608984,Housing,3,3
139769,46733,93036,33.43588349,66.56411651,Healthcare,2,2
218432,53611,164821,24.54356505,75.45643495,Entertainment,0,0
88716,22063,66653,24.86924568,75.13075432,Transportation,4,4
83278,19484,63794,23.39633517,76.60366483,Transportation,4,4
183858,46923,136935,25.52132624,74.47867376,Entertainment,0,0
29101,14846,14255,51.01542902,48.98457098,Housing,3,1
200455,18008,182447,8.983562396,91.0164376,Entertainment,0,0
52195,26164,26031,50.12740684,49.87259316,Food,1,4
97092,52877,44215,54.46071767,45.53928233,Transportation,4,4
140287,45590,94697,32.4976655,67.5023345,Healthcare,2,2
238922,2029,236893,0.84923113,99.15076887,Entertainment,0,0
188102,63006,125096,33.49565661,66.50434339,Entertainment,0,0
12128,1955,10173,16.11972296,83.88027704,Housing,3,3
202099,12018,190081,5.946590532,94.05340947,Entertainment,0,0
236986,50839,186147,21.45232208,78.54767792,Entertainment,0,0
150262,4395,145867,2.92489119,97.07510881,Healthcare,2,0
153012,13517,139495,8.833947664,91.16605234,Healthcare,2,0
65431,11469,53962,17.52838868,82.47161132,Transportation,4,4
245123,28235,216888,11.51870693,88.48129307,Entertainment,0,0
100313,57579,42734,57.39934007,42.60065993,Transportation,4,4
11688,6591,5097,56.39117043,43.60882957,Housing,3,3
29817,7913,21904,26.53855183,73.46144817,Housing,3,1
170137,24072,146065,14.14859789,85.85140211,Healthcare,2,0
22448,1124,21324,5.007127584,94.99287242,Housing,3,3
163922,25007,138915,15.25542636,84.74457364,Healthcare,2,0
145060,24860,120200,17.13773611,82.86226389,Healthcare,2,2
111517,30560,80957,27.40389358,72.59610642,Transportation,4,2
157099,32807,124292,20.88301008,79.11698992,Healthcare,2,0
78765,42438,36327,53.87926109,46.12073891,Transportation,4,4
69863,34671,35192,49.62712738,50.37287262,Transportation,4,4
237175,12507,224668,5.273321387,94.72667861,Entertainment,0,0
226397,21038,205359,9.292525961,90.70747404,Entertainment,0,0
25310,12993,12317,51.33544054,48.66455946,Housing,3,1
82675,44797,37878,54.18445721,45.81554279,Transportation,4,4
161186,69424,91762,43.07073815,56.92926185,Healthcare,2,0
238672,64031,174641,26.82803178,73.17196822,Entertainment,0,0
91484,262,91222,0.286388877,99.71361112,Transportation,4,4
51436,5014,46422,9.748036395,90.25196361,Food,1,4
22459,7148,15311,31.82688455,68.17311545,Housing,3,3
57958,19175,38783,33.08430243,66.91569757,Food,1,4
64648,31779,32869,49.15697315,50.84302685,Transportation,4,4
104893,6631,98262,6.321680188,93.67831981,Transportation,4,2
249998,28524,221474,11.40969128,88.59030872,Entertainment,0,0
81907,4140,77767,5.054513045,94.94548695,Transportation,4,4
103981,13472,90509,12.95621315,87.04378685,Transportation,4,2
11749,5985,5764,50.94050557,49.05949443,Housing,3,3
103360,17337,86023,16.77341331,83.22658669,Transportation,4,2
125568,16021,109547,12.7588239,87.2411761,Healthcare,2,2
165698,64277,101421,38.79165711,61.20834289,Healthcare,2,0
26162,15283,10879,58.41678771,41.58321229,Housing,3,1
49256,24107,25149,48.94226084,51.05773916,Food,1,1
31280,11864,19416,37.92838875,62.07161125,Food,1,1
41396,14860,26536,35.89718813,64.10281187,Food,1,1
101954,53247,48707,52.2264943,47.7735057,Transportation,4,4
20495,7172,13323,34.99390095,65.00609905,Housing,3,3
231291,4252,227039,1.838376763,98.16162324,Entertainment,0,0
97639,5547,92092,5.681131515,94.31886848,Transportation,4,4
52684,22552,30132,42.80616506,57.19383494,Food,1,4
36982,14491,22491,39.18392732,60.81607268,Food,1,1
22464,201,22263,0.894764957,99.10523504,Housing,3,3
42311,24754,17557,58.50488053,41.49511947,Food,1,1
12751,1221,11530,9.575719551,90.42428045,Housing,3,3
68310,12921,55389,18.91523935,81.08476065,Transportation,4,4
55224,5160,50064,9.343763581,90.65623642,Food,1,4
21022,2472,18550,11.7591095,88.2408905,Housing,3,3
162655,35914,126741,22.07986229,77.92013771,Healthcare,2,0
74103,37544,36559,50.66461547,49.33538453,Transportation,4,4
15908,8422,7486,52.94191602,47.05808398,Housing,3,3
130300,46096,84204,35.37682272,64.62317728,Healthcare,2,2
38401,4180,34221,10.8851332,89.1148668,Food,1,1
26669,3726,22943,13.97127751,86.02872249,Housing,3,1
13741,6843,6898,49.79986901,50.20013099,Housing,3,3
180760,210,180550,0.116176145,99.88382385,Entertainment,0,0
62330,27022,35308,43.35312049,56.64687951,Transportation,4,4
49340,23945,25395,48.53060397,51.46939603,Food,1,1
106235,36955,69280,34.78608745,65.21391255,Transportation,4,2
215174,29437,185737,13.6805562,86.3194438,Entertainment,0,0
192722,5171,187551,2.683139444,97.31686056,Entertainment,0,0
173309,2729,170580,1.574644133,98.42535587,Healthcare,2,0
137155,47380,89775,34.54485801,65.45514199,Healthcare,2,2
226085,47753,178332,21.12170201,78.87829799,Entertainment,0,0
190737,38871,151866,20.37937055,79.62062945,Entertainment,0,0
70299,39736,30563,56.52427488,43.47572512,Transportation,4,4
58719,3580,55139,6.096834074,93.90316593,Food,1,4
64920,22845,42075,35.18946396,64.81053604,Transportation,4,4
22228,10667,11561,47.98902285,52.01097715,Housing,3,3
219458,42174,177284,19.21734455,80.78265545,Entertainment,0,0
132640,60740,71900,45.79312425,54.20687575,Healthcare,2,2
148713,20418,128295,13.7298017,86.2701983,Healthcare,2,2
52170,27539,24631,52.78704236,47.21295764,Food,1,4
156184,27248,128936,17.44608923,82.55391077,Healthcare,2,0
50848,4924,45924,9.683763373,90.31623663,Food,1,4
17299,10354,6945,59.8531707,40.1468293,Housing,3,3
11735,6380,5355,54.36727738,45.63272262,Housing,3,3
78333,3869,74464,4.939169954,95.06083005,Transportation,4,4
55139,7185,47954,13.03070422,86.96929578,Food,1,4
38150,2214,35936,5.803407602,94.1965924,Food,1,1
10635,4067,6568,38.24165491,61.75834509,Housing,3,3
102605,30910,71695,30.12523756,69.87476244,Transportation,4,2
27526,1053,26473,3.825474097,96.1745259,Housing,3,1
207429,18321,189108,8.832419768,91.16758023,Entertainment,0,0
109721,46395,63326,42.28452165,57.71547835,Transportation,4,4
224065,47753,176312,21.31211925,78.68788075,Entertainment,0,0
49917,507,49410,1.015686039,98.98431396,Food,1,4
127680,6356,121324,4.978070175,95.02192982,Healthcare,2,2
236804,20399,216405,8.614297056,91.38570294,Entertainment,0,0
57925,22952,34973,39.62365127,60.37634873,Food,1,4
14259,5476,8783,38.40381513,61.59618487,Housing,3,3
187346,38534,148812,20.56836015,79.43163985,Entertainment,0,0
24654,10588,14066,42.94637787,57.05362213,Housing,3,3
28605,3419,25186,11.95245586,88.04754414,Housing,3,1
111435,27049,84386,24.2733432,75.7266568,Transportation,4,2
13219,4102,9117,31.03109161,68.96890839,Housing,3,3
216238,3891,212347,1.79940621,98.20059379,Entertainment,0,0
65799,21421,44378,32.55520601,67.44479399,Transportation,4,4
181323,31098,150225,17.15060969,82.84939031,Entertainment,0,0
85242,44434,40808,52.12688581,47.87311419,Transportation,4,4
34486,9326,25160,27.04285797,72.95714203,Food,1,1
231792,66673,165119,28.76415062,71.23584938,Entertainment,0,0
247793,9191,238602,3.709144326,96.29085567,Entertainment,0,0
160259,44090,116169,27.51171541,72.48828459,Healthcare,2,0
23077,5280,17797,22.87992373,77.12007627,Housing,3,3
33420,709,32711,2.121484141,97.87851586,Food,1,1
199377,7694,191683,3.85902085,96.14097915,Entertainment,0,0
62040,21080,40960,33.97807866,66.02192134,Transportation,4,4
37431,9971,27460,26.63834789,73.36165211,Food,1,1
113580,43978,69602,38.71984504,61.28015496,Transportation,4,4
95419,51914,43505,54.40635513,45.59364487,Transportation,4,4
63337,4768,58569,7.527985222,92.47201478,Transportation,4,4
153289,40321,112968,26.30390961,73.69609039,Healthcare,2,0
182892,6378,176514,3.487303983,96.51269602,Entertainment,0,0
202631,52279,150352,25.80009969,74.19990031,Entertainment,0,0
17244,8652,8592,50.17397356,49.82602644,Housing,3,3
160551,40697,119854,25.34833168,74.65166832,Healthcare,2,0
24310,11129,13181,45.7795146,54.2204854,Housing,3,3
41171,11565,29606,28.09016055,71.90983945,Food,1,1
39722,22344,17378,56.25094406,43.74905594,Food,1,1
164611,17861,146750,10.85042919,89.14957081,Healthcare,2,0
184550,63662,120888,34.4958006,65.5041994,Entertainment,0,0
66949,22164,44785,33.10579695,66.89420305,Transportation,4,4
63642,33539,30103,52.69947519,47.30052481,Transportation,4,4
115543,26731,88812,23.13510987,76.86489013,Transportation,4,2
157055,66102,90953,42.08844036,57.91155964,Healthcare,2,0
134739,47325,87414,35.12346091,64.87653909,Healthcare,2,2
36628,14495,22133,39.57355029,60.42644971,Food,1,1
128252,19839,108413,15.46876462,84.53123538,Healthcare,2,2
46742,20497,26245,43.85135424,56.14864576,Food,1,1
166884,45631,121253,27.3429448,72.6570552,Healthcare,2,0
205490,29676,175814,14.44157867,85.55842133,Entertainment,0,0
50843,20280,30563,39.8874968,60.1125032,Food,1,4
248991,35067,213924,14.08364158,85.91635842,Entertainment,0,0
59836,7712,52124,12.88856207,87.11143793,Food,1,4
74032,485,73547,0.655122109,99.34487789,Transportation,4,4
242416,7230,235186,2.982476404,97.0175236,Entertainment,0,0
210189,2532,207657,1.204630119,98.79536988,Entertainment,0,0
10899,4454,6445,40.86613451,59.13386549,Housing,3,3
244243,56010,188233,22.93207994,77.06792006,Entertainment,0,0
147918,51778,96140,35.00452954,64.99547046,Healthcare,2,2
234611,48150,186461,20.52333437,79.47666563,Entertainment,0,0
181249,37729,143520,20.81611485,79.18388515,Entertainment,0,0
68982,16324,52658,23.66414427,76.33585573,Transportation,4,4
98358,42147,56211,42.85060697,57.14939303,Transportation,4,4
107350,15519,91831,14.45645086,85.54354914,Transportation,4,2
142454,13564,128890,9.521670153,90.47832985,Healthcare,2,2
32196,9810,22386,30.46962356,69.53037644,Food,1,1
49399,10629,38770,21.51662989,78.48337011,Food,1,1
93891,47424,46467,50.50963351,49.49036649,Transportation,4,4
59198,8919,50279,15.06638738,84.93361262,Food,1,4
112718,35222,77496,31.24789297,68.75210703,Transportation,4,2
121312,51788,69524,42.6899235,57.3100765,Healthcare,2,4
221652,36673,184979,16.54530525,83.45469475,Entertainment,0,0
178890,59192,119698,33.08849013,66.91150987,Healthcare,2,0
234787,53039,181748,22.59026266,77.40973734,Entertainment,0,0
90627,2749,87878,3.033312368,96.96668763,Transportation,4,4
23385,3714,19671,15.88197563,84.11802437,Housing,3,3
230349,43775,186574,19.00377254,80.99622746,Entertainment,0,0
209641,2551,207090,1.216842125,98.78315787,Entertainment,0,0
143086,22308,120778,15.59062382,84.40937618,Healthcare,2,2
180834,46921,133913,25.94700112,74.05299888,Entertainment,0,0
65522,2893,62629,4.415310888,95.58468911,Transportation,4,4
157914,32996,124918,20.89491749,79.10508251,Healthcare,2,0
13600,6043,7557,44.43382353,55.56617647,Housing,3,3
23796,2169,21627,9.114977307,90.88502269,Housing,3,3
21210,1428,19782,6.732673267,93.26732673,Housing,3,3
17236,286,16950,1.659317707,98.34068229,Housing,3,3
216547,16506,200041,7.622363736,92.37763626,Entertainment,0,0
38555,18427,20128,47.79406043,52.20593957,Food,1,1
164775,35619,129156,21.61675011,78.38324989,Healthcare,2,0
116441,763,115678,0.655267475,99.34473253,Transportation,4,2
79079,5916,73163,7.481126468,92.51887353,Transportation,4,4
43777,14996,28781,34.25543093,65.74456907,Food,1,1
129854,53628,76226,41.2986893,58.7013107,Healthcare,2,2
10191,6050,4141,59.36610735,40.63389265,Housing,3,3
85072,1472,83600,1.730299041,98.26970096,Transportation,4,4
169892,38456,131436,22.63555671,77.36444329,Healthcare,2,0
12490,5533,6957,44.29943955,55.70056045,Housing,3,3
42192,23540,18652,55.79256731,44.20743269,Food,1,1
157253,44100,113153,28.04398008,71.95601992,Healthcare,2,0
142327,11437,130890,8.035720559,91.96427944,Healthcare,2,2
18536,3183,15353,17.17198964,82.82801036,Housing,3,3
43333,8656,34677,19.97553827,80.02446173,Food,1,1
191898,41496,150402,21.62398774,78.37601226,Entertainment,0,0
209223,32902,176321,15.72580452,84.27419548,Entertainment,0,0
151794,52068,99726,34.30175106,65.69824894,Healthcare,2,0
88667,46695,41972,52.66333585,47.33666415,Transportation,4,4
56225,29503,26722,52.47309916,47.52690084,Food,1,4
26527,14519,12008,54.73291364,45.26708636,Housing,3,1
33332,7570,25762,22.71090844,77.28909156,Food,1,1
125084,5675,119409,4.536951169,95.46304883,Healthcare,2,2
14554,3018,11536,20.73656727,79.26343273,Housing,3,3
51087,26645,24442,52.15612582,47.84387418,Food,1,4
202068,16163,185905,7.998792486,92.00120751,Entertainment,0,0
101882,8521,93361,8.363597103,91.6364029,Transportation,4,2
10705,2860,7845,26.71648762,73.28351238,Housing,3,3
129999,68187,61812,52.45194194,47.54805806,Healthcare,2,4
241128,68750,172378,28.51182774,71.48817226,Entertainment,0,0
14051,1269,12782,9.031385667,90.96861433,Housing,3,3
40176,18672,21504,46.47550777,53.52449223,Food,1,1
16262,6322,9940,38.87590702,61.12409298,Housing,3,3
125483,18740,106743,14.93429389,85.06570611,Healthcare,2,2
82787,17899,64888,21.62054429,78.37945571,Transportation,4,4
153321,9901,143420,6.457693336,93.54230666,Healthcare,2,0
93565,11127,82438,11.89226741,88.10773259,Transportation,4,4
119246,11689,107557,9.802425239,90.19757476,Transportation,4,2
130382,16273,114109,12.48101732,87.51898268,Healthcare,2,2
28334,3741,24593,13.20321875,86.79678125,Housing,3,1
177298,16588,160710,9.355999504,90.6440005,Healthcare,2,0
23503,6730,16773,28.63464239,71.36535761,Housing,3,3
49196,9584,39612,19.48125864,80.51874136,Food,1,1
14823,3452,11371,23.28813331,76.71186669,Housing,3,3
180458,44714,135744,24.7780647,75.2219353,Entertainment,0,0
49918,29622,20296,59.34131976,40.65868024,Food,1,1
233455,52953,180502,22.68231565,77.31768435,Entertainment,0,0
172604,18004,154600,10.43081273,89.56918727,Healthcare,2,0
147047,2989,144058,2.032683428,97.96731657,Healthcare,2,2
199270,29279,169991,14.69312992,85.30687008,Entertainment,0,0
175336,28861,146475,16.46039604,83.53960396,Healthcare,2,0
33880,8122,25758,23.97284534,76.02715466,Food,1,1
28923,14191,14732,49.06475815,50.93524185,Housing,3,1
12905,6570,6335,50.91049981,49.08950019,Housing,3,3
20682,3078,17604,14.88250653,85.11749347,Housing,3,3
34316,17862,16454,52.05152116,47.94847884,Food,1,1
212318,53268,159050,25.08878192,74.91121808,Entertainment,0,0
68057,29173,38884,42.86553918,57.13446082,Transportation,4,4
15388,5290,10098,34.37743696,65.62256304,Housing,3,3
142336,21383,120953,15.02290355,84.97709645,Healthcare,2,2
130949,34354,96595,26.23464097,73.76535903,Healthcare,2,2
50916,4490,46426,8.818446068,91.18155393,Food,1,4
29495,3049,26446,10.33734531,89.66265469,Housing,3,1
103532,60927,42605,58.84847197,41.15152803,Transportation,4,4
13555,7258,6297,53.54481741,46.45518259,Housing,3,3
33340,14910,18430,44.72105579,55.27894421,Food,1,1
142298,10759,131539,7.560893337,92.43910666,Healthcare,2,2
171618,54769,116849,31.91331912,68.08668088,Healthcare,2,0
241270,67312,173958,27.89903428,72.10096572,Entertainment,0,0
124726,16075,108651,12.88825105,87.11174895,Healthcare,2,2
21986,10528,11458,47.88501774,52.11498226,Housing,3,3
36442,19372,17070,53.15844355,46.84155645,Food,1,1
45584,23419,22165,51.37548263,48.62451737,Food,1,1
148422,37438,110984,25.22402339,74.77597661,Healthcare,2,2
211489,62419,149070,29.51406456,70.48593544,Entertainment,0,0
151878,63293,88585,41.67358011,58.32641989,Healthcare,2,0
228462,67534,160928,29.56027698,70.43972302,Entertainment,0,0
82028,43972,38056,53.60608573,46.39391427,Transportation,4,4
173476,48337,125139,27.86379672,72.13620328,Healthcare,2,0
104690,2886,101804,2.756710288,97.24328971,Transportation,4,2
226946,49675,177271,21.88846686,78.11153314,Entertainment,0,0
27075,3375,23700,12.46537396,87.53462604,Housing,3,1
28248,13419,14829,47.50424809,52.49575191,Housing,3,1
210636,15657,194979,7.433202302,92.5667977,Entertainment,0,0
190315,18810,171505,9.883614008,90.11638599,Entertainment,0,0
201367,29877,171490,14.8370885,85.1629115,Entertainment,0,0
243230,20851,222379,8.572544505,91.42745549,Entertainment,0,0
54327,11682,42645,21.50312,78.49688,Food,1,4
125491,23711,101780,18.89458208,81.10541792,Healthcare,2,2
30060,7289,22771,24.24817033,75.75182967,Food,1,1
198522,44545,153977,22.43831918,77.56168082,Entertainment,0,0
16217,169,16048,1.042116298,98.9578837,Housing,3,3
24204,13621,10583,56.27582218,43.72417782,Housing,3,3
96055,39252,56803,40.86408828,59.13591172,Transportation,4,4
14057,55,14002,0.391264139,99.60873586,Housing,3,3
219679,29940,189739,13.62897683,86.37102317,Entertainment,0,0
105503,59047,46456,55.9671289,44.0328711,Transportation,4,4
155322,41158,114164,26.49849989,73.50150011,Healthcare,2,0
207667,54048,153619,26.02628246,73.97371754,Entertainment,0,0
215895,16353,199542,7.574515389,92.42548461,Entertainment,0,0
216340,19250,197090,8.898030877,91.10196912,Entertainment,0,0
110154,28782,81372,26.12887412,73.87112588,Transportation,4,2
135512,14690,120822,10.84036838,89.15963162,Healthcare,2,2
217499,1056,216443,0.485519474,99.51448053,Entertainment,0,0
115250,53866,61384,46.73839479,53.26160521,Transportation,4,4
249600,38039,211561,15.23998397,84.76001603,Entertainment,0,0
239492,55535,183957,23.18866601,76.81133399,Entertainment,0,0
81213,13620,67593,16.77071405,83.22928595,Transportation,4,4
41072,9886,31186,24.06992598,75.93007402,Food,1,1
26339,10204,16135,38.74103041,61.25896959,Housing,3,1
13943,5957,7986,42.7239475,57.2760525,Housing,3,3
59946,28111,31835,46.89387115,53.10612885,Food,1,4
137921,43374,94547,31.44843787,68.55156213,Healthcare,2,2
166957,40774,126183,24.42185712,75.57814288,Healthcare,2,0
129079,53930,75149,41.78061497,58.21938503,Healthcare,2,2
52256,18511,33745,35.4236834,64.5763166,Food,1,4
62175,14292,47883,22.986731,77.013269,Transportation,4,4
211857,4123,207734,1.946124036,98.05387596,Entertainment,0,0
56598,5421,51177,9.578076964,90.42192304,Food,1,4
191297,9574,181723,5.004783138,94.99521686,Entertainment,0,0
55681,8310,47371,14.92430093,85.07569907,Food,1,4
133877,59077,74800,44.12781882,55.87218118,Healthcare,2,2
196471,33560,162911,17.08140133,82.91859867,Entertainment,0,0
38128,12293,25835,32.2413974,67.7586026,Food,1,1
12255,60,12195,0.489596083,99.51040392,Housing,3,3
11842,7074,4768,59.73653099,40.26346901,Housing,3,3
225516,61611,163905,27.32001277,72.67998723,Entertainment,0,0
10992,4744,6248,43.15866084,56.84133916,Housing,3,3
205364,23650,181714,11.5161372,88.4838628,Entertainment,0,0
26984,12265,14719,45.45286095,54.54713905,Housing,3,1
140492,48886,91606,34.79628733,65.20371267,Healthcare,2,2
106497,22430,84067,21.06162615,78.93837385,Transportation,4,2
22167,11644,10523,52.52853341,47.47146659,Housing,3,3
30609,10183,20426,33.26799307,66.73200693,Food,1,1
79098,30252,48846,38.2462262,61.7537738,Transportation,4,4
25496,14641,10855,57.42469407,42.57530593,Housing,3,1
214117,14256,199861,6.658042098,93.3419579,Entertainment,0,0
101598,55927,45671,55.04734345,44.95265655,Transportation,4,4
122860,8589,114271,6.990883933,93.00911607,Healthcare,2,2
43960,17459,26501,39.71565059,60.28434941,Food,1,1
135429,8811,126618,6.50599207,93.49400793,Healthcare,2,2
142019,36985,105034,26.04229012,73.95770988,Healthcare,2,2
93701,45356,48345,48.40503303,51.59496697,Transportation,4,4
34685,7745,26940,22.32953726,77.67046274,Food,1,1
56194,17152,39042,30.52283162,69.47716838,Food,1,4
67830,9941,57889,14.65575704,85.34424296,Transportation,4,4
13781,2057,11724,14.92634787,85.07365213,Housing,3,3
172650,54352,118298,31.48103099,68.51896901,Healthcare,2,0
54186,650,53536,1.199571845,98.80042815,Food,1,4
131122,24971,106151,19.04409634,80.95590366,Healthcare,2,2
46212,4845,41367,10.48428979,89.51571021,Food,1,4
139688,57465,82223,41.13810778,58.86189222,Healthcare,2,2
36728,17102,19626,46.56392943,53.43607057,Food,1,1
17982,9732,8250,54.12078745,45.87921255,Housing,3,3
138647,4264,134383,3.07543618,96.92456382,Healthcare,2,2
143087,65877,77210,46.03982193,53.96017807,Healthcare,2,2
25418,6672,18746,26.2491148,73.7508852,Housing,3,1
168389,27656,140733,16.42387567,83.57612433,Healthcare,2,0
204702,29009,175693,14.17133199,85.82866801,Entertainment,0,0
37149,693,36456,1.865460712,98.13453929,Food,1,1
40714,15421,25293,37.87640615,62.12359385,Food,1,1
180449,20390,160059,11.29959157,88.70040843,Entertainment,0,0
146354,30580,115774,20.89454337,79.10545663,Healthcare,2,2
108643,11760,96883,10.82444336,89.17555664,Transportation,4,2
10873,3183,7690,29.27434931,70.72565069,Housing,3,3
205326,35621,169705,17.3485092,82.6514908,Entertainment,0,0
201983,18771,183212,9.293356372,90.70664363,Entertainment,0,0
20604,2080,18524,10.09512716,89.90487284,Housing,3,3
32683,14318,18365,43.80870789,56.19129211,Food,1,1
180749,20541,160208,11.36437823,88.63562177,Entertainment,0,0
97075,32861,64214,33.85114602,66.14885398,Transportation,4,4
49877,12446,37431,24.95338533,75.04661467,Food,1,1
173210,34113,139097,19.69459038,80.30540962,Healthcare,2,0
32148,12459,19689,38.75513251,61.24486749,Food,1,1
34926,5465,29461,15.64736872,84.35263128,Food,1,1
115097,40513,74584,35.19900606,64.80099394,Transportation,4,2
224049,38245,185804,17.06992667,82.93007333,Entertainment,0,0
143603,19878,123725,13.8423292,86.1576708,Healthcare,2,2
97399,744,96655,0.763868212,99.23613179,Transportation,4,4
73212,188,73024,0.256788505,99.7432115,Transportation,4,4
49904,19037,30867,38.14724271,61.85275729,Food,1,1
143994,15234,128760,10.57960748,89.42039252,Healthcare,2,2
71608,37147,34461,51.87548877,48.12451123,Transportation,4,4
108570,6987,101583,6.435479414,93.56452059,Transportation,4,2
154346,19884,134462,12.88274396,87.11725604,Healthcare,2,0
249653,14170,235483,5.675878119,94.32412188,Entertainment,0,0
20485,5919,14566,28.89431291,71.10568709,Housing,3,3
53477,21221,32256,39.68248032,60.31751968,Food,1,4
105556,18639,86917,17.65792565,82.34207435,Transportation,4,2
151067,21529,129538,14.25129247,85.74870753,Healthcare,2,0
35024,18872,16152,53.88305162,46.11694838,Food,1,1
13325,6564,6761,49.26078799,50.73921201,Housing,3,3
37498,20562,16936,54.83492453,45.16507547,Food,1,1
128480,63378,65102,49.32907846,50.67092154,Healthcare,2,4
228537,33982,194555,14.8693647,85.1306353,Entertainment,0,0
63111,11035,52076,17.48506599,82.51493401,Transportation,4,4
111250,4808,106442,4.321797753,95.67820225,Transportation,4,2
220284,16609,203675,7.539812242,92.46018776,Entertainment,0,0
67406,40000,27406,59.34189835,40.65810165,Transportation,4,4
112533,11833,100700,10.51513778,89.48486222,Transportation,4,2
54373,5399,48974,9.929560628,90.07043937,Food,1,4
121093,44031,77062,36.36130908,63.63869092,Healthcare,2,2
27245,8171,19074,29.990824,70.009176,Housing,3,1
165466,11215,154251,6.777827469,93.22217253,Healthcare,2,0
239682,36826,202856,15.36452466,84.63547534,Entertainment,0,0
51278,3818,47460,7.445688209,92.55431179,Food,1,4
18426,507,17919,2.751546727,97.24845327,Housing,3,3
29338,3812,25526,12.99338742,87.00661258,Housing,3,1
148403,14348,134055,9.668268162,90.33173184,Healthcare,2,2
17330,13,17317,0.075014426,99.92498557,Housing,3,3
27416,3689,23727,13.45564634,86.54435366,Housing,3,1
52094,28921,23173,55.51695013,44.48304987,Food,1,4
215014,6379,208635,2.966783558,97.03321644,Entertainment,0,0
113742,63452,50290,55.78590143,44.21409857,Transportation,4,4
210011,38069,171942,18.12714572,81.87285428,Entertainment,0,0
65438,36136,29302,55.22173661,44.77826339,Transportation,4,4
192819,44933,147886,23.30320145,76.69679855,Entertainment,0,0
162402,46630,115772,28.71270058,71.28729942,Healthcare,2,0
37268,21998,15270,59.02651068,40.97348932,Food,1,1
207462,36691,170771,17.68564846,82.31435154,Entertainment,0,0
135694,19783,115911,14.57912656,85.42087344,Healthcare,2,2
45676,1147,44529,2.511165601,97.4888344,Food,1,4
15008,3102,11906,20.66897655,79.33102345,Housing,3,3
127922,33045,94877,25.83214772,74.16785228,Healthcare,2,2
41549,1451,40098,3.492262148,96.50773785,Food,1,1
14004,6117,7887,43.68037704,56.31962296,Housing,3,3
135044,3342,131702,2.474748971,97.52525103,Healthcare,2,2
170473,25533,144940,14.97773841,85.02226159,Healthcare,2,0
45800,17221,28579,37.60043668,62.39956332,Food,1,1
129907,626,129281,0.481883193,99.51811681,Healthcare,2,2
78609,3538,75071,4.500756911,95.49924309,Transportation,4,4
144613,25665,118948,17.74736711,82.25263289,Healthcare,2,2
115024,57163,57861,49.69658506,50.30341494,Transportation,4,4
152312,50642,101670,33.24885761,66.75114239,Healthcare,2,0
28625,12752,15873,44.54847162,55.45152838,Housing,3,1
148944,49929,99015,33.52199484,66.47800516,Healthcare,2,2
235629,57957,177672,24.59671772,75.40328228,Entertainment,0,0
91099,33277,57822,36.52839219,63.47160781,Transportation,4,4
39800,22486,17314,56.49748744,43.50251256,Food,1,1
176908,30373,146535,17.16881091,82.83118909,Healthcare,2,0
224204,52471,171733,23.40323991,76.59676009,Entertainment,0,0
112893,50068,62825,44.3499597,55.6500403,Transportation,4,4
47801,22314,25487,46.68103178,53.31896822,Food,1,1
220084,4019,216065,1.826120936,98.17387906,Entertainment,0,0
49851,14956,34895,30.00140418,69.99859582,Food,1,1
13910,965,12945,6.937455068,93.06254493,Housing,3,3
11752,6141,5611,52.25493533,47.74506467,Housing,3,3
78600,31031,47569,39.47964377,60.52035623,Transportation,4,4
195784,48187,147597,24.61232787,75.38767213,Entertainment,0,0
113669,53426,60243,47.0013812,52.9986188,Transportation,4,4
20776,12257,8519,58.99595687,41.00404313,Housing,3,3
107214,64306,42908,59.97910721,40.02089279,Transportation,4,4
202654,63466,139188,31.31741786,68.68258214,Entertainment,0,0
48014,12980,35034,27.03378181,72.96621819,Food,1,1
240682,51815,188867,21.52840678,78.47159322,Entertainment,0,0
185300,21434,163866,11.56718834,88.43281166,Entertainment,0,0
82003,47249,34754,57.61862371,42.38137629,Transportation,4,4
36938,6639,30299,17.97336077,82.02663923,Food,1,1
20876,11657,9219,55.83924123,44.16075877,Housing,3,3
134321,25210,109111,18.76847254,81.23152746,Healthcare,2,2
162958,63968,98990,39.25428638,60.74571362,Healthcare,2,0
98204,29802,68402,30.34703271,69.65296729,Transportation,4,4
165467,68381,97086,41.32606502,58.67393498,Healthcare,2,0
162743,46813,115930,28.76498528,71.23501472,Healthcare,2,0
14813,4526,10287,30.55424289,69.44575711,Housing,3,3
48252,12427,35825,25.75437288,74.24562712,Food,1,1
233157,67117,166040,28.7861827,71.2138173,Entertainment,0,0
141589,52318,89271,36.95061057,63.04938943,Healthcare,2,2
38016,12537,25479,32.9782197,67.0217803,Food,1,1
41451,4255,37196,10.26513232,89.73486768,Food,1,1
186581,15501,171080,8.307919885,91.69208012,Entertainment,0,0
29239,1563,27676,5.345600055,94.65439995,Housing,3,1
101883,53214,48669,52.23049969,47.76950031,Transportation,4,4
186765,32624,154141,17.467941,82.532059,Entertainment,0,0
93092,8383,84709,9.005070253,90.99492975,Transportation,4,4
109948,16958,92990,15.42365482,84.57634518,Transportation,4,2
42568,13674,28894,32.12272129,67.87727871,Food,1,1
176699,64342,112357,36.41333567,63.58666433,Healthcare,2,0
67769,27368,40401,40.38424648,59.61575352,Transportation,4,4
52585,27512,25073,52.31910241,47.68089759,Food,1,4
128225,1619,126606,1.262624293,98.73737571,Healthcare,2,2
177178,42272,134906,23.85849259,76.14150741,Healthcare,2,0
11924,4695,7229,39.37437102,60.62562898,Housing,3,3
237787,68307,169480,28.72612885,71.27387115,Entertainment,0,0
83212,5667,77545,6.81031582,93.18968418,Transportation,4,4
214560,50780,163780,23.66703952,76.33296048,Entertainment,0,0
47733,18267,29466,38.26912199,61.73087801,Food,1,1
247130,44034,203096,17.81815239,82.18184761,Entertainment,0,0
177352,69748,107604,39.32743922,60.67256078,Healthcare,2,0
127348,32916,94432,25.84728461,74.15271539,Healthcare,2,2
138313,25251,113062,18.25641841,81.74358159,Healthcare,2,2
243987,26401,217586,10.82065848,89.17934152,Entertainment,0,0
134371,33557,100814,24.97339456,75.02660544,Healthcare,2,2
171747,67151,104596,39.09879066,60.90120934,Healthcare,2,0
143309,38213,105096,26.66475937,73.33524063,Healthcare,2,2
146360,13418,132942,9.167805411,90.83219459,Healthcare,2,2
239920,33999,205921,14.17097366,85.82902634,Entertainment,0,0
224669,12902,211767,5.742670328,94.25732967,Entertainment,0,0
61851,17534,44317,28.34877367,71.65122633,Transportation,4,4
88387,22890,65497,25.89747361,74.10252639,Transportation,4,4
89667,40536,49131,45.20726689,54.79273311,Transportation,4,4
23120,1904,21216,8.235294118,91.76470588,Housing,3,3
18596,10715,7881,57.61991826,42.38008174,Housing,3,3
43299,16358,26941,37.77916349,62.22083651,Food,1,1
139849,53171,86678,38.02029332,61.97970668,Healthcare,2,2
11681,1147,10534,9.81936478,90.18063522,Housing,3,3
58149,9508,48641,16.35109804,83.64890196,Food,1,4
142412,7173,135239,5.036794652,94.96320535,Healthcare,2,2
55582,14717,40865,26.47799647,73.52200353,Food,1,4
62624,15880,46744,25.35769034,74.64230966,Transportation,4,4
166973,69687,97286,41.73549017,58.26450983,Healthcare,2,0
50056,13418,36638,26.80597731,73.19402269,Food,1,4
73520,7864,65656,10.69640914,89.30359086,Transportation,4,4
87633,49969,37664,57.02075702,42.97924298,Transportation,4,4
123217,4148,119069,3.366418595,96.63358141,Healthcare,2,2
72150,17100,55050,23.7006237,76.2993763,Transportation,4,4
132648,14471,118177,10.90932392,89.09067608,Healthcare,2,2
227108,4633,222475,2.039998591,97.96000141,Entertainment,0,0
50061,8209,41852,16.39799445,83.60200555,Food,1,4
130229,36754,93475,28.22259251,71.77740749,Healthcare,2,2
206094,41059,165035,19.92246257,80.07753743,Entertainment,0,0
244374,52436,191938,21.45727451,78.54272549,Entertainment,0,0
206911,21875,185036,10.57217838,89.42782162,Entertainment,0,0
92307,5089,87218,5.513124682,94.48687532,Transportation,4,4
18191,5494,12697,30.20174812,69.79825188,Housing,3,3
157035,7363,149672,4.688763651,95.31123635,Healthcare,2,0
124984,60333,64651,48.27257889,51.72742111,Healthcare,2,4
238276,23633,214643,9.918330004,90.08167,Entertainment,0,0
10502,2161,8341,20.57703295,79.42296705,Housing,3,3
136330,25895,110435,18.99435194,81.00564806,Healthcare,2,2
248631,21976,226655,8.838801276,91.16119872,Entertainment,0,0
190197,33362,156835,17.54076037,82.45923963,Entertainment,0,0
229039,9816,219223,4.285732997,95.714267,Entertainment,0,0
189519,21283,168236,11.2300086,88.7699914,Entertainment,0,0
133553,37223,96330,27.87133198,72.12866802,Healthcare,2,2
187766,44532,143234,23.71675383,76.28324617,Entertainment,0,0
24041,12998,11043,54.06597063,45.93402937,Housing,3,3
56044,31600,24444,56.3842695,43.6157305,Food,1,4
56193,13790,42403,24.54042318,75.45957682,Food,1,4
121369,27374,93995,22.55435902,77.44564098,Healthcare,2,2
26579,5946,20633,22.37104481,77.62895519,Housing,3,1
114870,2697,112173,2.347871507,97.65212849,Transportation,4,2
95554,56582,38972,59.21468489,40.78531511,Transportation,4,4
16455,7422,9033,45.10483136,54.89516864,Housing,3,3
200838,41009,159829,20.41894462,79.58105538,Entertainment,0,0
13959,1465,12494,10.49502113,89.50497887,Housing,3,3
26110,3963,22147,15.17809268,84.82190732,Housing,3,1
17325,6890,10435,39.76911977,60.23088023,Housing,3,3
30063,12146,17917,40.40182284,59.59817716,Food,1,1
40077,12248,27829,30.56116975,69.43883025,Food,1,1
163659,1439,162220,0.879267257,99.12073274,Healthcare,2,0
12560,1908,10652,15.1910828,84.8089172,Housing,3,3
27124,9349,17775,34.46763014,65.53236986,Housing,3,1
223918,37637,186281,16.80838521,83.19161479,Entertainment,0,0
124984,63373,61611,50.70489023,49.29510977,Healthcare,2,4
16582,6951,9631,41.91894826,58.08105174,Housing,3,3
19440,4610,14830,23.71399177,76.28600823,Housing,3,3
117347,49455,67892,42.14423888,57.85576112,Transportation,4,4
13715,6706,7009,48.89537003,51.10462997,Housing,3,3
245513,48754,196759,19.85801159,80.14198841,Entertainment,0,0
129740,13600,116140,10.48250347,89.51749653,Healthcare,2,2
90789,21575,69214,23.7638921,76.2361079,Transportation,4,4
15224,5464,9760,35.8906989,64.1093011,Housing,3,3
19898,3059,16839,15.37340436,84.62659564,Housing,3,3
248587,43667,204920,17.5660835,82.4339165,Entertainment,0,0
128859,27867,100992,21.62596326,78.37403674,Healthcare,2,2
72123,2476,69647,3.433024139,96.56697586,Transportation,4,4
80848,23191,57657,28.68469226,71.31530774,Transportation,4,4
100080,23525,76555,23.50619504,76.49380496,Transportation,4,2
249021,42008,207013,16.86926002,83.13073998,Entertainment,0,0
130215,41972,88243,32.23284568,67.76715432,Healthcare,2,2
183358,64123,119235,34.97147656,65.02852344,Entertainment,0,0
157442,49091,108351,31.18037118,68.81962882,Healthcare,2,0
215840,33290,182550,15.42346182,84.57653818,Entertainment,0,0
30886,8200,22686,26.54924561,73.45075439,Food,1,1
15608,399,15209,2.556381343,97.44361866,Housing,3,3
42638,4837,37801,11.34434073,88.65565927,Food,1,1
34869,8390,26479,24.06148728,75.93851272,Food,1,1
188559,54973,133586,29.15427002,70.84572998,Entertainment,0,0
205177,39348,165829,19.17758813,80.82241187,Entertainment,0,0
235497,22510,212987,9.558508176,90.44149182,Entertainment,0,0
208765,63346,145419,30.34320887,69.65679113,Entertainment,0,0
149203,41170,108033,27.59327896,72.40672104,Healthcare,2,2
166753,43673,123080,26.19023346,73.80976654,Healthcare,2,0
78469,31153,47316,39.70102843,60.29897157,Transportation,4,4
32246,655,31591,2.031259691,97.96874031,Food,1,1
193529,49860,143669,25.76358065,74.23641935,Entertainment,0,0
182257,38611,143646,21.1849202,78.8150798,Entertainment,0,0
140450,57402,83048,40.87006052,59.12993948,Healthcare,2,2
214584,42595,171989,19.85003542,80.14996458,Entertainment,0,0
234429,33002,201427,14.07760985,85.92239015,Entertainment,0,0
120748,27781,92967,23.00742041,76.99257959,Healthcare,2,2
57865,21822,36043,37.71191567,62.28808433,Food,1,4
43715,11188,32527,25.59304587,74.40695413,Food,1,1
236265,43273,192992,18.31545087,81.68454913,Entertainment,0,0
242409,34881,207528,14.38931723,85.61068277,Entertainment,0,0
101142,36024,65118,35.61725099,64.38274901,Transportation,4,2
63957,13420,50537,20.98284785,79.01715215,Transportation,4,4
151588,11247,140341,7.419452727,92.58054727,Healthcare,2,0
17616,1874,15742,10.63805631,89.36194369,Housing,3,3
28259,16904,11355,59.81811104,40.18188896,Housing,3,1
57022,33736,23286,59.16313002,40.83686998,Food,1,1
157382,47723,109659,30.32303567,69.67696433,Healthcare,2,0
58226,18781,39445,32.25534984,67.74465016,Food,1,4
26917,6697,20220,24.88018724,75.11981276,Housing,3,1
40690,18401,22289,45.22241337,54.77758663,Food,1,1
34250,4275,29975,12.48175182,87.51824818,Food,1,1
166870,43142,123728,25.85365854,74.14634146,Healthcare,2,0
135144,30303,104841,22.42274907,77.57725093,Healthcare,2,2
21358,8605,12753,40.28935294,59.71064706,Housing,3,3
193277,43949,149328,22.73886701,77.26113299,Entertainment,0,0
94654,39380,55274,41.6041583,58.3958417,Transportation,4,4
244157,28854,215303,11.81780576,88.18219424,Entertainment,0,0
69229,19491,49738,28.15438617,71.84561383,Transportation,4,4
36695,8026,28669,21.87218967,78.12781033,Food,1,1
184811,8994,175817,4.866593439,95.13340656,Entertainment,0,0
65773,2626,63147,3.992519727,96.00748027,Transportation,4,4
13981,6031,7950,43.13711466,56.86288534,Housing,3,3
86632,15596,71036,18.00258565,81.99741435,Transportation,4,4
20801,11536,9265,55.45887217,44.54112783,Housing,3,3
33476,2800,30676,8.364201219,91.63579878,Food,1,1
89462,52657,36805,58.85962755,41.14037245,Transportation,4,4
149227,2328,146899,1.560039403,98.4399606,Healthcare,2,2
235455,47725,187730,20.26926589,79.73073411,Entertainment,0,0
44614,9796,34818,21.95723316,78.04276684,Food,1,1
211298,52695,158603,24.93871215,75.06128785,Entertainment,0,0
109851,54786,55065,49.8730098,50.1269902,Transportation,4,4
183951,8234,175717,4.476192029,95.52380797,Entertainment,0,0
26954,2608,24346,9.67574386,90.32425614,Housing,3,1
42257,5951,36306,14.08287384,85.91712616,Food,1,1
75131,31428,43703,41.8309353,58.1690647,Transportation,4,4
105980,446,105534,0.42083412,99.57916588,Transportation,4,2
248646,36879,211767,14.83192973,85.16807027,Entertainment,0,0
25479,3821,21658,14.99666392,85.00333608,Housing,3,1
241288,8399,232889,3.48090249,96.51909751,Entertainment,0,0
55670,7526,48144,13.51895096,86.48104904,Food,1,4
113055,1383,111672,1.223298395,98.77670161,Transportation,4,2
17842,3826,14016,21.44378433,78.55621567,Housing,3,3
248358,48204,200154,19.40907883,80.59092117,Entertainment,0,0
28390,10852,17538,38.22472702,61.77527298,Housing,3,1
94043,40582,53461,43.15260041,56.84739959,Transportation,4,4
10573,5344,5229,50.54383808,49.45616192,Housing,3,3
221714,52059,169655,23.48024933,76.51975067,Entertainment,0,0
11718,6395,5323,54.57415941,45.42584059,Housing,3,3
47731,12298,35433,25.76522595,74.23477405,Food,1,1
190958,61097,129861,31.99499366,68.00500634,Entertainment,0,0
24550,11345,13205,46.21181263,53.78818737,Housing,3,3
219622,59189,160433,26.95039659,73.04960341,Entertainment,0,0
25976,8714,17262,33.54635048,66.45364952,Housing,3,1
40961,2150,38811,5.248895291,94.75110471,Food,1,1
15780,2552,13228,16.17237009,83.82762991,Housing,3,3
179105,42335,136770,23.63697273,76.36302727,Healthcare,2,0
132213,58056,74157,43.91096186,56.08903814,Healthcare,2,2
64747,26902,37845,41.54941542,58.45058458,Transportation,4,4
198709,56624,142085,28.4959413,71.5040587,Entertainment,0,0
19124,8946,10178,46.77891654,53.22108346,Housing,3,3
128411,50976,77435,39.6975337,60.3024663,Healthcare,2,2
10069,1855,8214,18.42288211,81.57711789,Housing,3,3
50010,7696,42314,15.38892222,84.61107778,Food,1,4
73772,22050,51722,29.88938893,70.11061107,Transportation,4,4
88257,33760,54497,38.25192336,61.74807664,Transportation,4,4
112377,46994,65383,41.81816564,58.18183436,Transportation,4,4
17045,3712,13333,21.7776474,78.2223526,Housing,3,3
68428,15336,53092,22.41187818,77.58812182,Transportation,4,4
14594,639,13955,4.378511717,95.62148828,Housing,3,3
187537,15924,171613,8.491124418,91.50887558,Entertainment,0,0
103714,29849,73865,28.78010683,71.21989317,Transportation,4,2
173059,30817,142242,17.80722181,82.19277819,Healthcare,2,0
197848,24869,172979,12.56975052,87.43024948,Entertainment,0,0
56789,3995,52794,7.03481308,92.96518692,Food,1,4
42873,22885,19988,53.37858326,46.62141674,Food,1,1
53457,7003,46454,13.1002488,86.8997512,Food,1,4
63944,5663,58281,8.856186663,91.14381334,Transportation,4,4
43075,25755,17320,59.7910621,40.2089379,Food,1,1
146970,36217,110753,24.64244404,75.35755596,Healthcare,2,2
157050,40999,116051,26.10569882,73.89430118,Healthcare,2,0
175375,7928,167447,4.520598717,95.47940128,Healthcare,2,0
194304,16264,178040,8.370388669,91.62961133,Entertainment,0,0
51781,28836,22945,55.68837991,44.31162009,Food,1,4
53843,2589,51254,4.808424493,95.19157551,Food,1,4
47537,21927,25610,46.1261754,53.8738246,Food,1,1
57141,632,56509,1.106035946,98.89396405,Food,1,4
121743,31565,90178,25.92756873,74.07243127,Healthcare,2,2
94221,24972,69249,26.50364568,73.49635432,Transportation,4,4
162916,48923,113993,30.0295858,69.9704142,Healthcare,2,0
212464,67241,145223,31.6481851,68.3518149,Entertainment,0,0
36574,12281,24293,33.57849839,66.42150161,Food,1,1
220264,38553,181711,17.5030872,82.4969128,Entertainment,0,0
144544,52187,92357,36.10457715,63.89542285,Healthcare,2,2
44335,35,44300,0.078944401,99.9210556,Food,1,4
43552,9482,34070,21.77167524,78.22832476,Food,1,1
39056,7514,31542,19.23904138,80.76095862,Food,1,1
121694,38798,82896,31.88160468,68.11839532,Healthcare,2,2
154372,26535,127837,17.188998,82.811002,Healthcare,2,0
98268,43725,54543,44.49566492,55.50433508,Transportation,4,4
23331,3997,19334,17.13171317,82.86828683,Housing,3,3
70549,21174,49375,30.01318233,69.98681767,Transportation,4,4
217465,14270,203195,6.56197549,93.43802451,Entertainment,0,0
142662,13726,128936,9.621342754,90.37865725,Healthcare,2,2
30319,1797,28522,5.926976483,94.07302352,Food,1,1
153296,36109,117187,23.55508298,76.44491702,Healthcare,2,0
32578,17250,15328,52.94984345,47.05015655,Food,1,1
63888,27712,36176,43.37590784,56.62409216,Transportation,4,4
48368,27047,21321,55.91920278,44.08079722,Food,1,1
231773,69005,162768,29.7726655,70.2273345,Entertainment,0,0
212809,40518,172291,19.03960829,80.96039171,Entertainment,0,0
206242,30976,175266,15.01924923,84.98075077,Entertainment,0,0
144526,51704,92822,35.77487788,64.22512212,Healthcare,2,2
28407,10551,17856,37.14225367,62.85774633,Housing,3,1
22388,11742,10646,52.44773986,47.55226014,Housing,3,3
158243,48066,110177,30.37480331,69.62519669,Healthcare,2,0
20982,6123,14859,29.18215613,70.81784387,Housing,3,3
19844,9916,9928,49.96976416,50.03023584,Housing,3,3
82108,5474,76634,6.666829054,93.33317095,Transportation,4,4
15880,8300,7580,52.26700252,47.73299748,Housing,3,3
31015,14595,16420,47.05787522,52.94212478,Food,1,1
23946,998,22948,4.167710682,95.83228932,Housing,3,3
17730,1678,16052,9.464184997,90.535815,Housing,3,3
162677,31206,131471,19.18279781,80.81720219,Healthcare,2,0
30630,15049,15581,49.13157036,50.86842964,Food,1,1
189379,52210,137169,27.56905465,72.43094535,Entertainment,0,0
87015,35463,51552,40.75504223,59.24495777,Transportation,4,4
16897,5979,10918,35.38497958,64.61502042,Housing,3,3
170275,12811,157464,7.523711643,92.47628836,Healthcare,2,0
31620,18736,12884,59.25363694,40.74636306,Food,1,1
157593,55013,102580,34.90827638,65.09172362,Healthcare,2,0
144449,44716,99733,30.95625446,69.04374554,Healthcare,2,2
170125,58376,111749,34.31359295,65.68640705,Healthcare,2,0
51248,19666,31582,38.37418046,61.62581954,Food,1,4
195620,65727,129893,33.59932522,66.40067478,Entertainment,0,0
19686,8322,11364,42.27369704,57.72630296,Housing,3,3
165179,56806,108373,34.39057023,65.60942977,Healthcare,2,0
59631,20881,38750,35.01702135,64.98297865,Food,1,4
231293,25744,205549,11.13047087,88.86952913,Entertainment,0,0
39137,7476,31661,19.10212842,80.89787158,Food,1,1
22264,13089,9175,58.78997485,41.21002515,Housing,3,3
56661,21895,34766,38.6420995,61.3579005,Food,1,4
37917,17528,20389,46.22728591,53.77271409,Food,1,1
147606,54120,93486,36.66517621,63.33482379,Healthcare,2,2
51928,3894,48034,7.498844554,92.50115545,Food,1,4
45712,1549,44163,3.38860693,96.61139307,Food,1,4
108996,62813,46183,57.62872032,42.37127968,Transportation,4,4
106832,26041,80791,24.37565523,75.62434477,Transportation,4,2
48947,18842,30105,38.49469835,61.50530165,Food,1,1
166507,55928,110579,33.58897824,66.41102176,Healthcare,2,0
48046,10751,37295,22.37647255,77.62352745,Food,1,1
210510,35013,175497,16.63246402,83.36753598,Entertainment,0,0
62092,34676,27416,55.84616376,44.15383624,Transportation,4,4
233628,37034,196594,15.85169586,84.14830414,Entertainment,0,0
152356,12741,139615,8.362650634,91.63734937,Healthcare,2,0
52896,12498,40398,23.62749546,76.37250454,Food,1,4
13558,1341,12217,9.890839357,90.10916064,Housing,3,3
195227,1893,193334,0.96964047,99.03035953,Entertainment,0,0
50079,1873,48206,3.740090657,96.25990934,Food,1,4
161895,64105,97790,39.59665215,60.40334785,Healthcare,2,0
104787,12524,92263,11.95186426,88.04813574,Transportation,4,2
17709,3727,13982,21.04579592,78.95420408,Housing,3,3
233736,58131,175605,24.87036657,75.12963343,Entertainment,0,0
92167,41410,50757,44.92931309,55.07068691,Transportation,4,4
209229,57154,152075,27.31648098,72.68351902,Entertainment,0,0
192705,20746,171959,10.76567811,89.23432189,Entertainment,0,0
27901,7964,19937,28.54377979,71.45622021,Housing,3,1
136005,5385,130620,3.959413257,96.04058674,Healthcare,2,2
15055,3776,11279,25.08136832,74.91863168,Housing,3,3
91861,47508,44353,51.71726848,48.28273152,Transportation,4,4
143359,55509,87850,38.72027567,61.27972433,Healthcare,2,2
53492,30825,22667,57.62543932,42.37456068,Food,1,4
162215,41301,120914,25.46065407,74.53934593,Healthcare,2,0
12643,3840,8803,30.37253816,69.62746184,Housing,3,3
137544,5657,131887,4.112865701,95.8871343,Healthcare,2,2
73834,36769,37065,49.79955034,50.20044966,Transportation,4,4
217120,3236,213884,1.490420044,98.50957996,Entertainment,0,0
126026,19406,106620,15.39840985,84.60159015,Healthcare,2,2
228169,58692,169477,25.72303862,74.27696138,Entertainment,0,0
129601,12308,117293,9.496840302,90.5031597,Healthcare,2,2
174616,50387,124229,28.85588949,71.14411051,Healthcare,2,0
106593,50734,55859,47.59599598,52.40400402,Transportation,4,4
105927,19594,86333,18.4976446,81.5023554,Transportation,4,2
59579,9464,50115,15.88479162,84.11520838,Food,1,4
25631,7147,18484,27.88420272,72.11579728,Housing,3,1
59510,16296,43214,27.383633,72.616367,Food,1,4
24610,2965,21645,12.04794799,87.95205201,Housing,3,3
12113,6180,5933,51.01956576,48.98043424,Housing,3,3
180816,38310,142506,21.18728431,78.81271569,Entertainment,0,0
35787,13424,22363,37.51082795,62.48917205,Food,1,1
26315,3885,22430,14.7634429,85.2365571,Housing,3,1
17080,1655,15425,9.68969555,90.31030445,Housing,3,3
47344,21066,26278,44.49560662,55.50439338,Food,1,1
37419,15627,21792,41.76220637,58.23779363,Food,1,1
55036,6278,48758,11.407079,88.592921,Food,1,4
29002,17079,11923,58.88904214,41.11095786,Housing,3,1
100160,39360,60800,39.2971246,60.7028754,Transportation,4,4
81916,768,81148,0.937545779,99.06245422,Transportation,4,4
73828,30117,43711,40.79346589,59.20653411,Transportation,4,4
101606,14276,87330,14.05035136,85.94964864,Transportation,4,2
28793,5809,22984,20.17504255,79.82495745,Housing,3,1
45481,15009,30472,33.00059365,66.99940635,Food,1,1
12793,5651,7142,44.17259439,55.82740561,Housing,3,3
160508,57651,102857,35.91783587,64.08216413,Healthcare,2,0
84918,14412,70506,16.97166678,83.02833322,Transportation,4,4
75125,8871,66254,11.80831947,88.19168053,Transportation,4,4
154176,41725,112451,27.06322644,72.93677356,Healthcare,2,0
73497,11009,62488,14.97884267,85.02115733,Transportation,4,4
40770,9913,30857,24.3144469,75.6855531,Food,1,1
41771,7736,34035,18.52002586,81.47997414,Food,1,1
165133,36529,128604,22.12095705,77.87904295,Healthcare,2,0
33267,11777,21490,35.40144888,64.59855112,Food,1,1
19175,2287,16888,11.92698827,88.07301173,Housing,3,3
210575,69519,141056,33.01389054,66.98610946,Entertainment,0,0
183137,50205,132932,27.41390325,72.58609675,Entertainment,0,0
23826,12450,11376,52.25384034,47.74615966,Housing,3,3
100061,3785,96276,3.782692558,96.21730744,Transportation,4,2
161315,15095,146220,9.357468307,90.64253169,Healthcare,2,0
198978,28061,170917,14.1025641,85.8974359,Entertainment,0,0
174980,7637,167343,4.3644988,95.6355012,Healthcare,2,0
72028,3420,68608,4.748153496,95.2518465,Transportation,4,4
29082,4123,24959,14.17715425,85.82284575,Housing,3,1
179058,34491,144567,19.26247361,80.73752639,Healthcare,2,0
172231,18155,154076,10.54107565,89.45892435,Healthcare,2,0
216691,21555,195136,9.947344375,90.05265562,Entertainment,0,0
132059,14832,117227,11.23134357,88.76865643,Healthcare,2,2
128225,43466,84759,33.89822578,66.10177422,Healthcare,2,2
153068,9883,143185,6.456607521,93.54339248,Healthcare,2,0
48087,7773,40314,16.16445193,83.83554807,Food,1,1
157040,67318,89722,42.86678553,57.13321447,Healthcare,2,0
127290,34135,93155,26.81671773,73.18328227,Healthcare,2,2
32952,10887,22065,33.03896577,66.96103423,Food,1,1
209804,24649,185155,11.74858439,88.25141561,Entertainment,0,0
75100,20803,54297,27.70039947,72.29960053,Transportation,4,4
47087,14689,32398,31.19544673,68.80455327,Food,1,1
246152,17874,228278,7.26136696,92.73863304,Entertainment,0,0
96759,39775,56984,41.10728718,58.89271282,Transportation,4,4
20116,4795,15321,23.83674687,76.16325313,Housing,3,3
186817,49006,137811,26.23208809,73.76791191,Entertainment,0,0
89008,49388,39620,55.48714722,44.51285278,Transportation,4,4
32423,15304,17119,47.20106098,52.79893902,Food,1,1
154299,24847,129452,16.10315038,83.89684962,Healthcare,2,0
59079,24180,34899,40.92824862,59.07175138,Food,1,4
11141,865,10276,7.764114532,92.23588547,Housing,3,3
171179,11615,159564,6.785294925,93.21470507,Healthcare,2,0
131918,47030,84888,35.65093467,64.34906533,Healthcare,2,2
49785,14418,35367,28.96053028,71.03946972,Food,1,1
67268,2043,65225,3.03710531,96.96289469,Transportation,4,4
246897,12828,234069,5.195688891,94.80431111,Entertainment,0,0
37792,15020,22772,39.74386113,60.25613887,Food,1,1
80540,2346,78194,2.912838341,97.08716166,Transportation,4,4
41255,65,41190,0.15755666,99.84244334,Food,1,4
58231,2482,55749,4.262334495,95.7376655,Food,1,4
168411,34903,133508,20.72489327,79.27510673,Healthcare,2,0
141315,24383,116932,17.25436083,82.74563917,Healthcare,2,2
87771,23939,63832,27.27438448,72.72561552,Transportation,4,4
78152,25841,52311,33.06505272,66.93494728,Transportation,4,4
67335,27260,40075,40.48414643,59.51585357,Transportation,4,4
85372,18153,67219,21.26341189,78.73658811,Transportation,4,4
99699,39090,60609,39.20801613,60.79198387,Transportation,4,4
47981,22977,25004,47.88770555,52.11229445,Food,1,1
174623,185,174438,0.105942516,99.89405748,Healthcare,2,0
21715,1703,20012,7.842505181,92.15749482,Housing,3,3
42134,22263,19871,52.83856268,47.16143732,Food,1,1
113562,50233,63329,44.23398672,55.76601328,Transportation,4,4
22868,10843,12025,47.41560259,52.58439741,Housing,3,3
15543,7817,7726,50.29273628,49.70726372,Housing,3,3
68552,28064,40488,40.93826584,59.06173416,Transportation,4,4
246358,48734,197624,19.78178099,80.21821901,Entertainment,0,0
38347,231,38116,0.602393929,99.39760607,Food,1,1
12829,4383,8446,34.16478291,65.83521709,Housing,3,3
56760,15255,41505,26.87632135,73.12367865,Food,1,4
167380,8717,158663,5.207910145,94.79208986,Healthcare,2,0
183352,56185,127167,30.6432436,69.3567564,Entertainment,0,0
26218,1270,24948,4.844000305,95.15599969,Housing,3,1
15314,3704,11610,24.18701841,75.81298159,Housing,3,3
186742,35303,151439,18.90469204,81.09530796,Entertainment,0,0
213836,56863,156973,26.59187415,73.40812585,Entertainment,0,0
104153,24796,79357,23.80728352,76.19271648,Transportation,4,2
103166,35519,67647,34.42897854,65.57102146,Transportation,4,2
16830,7685,9145,45.66250743,54.33749257,Housing,3,3
44334,14191,30143,32.00929309,67.99070691,Food,1,1
34445,13713,20732,39.81129337,60.18870663,Food,1,1
207547,30486,177061,14.68872111,85.31127889,Entertainment,0,0
23150,8974,14176,38.76457883,61.23542117,Housing,3,3
201564,4458,197106,2.211704471,97.78829553,Entertainment,0,0
196136,65646,130490,33.46963332,66.53036668,Entertainment,0,0
61050,13930,47120,22.81736282,77.18263718,Transportation,4,4
24168,8980,15188,37.15657067,62.84342933,Housing,3,3
211632,43142,168490,20.38538595,79.61461405,Entertainment,0,0
31282,2546,28736,8.138865801,91.8611342,Food,1,1
238065,10705,227360,4.496671077,95.50332892,Entertainment,0,0
20606,10135,10471,49.18470348,50.81529652,Housing,3,3
142317,60488,81829,42.5023012,57.4976988,Healthcare,2,2
155407,2921,152486,1.879580714,98.12041929,Healthcare,2,0
19152,4471,14681,23.34482038,76.65517962,Housing,3,3
58641,11063,47578,18.86564008,81.13435992,Food,1,4
26357,5953,20404,22.58603028,77.41396972,Housing,3,1
50610,10140,40470,20.03556609,79.96443391,Food,1,4
130105,38414,91691,29.52538334,70.47461666,Healthcare,2,2
190941,1152,189789,0.60332773,99.39667227,Entertainment,0,0
38677,9270,29407,23.96773276,76.03226724,Food,1,1
199561,33678,165883,16.87604291,83.12395709,Entertainment,0,0
28873,3218,25655,11.14536072,88.85463928,Housing,3,1
44065,12023,32042,27.28469307,72.71530693,Food,1,1
195813,26542,169271,13.55476909,86.44523091,Entertainment,0,0
21436,7489,13947,34.93655533,65.06344467,Housing,3,3
125553,30672,94881,24.42952379,75.57047621,Healthcare,2,2
240924,59379,181545,24.64636151,75.35363849,Entertainment,0,0
166700,42207,124493,25.31913617,74.68086383,Healthcare,2,0
77712,27395,50317,35.25195594,64.74804406,Transportation,4,4
45489,25152,20337,55.29248829,44.70751171,Food,1,1
25662,631,25031,2.458888629,97.54111137,Housing,3,1
170000,32814,137186,19.30235294,80.69764706,Healthcare,2,0
109895,33607,76288,30.58100915,69.41899085,Transportation,4,2
39175,6714,32461,17.13848117,82.86151883,Food,1,1
51343,5157,46186,10.04421245,89.95578755,Food,1,4
43974,10064,33910,22.88625097,77.11374903,Food,1,1
237424,14626,222798,6.160287081,93.83971292,Entertainment,0,0
15481,2071,13410,13.37768878,86.62231122,Housing,3,3
73514,40042,33472,54.46853661,45.53146339,Transportation,4,4
191078,58752,132326,30.74765279,69.25234721,Entertainment,0,0
38912,20577,18335,52.88085938,47.11914063,Food,1,1
14360,3302,11058,22.99442897,77.00557103,Housing,3,3
169694,12691,157003,7.478755878,92.52124412,Healthcare,2,0
59678,25417,34261,42.59023426,57.40976574,Food,1,4
89651,51476,38175,57.41821062,42.58178938,Transportation,4,4
102425,18938,83487,18.48962656,81.51037344,Transportation,4,2
188236,53488,134748,28.41539344,71.58460656,Entertainment,0,0
96869,12015,84854,12.40334885,87.59665115,Transportation,4,4
22535,302,22233,1.340137564,98.65986244,Housing,3,3
131576,12726,118850,9.671976652,90.32802335,Healthcare,2,2
24999,10169,14830,40.67762711,59.32237289,Housing,3,3
181991,57288,124703,31.47847971,68.52152029,Entertainment,0,0
248477,28804,219673,11.5922198,88.4077802,Entertainment,0,0
102929,44105,58824,42.84992568,57.15007432,Transportation,4,4
207733,11968,195765,5.761241594,94.23875841,Entertainment,0,0
19570,1543,18027,7.884517118,92.11548288,Housing,3,3
12726,6153,6573,48.34983498,51.65016502,Housing,3,3
53927,31035,22892,57.55002133,42.44997867,Food,1,4
218849,20296,198553,9.273974293,90.72602571,Entertainment,0,0
134450,42720,91730,31.77389364,68.22610636,Healthcare,2,2
12262,1575,10687,12.84456043,87.15543957,Housing,3,3
227307,7000,220307,3.079535606,96.92046439,Entertainment,0,0
136833,53973,82860,39.44443226,60.55556774,Healthcare,2,2
50958,19341,31617,37.95478629,62.04521371,Food,1,4
124898,16271,108627,13.02743038,86.97256962,Healthcare,2,2
96154,34329,61825,35.70210288,64.29789712,Transportation,4,4
33948,14972,18976,44.10274538,55.89725462,Food,1,1
44280,23227,21053,52.45483288,47.54516712,Food,1,1
95830,30134,65696,31.44526766,68.55473234,Transportation,4,4
24319,6839,17480,28.12204449,71.87795551,Housing,3,3
233832,63372,170460,27.10150878,72.89849122,Entertainment,0,0
150564,69205,81359,45.96384262,54.03615738,Healthcare,2,0
138862,50699,88163,36.5103484,63.4896516,Healthcare,2,2
228172,56748,171424,24.87071157,75.12928843,Entertainment,0,0
225349,481,224868,0.213446698,99.7865533,Entertainment,0,0
178041,15163,162878,8.516577642,91.48342236,Healthcare,2,0
247279,43760,203519,17.6966099,82.3033901,Entertainment,0,0
191587,38011,153576,19.84007266,80.15992734,Entertainment,0,0
24622,9723,14899,39.48907481,60.51092519,Housing,3,3
55118,28517,26601,51.73808919,48.26191081,Food,1,4
220610,65351,155259,29.62286388,70.37713612,Entertainment,0,0
23442,6802,16640,29.01629554,70.98370446,Housing,3,3
168342,69380,98962,41.21371969,58.78628031,Healthcare,2,0
44596,25860,18736,57.98726343,42.01273657,Food,1,1
180163,34992,145171,19.42241193,80.57758807,Entertainment,0,0
74434,40459,33975,54.35553645,45.64446355,Transportation,4,4
217745,51040,166705,23.44026269,76.55973731,Entertainment,0,0
216342,42624,173718,19.70213828,80.29786172,Entertainment,0,0
201648,54753,146895,27.15276125,72.84723875,Entertainment,0,0
16220,5095,11125,31.41183724,68.58816276,Housing,3,3
143300,43677,99623,30.47941382,69.52058618,Healthcare,2,2
12748,3731,9017,29.26733605,70.73266395,Housing,3,3
53001,18577,34424,35.05028207,64.94971793,Food,1,4
83764,45849,37915,54.73592474,45.26407526,Transportation,4,4
34893,2960,31933,8.483076835,91.51692317,Food,1,1
156069,7595,148474,4.866437281,95.13356272,Healthcare,2,0
175305,58498,116807,33.3692707,66.6307293,Healthcare,2,0
249478,39989,209489,16.0290687,83.9709313,Entertainment,0,0
225442,35335,190107,15.67365442,84.32634558,Entertainment,0,0
49911,10764,39147,21.56638817,78.43361183,Food,1,1
237129,16401,220728,6.916488494,93.08351151,Entertainment,0,0
130774,12498,118276,9.55694557,90.44305443,Healthcare,2,2
155020,12272,142748,7.916397884,92.08360212,Healthcare,2,0
20102,10138,9964,50.43279276,49.56720724,Housing,3,3
15940,7063,8877,44.30991217,55.69008783,Housing,3,3
57078,14171,42907,24.82742913,75.17257087,Food,1,4
12338,6113,6225,49.54611769,50.45388231,Housing,3,3
164317,47993,116324,29.2075683,70.7924317,Healthcare,2,0
98456,5772,92684,5.862517267,94.13748273,Transportation,4,4
55804,32984,22820,59.10687406,40.89312594,Food,1,1
35149,19384,15765,55.14808387,44.85191613,Food,1,1
177040,40915,136125,23.11059648,76.88940352,Healthcare,2,0
126528,35178,91350,27.80254173,72.19745827,Healthcare,2,2
30714,1945,28769,6.332617048,93.66738295,Food,1,1
32185,14134,18051,43.91486717,56.08513283,Food,1,1
141159,173,140986,0.122556833,99.87744317,Healthcare,2,2
19049,8604,10445,45.16772534,54.83227466,Housing,3,3
41329,23705,17624,57.35681967,42.64318033,Food,1,1
228391,48542,179849,21.2539023,78.7460977,Entertainment,0,0
163893,62444,101449,38.10046799,61.89953201,Healthcare,2,0
73064,37793,35271,51.72588416,48.27411584,Transportation,4,4
216787,62101,154686,28.6460904,71.3539096,Entertainment,0,0
45444,18907,26537,41.60505237,58.39494763,Food,1,1
203940,68353,135587,33.51623026,66.48376974,Entertainment,0,0
112848,10386,102462,9.203530413,90.79646959,Transportation,4,2
202992,55938,147054,27.556751,72.443249,Entertainment,0,0
94409,19443,74966,20.59443485,79.40556515,Transportation,4,4
235425,26611,208814,11.30338749,88.69661251,Entertainment,0,0
62961,37201,25760,59.08578326,40.91421674,Transportation,4,4
181111,55935,125176,30.88437478,69.11562522,Entertainment,0,0
67274,19418,47856,28.86404852,71.13595148,Transportation,4,4
33118,13351,19767,40.31342472,59.68657528,Food,1,1
153746,6809,146937,4.428733105,95.57126689,Healthcare,2,0
119447,50763,68684,42.49834655,57.50165345,Transportation,4,4
39835,9121,30714,22.89694992,77.10305008,Food,1,1
236165,49904,186261,21.13098893,78.86901107,Entertainment,0,0
103510,2869,100641,2.771712878,97.22828712,Transportation,4,2
241031,42677,198354,17.70602122,82.29397878,Entertainment,0,0
13693,6714,6979,49.0323523,50.9676477,Housing,3,3
23147,11226,11921,48.49872554,51.50127446,Housing,3,3
222420,44100,178320,19.82735366,80.17264634,Entertainment,0,0
240967,65347,175620,27.1186511,72.8813489,Entertainment,0,0
205907,10357,195550,5.029940701,94.9700593,Entertainment,0,0
203531,55233,148298,27.13738939,72.86261061,Entertainment,0,0
186779,59720,127059,31.97361588,68.02638412,Entertainment,0,0
147563,67510,80053,45.74995087,54.25004913,Healthcare,2,2
157120,3538,153582,2.251782077,97.74821792,Healthcare,2,0
17099,713,16386,4.169834493,95.83016551,Housing,3,3
49644,7053,42591,14.20715494,85.79284506,Food,1,4
154913,1714,153199,1.106427479,98.89357252,Healthcare,2,0
59044,18862,40182,31.94566764,68.05433236,Food,1,4
121268,46523,74745,38.36378929,61.63621071,Healthcare,2,2
26319,10321,15998,39.21501577,60.78498423,Housing,3,1
87609,39260,48349,44.81274755,55.18725245,Transportation,4,4
146090,50015,96075,34.23574509,65.76425491,Healthcare,2,2
159534,6852,152682,4.295009214,95.70499079,Healthcare,2,0
122164,6986,115178,5.718542287,94.28145771,Healthcare,2,2
228147,57769,170378,25.32095535,74.67904465,Entertainment,0,0
160008,26492,133516,16.55667217,83.44332783,Healthcare,2,0
88016,38402,49614,43.63070351,56.36929649,Transportation,4,4
42036,10061,31975,23.93424684,76.06575316,Food,1,1
143798,50124,93674,34.85723028,65.14276972,Healthcare,2,2
175414,7375,168039,4.204339448,95.79566055,Healthcare,2,0
176218,33050,143168,18.75517825,81.24482175,Healthcare,2,0
91667,2954,88713,3.222533736,96.77746626,Transportation,4,4
111048,42310,68738,38.10064116,61.89935884,Transportation,4,2
71884,30858,41026,42.9274943,57.0725057,Transportation,4,4
57165,13339,43826,23.33420799,76.66579201,Food,1,4
237007,69567,167440,29.35229761,70.64770239,Entertainment,0,0
125090,315,124775,0.251818691,99.74818131,Healthcare,2,2
23186,5756,17430,24.82532563,75.17467437,Housing,3,3
177904,43211,134693,24.28894235,75.71105765,Healthcare,2,0
28298,16726,11572,59.10665065,40.89334935,Housing,3,1
36129,9529,26600,26.37493426,73.62506574,Food,1,1
246884,55182,191702,22.3513877,77.6486123,Entertainment,0,0
131019,44652,86367,34.0805532,65.9194468,Healthcare,2,2
159614,13299,146315,8.331975892,91.66802411,Healthcare,2,0
155791,42164,113627,27.06446457,72.93553543,Healthcare,2,0
49298,20539,28759,41.66294779,58.33705221,Food,1,1
29128,7127,22001,24.46786597,75.53213403,Housing,3,1
84890,19575,65315,23.05925315,76.94074685,Transportation,4,4
156940,29764,127176,18.96520963,81.03479037,Healthcare,2,0
149933,8032,141901,5.357059487,94.64294051,Healthcare,2,2
26295,9977,16318,37.94257463,62.05742537,Housing,3,1
144397,6197,138200,4.291640408,95.70835959,Healthcare,2,2
131089,8303,122786,6.333864779,93.66613522,Healthcare,2,2
33084,11781,21303,35.609358,64.390642,Food,1,1
76768,13261,63507,17.27412464,82.72587536,Transportation,4,4
119936,55551,64385,46.31720251,53.68279749,Transportation,4,4
219123,46628,172495,21.27937277,78.72062723,Entertainment,0,0
189518,52573,136945,27.74037295,72.25962705,Entertainment,0,0
46867,28019,18848,59.78406981,40.21593019,Food,1,1
18181,9402,8779,51.7133271,48.2866729,Housing,3,3
17803,9784,8019,54.95702971,45.04297029,Housing,3,3
28085,6202,21883,22.08296244,77.91703756,Housing,3,1
53318,29960,23358,56.19115496,43.80884504,Food,1,4
154004,50176,103828,32.58097192,67.41902808,Healthcare,2,0
110702,8391,102311,7.579808856,92.42019114,Transportation,4,2
26267,1342,24925,5.10907222,94.89092778,Housing,3,1
109701,55857,53844,50.91749392,49.08250608,Transportation,4,4
125768,42591,83177,33.86473507,66.13526493,Healthcare,2,2
12020,519,11501,4.317803661,95.68219634,Housing,3,3
124014,5730,118284,4.620446079,95.37955392,Healthcare,2,2
18075,291,17784,1.609958506,98.39004149,Housing,3,3
157172,18682,138490,11.88634108,88.11365892,Healthcare,2,0
169854,58671,111183,34.54201844,65.45798156,Healthcare,2,0
10801,5770,5031,53.42097954,46.57902046,Housing,3,3
45598,17138,28460,37.5849818,62.4150182,Food,1,1
118112,49639,68473,42.02705906,57.97294094,Transportation,4,4
26506,1347,25159,5.081868256,94.91813174,Housing,3,1
117133,32457,84676,27.70952678,72.29047322,Transportation,4,2
104321,30894,73427,29.61436336,70.38563664,Transportation,4,2
99819,1841,97978,1.844338252,98.15566175,Transportation,4,4
59483,32654,26829,54.89635694,45.10364306,Food,1,4
39074,2230,36844,5.707119824,94.29288018,Food,1,1
88114,25569,62545,29.0180902,70.9819098,Transportation,4,4
14580,8699,5881,59.66392318,40.33607682,Housing,3,3
90614,27960,62654,30.85615909,69.14384091,Transportation,4,4
87124,51542,35582,59.15935907,40.84064093,Transportation,4,4
20841,10899,9942,52.29595509,47.70404491,Housing,3,3
102619,48843,53776,47.596449,52.403551,Transportation,4,4
24285,8858,15427,36.47519045,63.52480955,Housing,3,3
183010,37305,145705,20.38413201,79.61586799,Entertainment,0,0
156840,27481,129359,17.52167814,82.47832186,Healthcare,2,0
187420,65367,122053,34.87728097,65.12271903,Entertainment,0,0
159792,11230,148562,7.027886252,92.97211375,Healthcare,2,0
161341,20097,141244,12.45622625,87.54377375,Healthcare,2,0
11566,686,10880,5.931177589,94.06882241,Housing,3,3
123607,19353,104254,15.65688027,84.34311973,Healthcare,2,2
76335,12466,63869,16.3306478,83.6693522,Transportation,4,4
126484,5031,121453,3.977578192,96.02242181,Healthcare,2,2
239237,7926,231311,3.313032683,96.68696732,Entertainment,0,0
172856,50308,122548,29.10399408,70.89600592,Healthcare,2,0
40044,22734,17310,56.77255019,43.22744981,Food,1,1
212674,28923,183751,13.59968779,86.40031221,Entertainment,0,0
36555,20606,15949,56.36985365,43.63014635,Food,1,1
65386,36929,28457,56.47845104,43.52154896,Transportation,4,4
74289,27224,47065,36.64607142,63.35392858,Transportation,4,4
17091,196,16895,1.146802411,98.85319759,Housing,3,3
220788,31872,188916,14.43556715,85.56443285,Entertainment,0,0
91201,1079,90122,1.183101062,98.81689894,Transportation,4,4
43642,19166,24476,43.9164108,56.0835892,Food,1,1
71023,29970,41053,42.19759796,57.80240204,Transportation,4,4
59264,20845,38419,35.17312365,64.82687635,Food,1,4
83188,23689,59499,28.47646295,71.52353705,Transportation,4,4
47571,27987,19584,58.83206155,41.16793845,Food,1,1
19480,3982,15498,20.44147844,79.55852156,Housing,3,3
15840,7346,8494,46.37626263,53.62373737,Housing,3,3
30139,3576,26563,11.86502538,88.13497462,Food,1,1
96543,25022,71521,25.91798473,74.08201527,Transportation,4,4
51900,8432,43468,16.24662813,83.75337187,Food,1,4
240392,49218,191174,20.47405904,79.52594096,Entertainment,0,0
131435,59952,71483,45.61342108,54.38657892,Healthcare,2,2
230280,3281,226999,1.424787216,98.57521278,Entertainment,0,0
123164,30808,92356,25.01380273,74.98619727,Healthcare,2,2
122500,49949,72551,40.77469388,59.22530612,Healthcare,2,2
182669,11534,171135,6.314152921,93.68584708,Entertainment,0,0
131124,60262,70862,45.95802447,54.04197553,Healthcare,2,4
234335,8325,226010,3.552606311,96.44739369,Entertainment,0,0
225386,49862,175524,22.12293576,77.87706424,Entertainment,0,0
132112,50631,81481,38.32430059,61.67569941,Healthcare,2,2
47410,9054,38356,19.09723687,80.90276313,Food,1,1
163659,35280,128379,21.55701795,78.44298205,Healthcare,2,0
42992,23110,19882,53.75418683,46.24581317,Food,1,1
143883,47189,96694,32.79678628,67.20321372,Healthcare,2,2
72127,31015,41112,43.00054071,56.99945929,Transportation,4,4
13787,1844,11943,13.3749184,86.6250816,Housing,3,3
161800,30841,130959,19.06118665,80.93881335,Healthcare,2,0
27082,669,26413,2.47027546,97.52972454,Housing,3,1
40136,15403,24733,38.37701814,61.62298186,Food,1,1
198140,15547,182593,7.846472191,92.15352781,Entertainment,0,0
145569,16455,129114,11.30391773,88.69608227,Healthcare,2,2
125901,59480,66421,47.24346907,52.75653093,Healthcare,2,4
27320,11919,15401,43.62737921,56.37262079,Housing,3,1
85581,6811,78770,7.9585422,92.0414578,Transportation,4,4
146558,31722,114836,21.6446731,78.3553269,Healthcare,2,2
20681,157,20524,0.759150911,99.24084909,Housing,3,3
161466,49538,111928,30.68014319,69.31985681,Healthcare,2,0
86067,14326,71741,16.64517178,83.35482822,Transportation,4,4
235275,8552,226723,3.634895335,96.36510466,Entertainment,0,0
73999,15033,58966,20.31513939,79.68486061,Transportation,4,4
221060,40511,180549,18.3257939,81.6742061,Entertainment,0,0
147978,31771,116207,21.47008339,78.52991661,Healthcare,2,2
226493,45377,181116,20.03461476,79.96538524,Entertainment,0,0
20599,4019,16580,19.51065586,80.48934414,Housing,3,3
25108,4311,20797,17.16982635,82.83017365,Housing,3,1
119486,32659,86827,27.33290929,72.66709071,Transportation,4,2
246777,39292,207485,15.92206729,84.07793271,Entertainment,0,0
178479,2047,176432,1.146913643,98.85308636,Healthcare,2,0
179358,43872,135486,24.46057605,75.53942395,Healthcare,2,0
111842,19542,92300,17.4728635,82.5271365,Transportation,4,2
177922,42220,135702,23.72949944,76.27050056,Healthcare,2,0
218433,3884,214549,1.778119606,98.22188039,Entertainment,0,0
48474,25934,22540,53.50084581,46.49915419,Food,1,1
217414,23468,193946,10.79415309,89.20584691,Entertainment,0,0
192417,43644,148773,22.68198756,77.31801244,Entertainment,0,0
129248,45452,83796,35.16650161,64.83349839,Healthcare,2,2
135742,68001,67741,50.09576992,49.90423008,Healthcare,2,4
72876,20862,52014,28.62670838,71.37329162,Transportation,4,4
232527,33288,199239,14.31575688,85.68424312,Entertainment,0,0
242037,3573,238464,1.476220578,98.52377942,Entertainment,0,0
242177,12275,229902,5.068606845,94.93139315,Entertainment,0,0
195384,23230,172154,11.88940753,88.11059247,Entertainment,0,0
174867,47552,127315,27.19323829,72.80676171,Healthcare,2,0
50306,20255,30051,40.26358685,59.73641315,Food,1,4
30816,5169,25647,16.77375389,83.22624611,Food,1,1
202651,39146,163505,19.31695378,80.68304622,Entertainment,0,0
196092,24209,171883,12.34573568,87.65426432,Entertainment,0,0
64657,38077,26580,58.89076202,41.10923798,Transportation,4,4
68427,30566,37861,44.6695018,55.3304982,Transportation,4,4
42597,7503,35094,17.61391647,82.38608353,Food,1,1
47104,22182,24922,47.09154212,52.90845788,Food,1,1
11972,6394,5578,53.40795189,46.59204811,Housing,3,3
85240,16379,68861,19.2151572,80.7848428,Transportation,4,4
19994,241,19753,1.205361608,98.79463839,Housing,3,3
53022,14177,38845,26.73795783,73.26204217,Food,1,4
71803,11171,60632,15.55784577,84.44215423,Transportation,4,4
11264,376,10888,3.338068182,96.66193182,Housing,3,3
155386,26697,128689,17.18108452,82.81891548,Healthcare,2,0
222253,15111,207142,6.799008337,93.20099166,Entertainment,0,0
208022,69208,138814,33.26955803,66.73044197,Entertainment,0,0
26085,4104,21981,15.73317999,84.26682001,Housing,3,1
124068,26560,97508,21.40761518,78.59238482,Healthcare,2,2
86983,39291,47692,45.17089546,54.82910454,Transportation,4,4
118220,42592,75628,36.02774488,63.97225512,Transportation,4,2
182939,4755,178184,2.599227065,97.40077294,Entertainment,0,0
189696,16769,172927,8.839933367,91.16006663,Entertainment,0,0
18208,731,17477,4.014718805,95.9852812,Housing,3,3
17094,7761,9333,45.4018954,54.5981046,Housing,3,3
22294,13318,8976,59.73804611,40.26195389,Housing,3,3
73952,33891,40061,45.82837516,54.17162484,Transportation,4,4
169383,23633,145750,13.95240372,86.04759628,Healthcare,2,0
182108,60279,121829,33.1006875,66.8993125,Entertainment,0,0
29711,3820,25891,12.85719094,87.14280906,Housing,3,1
239566,19592,219974,8.178122104,91.8218779,Entertainment,0,0
13657,4902,8755,35.8936809,64.1063191,Housing,3,3
193378,59812,133566,30.93009546,69.06990454,Entertainment,0,0
82449,21457,60992,26.02457277,73.97542723,Transportation,4,4
68841,4660,64181,6.76922183,93.23077817,Transportation,4,4
56741,19224,37517,33.88026295,66.11973705,Food,1,4
213925,51554,162371,24.09910015,75.90089985,Entertainment,0,0
159711,46186,113525,28.91848401,71.08151599,Healthcare,2,0
131473,45434,86039,34.55766583,65.44233417,Healthcare,2,2
192529,34282,158247,17.80614868,82.19385132,Entertainment,0,0
25717,4433,21284,17.23762492,82.76237508,Housing,3,1
52286,26921,25365,51.48797001,48.51202999,Food,1,4
15492,1315,14177,8.488252001,91.511748,Housing,3,3
245933,29823,216110,12.12647347,87.87352653,Entertainment,0,0
188245,60148,128097,31.95197748,68.04802252,Entertainment,0,0
69607,2324,67283,3.338744666,96.66125533,Transportation,4,4
99583,56091,43492,56.32587892,43.67412108,Transportation,4,4
137754,4444,133310,3.226040623,96.77395938,Healthcare,2,2
32403,6794,25609,20.9671944,79.0328056,Food,1,1
59934,26511,33423,44.23365702,55.76634298,Food,1,4
52352,9946,42406,18.99831907,81.00168093,Food,1,4
19797,394,19403,1.990200535,98.00979946,Housing,3,3
142457,49099,93358,34.46583881,65.53416119,Healthcare,2,2
34528,17622,16906,51.03683967,48.96316033,Food,1,1
57978,15786,42192,27.22756908,72.77243092,Food,1,4
26308,8112,18196,30.83472708,69.16527292,Housing,3,1
92412,19377,73035,20.9680561,79.0319439,Transportation,4,4
78531,18533,59998,23.59959761,76.40040239,Transportation,4,4
11450,6842,4608,59.75545852,40.24454148,Housing,3,3
118090,42062,76028,35.61859599,64.38140401,Transportation,4,2
154174,43774,110400,28.39259538,71.60740462,Healthcare,2,0
136970,54059,82911,39.46776666,60.53223334,Healthcare,2,2
86888,2267,84621,2.609105976,97.39089402,Transportation,4,4
246513,3667,242846,1.487548324,98.51245168,Entertainment,0,0
16309,8206,8103,50.31577657,49.68422343,Housing,3,3
21731,10184,11547,46.86392711,53.13607289,Housing,3,3
172471,28619,143852,16.59351427,83.40648573,Healthcare,2,0
244870,62858,182012,25.66994732,74.33005268,Entertainment,0,0
11687,6867,4820,58.75759391,41.24240609,Housing,3,3
69015,33055,35960,47.89538506,52.10461494,Transportation,4,4
183443,42933,140510,23.40400015,76.59599985,Entertainment,0,0
231814,46815,184999,20.19507019,79.80492981,Entertainment,0,0
229250,20449,208801,8.919956379,91.08004362,Entertainment,0,0
102698,40854,61844,39.78071627,60.21928373,Transportation,4,4
136080,4114,131966,3.023221634,96.97677837,Healthcare,2,2
125956,11640,114316,9.241322367,90.75867763,Healthcare,2,2
103468,53385,50083,51.59566243,48.40433757,Transportation,4,4
154240,62159,92081,40.30018154,59.69981846,Healthcare,2,0
10538,455,10083,4.317707345,95.68229266,Housing,3,3
169010,17622,151388,10.42660198,89.57339802,Healthcare,2,0
246450,14008,232442,5.683911544,94.31608846,Entertainment,0,0
59516,35347,24169,59.39075207,40.60924793,Food,1,1
156148,42657,113491,27.31831339,72.68168661,Healthcare,2,0
232626,6734,225892,2.894775305,97.1052247,Entertainment,0,0
222602,41490,181112,18.63864655,81.36135345,Entertainment,0,0
74974,19688,55286,26.25977005,73.74022995,Transportation,4,4
239059,26667,212392,11.15498684,88.84501316,Entertainment,0,0
54761,12824,41937,23.41812604,76.58187396,Food,1,4
44946,17202,27744,38.27259378,61.72740622,Food,1,1
47717,1911,45806,4.004861999,95.995138,Food,1,4
17030,7892,9138,46.34174985,53.65825015,Housing,3,3
171194,3050,168144,1.781604495,98.2183955,Healthcare,2,0
46349,9972,36377,21.51502729,78.48497271,Food,1,1
46490,1924,44566,4.138524414,95.86147559,Food,1,4
198127,1309,196818,0.660687337,99.33931266,Entertainment,0,0
242266,19794,222472,8.170358201,91.8296418,Entertainment,0,0
202804,45595,157209,22.48229818,77.51770182,Entertainment,0,0
78485,38092,40393,48.5341148,51.4658852,Transportation,4,4
51553,4631,46922,8.982988381,91.01701162,Food,1,4
42425,12383,30042,29.18797879,70.81202121,Food,1,1
180703,39808,140895,22.02951805,77.97048195,Entertainment,0,0
188539,27469,161070,14.56939943,85.43060057,Entertainment,0,0
177271,46702,130569,26.34497464,73.65502536,Healthcare,2,0
221268,18539,202729,8.378527397,91.6214726,Entertainment,0,0
190334,12895,177439,6.774932487,93.22506751,Entertainment,0,0
22852,1407,21445,6.157010327,93.84298967,Housing,3,3
153651,50078,103573,32.59204301,67.40795699,Healthcare,2,0
72216,8903,63313,12.3282929,87.6717071,Transportation,4,4
226893,43692,183201,19.25665402,80.74334598,Entertainment,0,0
36850,16476,20374,44.7109905,55.2890095,Food,1,1
228993,39596,189397,17.29135825,82.70864175,Entertainment,0,0
48790,15634,33156,32.04345153,67.95654847,Food,1,1
215210,16818,198392,7.814692626,92.18530737,Entertainment,0,0
22807,13446,9361,58.95558381,41.04441619,Housing,3,3
13889,482,13407,3.470372237,96.52962776,Housing,3,3
232406,17990,214416,7.740764008,92.25923599,Entertainment,0,0
96125,7289,88836,7.58283485,92.41716515,Transportation,4,4
100689,5477,95212,5.439521696,94.5604783,Transportation,4,2
13512,6615,6897,48.95648313,51.04351687,Housing,3,3
133080,42260,90820,31.75533514,68.24466486,Healthcare,2,2
82647,29660,52987,35.88757003,64.11242997,Transportation,4,4
169435,57255,112180,33.79171954,66.20828046,Healthcare,2,0
24816,7470,17346,30.10154739,69.89845261,Housing,3,3
29908,6093,23815,20.37247559,79.62752441,Housing,3,1
206419,13125,193294,6.358426308,93.64157369,Entertainment,0,0
53107,15690,37417,29.54412789,70.45587211,Food,1,4
152651,51186,101465,33.53138859,66.46861141,Healthcare,2,0
120141,66640,53501,55.46815825,44.53184175,Healthcare,2,4
67053,17610,49443,26.26280703,73.73719297,Transportation,4,4
10945,1636,9309,14.9474646,85.0525354,Housing,3,3
247951,62075,185876,25.0351884,74.9648116,Entertainment,0,0
248801,34039,214762,13.68121511,86.31878489,Entertainment,0,0
207106,2641,204465,1.275192414,98.72480759,Entertainment,0,0
166521,7104,159417,4.266128596,95.7338714,Healthcare,2,0
20541,2309,18232,11.24093277,88.75906723,Housing,3,3
138456,35139,103317,25.37918183,74.62081817,Healthcare,2,2
174222,25394,148828,14.57565635,85.42434365,Healthcare,2,0
21004,9814,11190,46.72443344,53.27556656,Housing,3,3
37549,3187,34362,8.487576234,91.51242377,Food,1,1
19390,3756,15634,19.3708097,80.6291903,Housing,3,3
28319,2799,25520,9.883823581,90.11617642,Housing,3,1
32484,17581,14903,54.12202931,45.87797069,Food,1,1
12575,4790,7785,38.09145129,61.90854871,Housing,3,3
57210,21115,36095,36.90788324,63.09211676,Food,1,4
108727,49044,59683,45.10747101,54.89252899,Transportation,4,4
199707,60008,139699,30.04802035,69.95197965,Entertainment,0,0
155664,50581,105083,32.49370439,67.50629561,Healthcare,2,0
47748,24887,22861,52.12155483,47.87844517,Food,1,1
152472,48264,104208,31.65433653,68.34566347,Healthcare,2,0
32513,5570,26943,17.13160889,82.86839111,Food,1,1
170416,38386,132030,22.52488029,77.47511971,Healthcare,2,0
158332,7903,150429,4.991410454,95.00858955,Healthcare,2,0
238389,12881,225508,5.403353343,94.59664666,Entertainment,0,0
22518,3815,18703,16.94200195,83.05799805,Housing,3,3
44989,24655,20334,54.802285,45.197715,Food,1,1
11536,2627,8909,22.7721914,77.2278086,Housing,3,3
74774,41174,33600,55.06459465,44.93540535,Transportation,4,4
203497,55376,148121,27.21219477,72.78780523,Entertainment,0,0
106646,53980,52666,50.61605686,49.38394314,Transportation,4,4
204474,67707,136767,33.11276739,66.88723261,Entertainment,0,0
98138,22386,75752,22.8107359,77.1892641,Transportation,4,4
54742,26960,27782,49.24920536,50.75079464,Food,1,4
161257,20859,140398,12.93525242,87.06474758,Healthcare,2,0
17304,4515,12789,26.09223301,73.90776699,Housing,3,3
174101,63697,110404,36.58623443,63.41376557,Healthcare,2,0
169705,2227,167478,1.312277187,98.68772281,Healthcare,2,0
101538,12029,89509,11.84679627,88.15320373,Transportation,4,2
84746,15626,69120,18.43862837,81.56137163,Transportation,4,4
15034,1257,13777,8.361048291,91.63895171,Housing,3,3
109815,15526,94289,14.13832354,85.86167646,Transportation,4,2
185326,61735,123591,33.31156988,66.68843012,Entertainment,0,0
118178,51902,66276,43.91849583,56.08150417,Transportation,4,4
136801,55015,81786,40.2153493,59.7846507,Healthcare,2,2
193405,12467,180938,6.446058789,93.55394121,Entertainment,0,0
37567,10066,27501,26.7947933,73.2052067,Food,1,1
231578,1768,229810,0.763457669,99.23654233,Entertainment,0,0
44500,16360,28140,36.76404494,63.23595506,Food,1,1
169465,50842,118623,30.00147523,69.99852477,Healthcare,2,0
10435,492,9943,4.714901773,95.28509823,Housing,3,3
226614,1611,225003,0.710900474,99.28909953,Entertainment,0,0
103765,61402,42363,59.17409531,40.82590469,Transportation,4,4
53550,15219,38331,28.42016807,71.57983193,Food,1,4
151949,47225,104724,31.07950694,68.92049306,Healthcare,2,0
223964,35288,188676,15.75610366,84.24389634,Entertainment,0,0
210844,12575,198269,5.964125135,94.03587486,Entertainment,0,0
231734,1953,229781,0.842776632,99.15722337,Entertainment,0,0
123453,53904,69549,43.66358047,56.33641953,Healthcare,2,4
245818,58825,186993,23.93030616,76.06969384,Entertainment,0,0
121984,37730,84254,30.93028594,69.06971406,Healthcare,2,2
24207,7404,16803,30.58619408,69.41380592,Housing,3,3
177708,14862,162846,8.363157539,91.63684246,Healthcare,2,0
109355,40579,68776,37.10758539,62.89241461,Transportation,4,2
22917,6621,16296,28.89121613,71.10878387,Housing,3,3
236448,39510,196938,16.70980512,83.29019488,Entertainment,0,0
144812,50246,94566,34.69740077,65.30259923,Healthcare,2,2
164591,46021,118570,27.9608241,72.0391759,Healthcare,2,0
71026,39626,31400,55.79083716,44.20916284,Transportation,4,4
60023,17825,42198,29.6969495,70.3030505,Transportation,4,4
24019,6917,17102,28.79803489,71.20196511,Housing,3,3
236062,58078,177984,24.60285857,75.39714143,Entertainment,0,0
217410,12577,204833,5.784922497,94.2150775,Entertainment,0,0
227056,24609,202447,10.8382954,89.1617046,Entertainment,0,0
245793,12719,233074,5.174679507,94.82532049,Entertainment,0,0
111683,28653,83030,25.65565037,74.34434963,Transportation,4,2
75702,33562,42140,44.33436369,55.66563631,Transportation,4,4
16484,39,16445,0.23659306,99.76340694,Housing,3,3
72218,34197,38021,47.35246061,52.64753939,Transportation,4,4
11328,5785,5543,51.06814972,48.93185028,Housing,3,3
49438,9473,39965,19.16137384,80.83862616,Food,1,1
132323,64420,67903,48.68390227,51.31609773,Healthcare,2,4
160351,38058,122293,23.73418314,76.26581686,Healthcare,2,0
56902,1561,55341,2.743313065,97.25668694,Food,1,4
120447,6732,113715,5.589180303,94.4108197,Healthcare,2,2
127706,11844,115862,9.2744272,90.7255728,Healthcare,2,2
197708,7073,190635,3.577498129,96.42250187,Entertainment,0,0
21365,10532,10833,49.29557688,50.70442312,Housing,3,3
213558,45362,168196,21.241068,78.758932,Entertainment,0,0
47450,8897,38553,18.75026344,81.24973656,Food,1,1
208589,28555,180034,13.68960012,86.31039988,Entertainment,0,0
228654,31346,197308,13.70892265,86.29107735,Entertainment,0,0
164006,35262,128744,21.50043291,78.49956709,Healthcare,2,0
52800,31428,21372,59.52272727,40.47727273,Food,1,1
37807,786,37021,2.078980083,97.92101992,Food,1,1
25771,2936,22835,11.39265065,88.60734935,Housing,3,1
235114,28214,206900,12.0001361,87.9998639,Entertainment,0,0
24020,8099,15921,33.71773522,66.28226478,Housing,3,3
41717,22528,19189,54.00196563,45.99803437,Food,1,1
198471,23353,175118,11.76645454,88.23354546,Entertainment,0,0
23064,1805,21259,7.826049254,92.17395075,Housing,3,3
19368,5237,14131,27.03944651,72.96055349,Housing,3,3
143808,16448,127360,11.43747219,88.56252781,Healthcare,2,2
45238,3412,41826,7.542331668,92.45766833,Food,1,4
106127,17597,88530,16.58107739,83.41892261,Transportation,4,2
21019,7234,13785,34.41648033,65.58351967,Housing,3,3
45730,10946,34784,23.93614695,76.06385305,Food,1,1
246428,69353,177075,28.14331164,71.85668836,Entertainment,0,0
28846,2037,26809,7.061637662,92.93836234,Housing,3,1
56051,21917,34134,39.10188935,60.89811065,Food,1,4
51030,5552,45478,10.87987458,89.12012542,Food,1,4
225994,20358,205636,9.008203758,90.99179624,Entertainment,0,0
65598,2289,63309,3.489435654,96.51056435,Transportation,4,4
154060,17706,136354,11.49292483,88.50707517,Healthcare,2,0
113743,44357,69386,38.99756469,61.00243531,Transportation,4,4
187298,23341,163957,12.46195902,87.53804098,Entertainment,0,0
214915,59135,155780,27.5155294,72.4844706,Entertainment,0,0
18508,2940,15568,15.88502269,84.11497731,Housing,3,3
119830,19614,100216,16.36818827,83.63181173,Transportation,4,2
248685,1019,247666,0.409755313,99.59024469,Entertainment,0,0
59391,33949,25442,57.16185954,42.83814046,Food,1,4
247959,60008,187951,24.20077513,75.79922487,Entertainment,0,0
205914,4232,201682,2.055226939,97.94477306,Entertainment,0,0
209531,4545,204986,2.169130105,97.8308699,Entertainment,0,0
85400,27248,58152,31.90632319,68.09367681,Transportation,4,4
64324,30286,34038,47.08351471,52.91648529,Transportation,4,4
20395,183,20212,0.897278745,99.10272126,Housing,3,3
187568,33575,153993,17.90017487,82.09982513,Entertainment,0,0
205730,67879,137851,32.99421572,67.00578428,Entertainment,0,0
157371,60899,96472,38.69772703,61.30227297,Healthcare,2,0
151458,67398,84060,44.4994652,55.5005348,Healthcare,2,0
143446,35570,107876,24.79678764,75.20321236,Healthcare,2,2
62284,30128,32156,48.37197354,51.62802646,Transportation,4,4
20714,6143,14571,29.65627112,70.34372888,Housing,3,3
247059,8521,238538,3.448973727,96.55102627,Entertainment,0,0
171557,46740,124817,27.24458926,72.75541074,Healthcare,2,0
123439,38734,84705,31.37906172,68.62093828,Healthcare,2,2
216116,47585,168531,22.01826797,77.98173203,Entertainment,0,0
137277,28592,108685,20.82796098,79.17203902,Healthcare,2,2
69163,16433,52730,23.75981377,76.24018623,Transportation,4,4
24786,3131,21655,12.63213104,87.36786896,Housing,3,3
18521,6019,12502,32.49824524,67.50175476,Housing,3,3
92352,42831,49521,46.37798857,53.62201143,Transportation,4,4
158000,18185,139815,11.50949367,88.49050633,Healthcare,2,0
150932,46434,104498,30.76484775,69.23515225,Healthcare,2,0
131238,69240,61998,52.7591094,47.2408906,Healthcare,2,4
34292,10297,23995,30.02741164,69.97258836,Food,1,1
140306,31121,109185,22.18080481,77.81919519,Healthcare,2,2
173067,6390,166677,3.692211687,96.30778831,Healthcare,2,0
165579,21870,143709,13.20819669,86.79180331,Healthcare,2,0
243817,48076,195741,19.71806724,80.28193276,Entertainment,0,0
123906,68397,55509,55.20071667,44.79928333,Healthcare,2,4
248725,35738,212987,14.36847924,85.63152076,Entertainment,0,0
199645,20990,178655,10.51366175,89.48633825,Entertainment,0,0
27852,109,27743,0.391354301,99.6086457,Housing,3,1
53681,10185,43496,18.97319349,81.02680651,Food,1,4
33339,10082,23257,30.24085905,69.75914095,Food,1,1
107189,53920,53269,50.30366922,49.69633078,Transportation,4,4
21561,4855,16706,22.51750846,77.48249154,Housing,3,3
137247,68857,68390,50.17013122,49.82986878,Healthcare,2,4
69123,11577,57546,16.74840502,83.25159498,Transportation,4,4
98980,13532,85448,13.67144878,86.32855122,Transportation,4,4
14837,2915,11922,19.64682887,80.35317113,Housing,3,3
142457,204,142253,0.143201106,99.85679889,Healthcare,2,2
22526,13056,9470,57.95969102,42.04030898,Housing,3,3
14390,1598,12792,11.10493398,88.89506602,Housing,3,3
30454,3407,27047,11.18736455,88.81263545,Food,1,1
20196,1752,18444,8.674985146,91.32501485,Housing,3,3
211786,16247,195539,7.67142304,92.32857696,Entertainment,0,0
21291,5772,15519,27.1100465,72.8899535,Housing,3,3
17832,2228,15604,12.4943921,87.5056079,Housing,3,3
222140,62789,159351,28.26550824,71.73449176,Entertainment,0,0
17942,719,17223,4.007357039,95.99264296,Housing,3,3
26475,9050,17425,34.18319169,65.81680831,Housing,3,1
51612,7599,44013,14.72332016,85.27667984,Food,1,4
33190,19647,13543,59.19554083,40.80445917,Food,1,1
179688,7605,172083,4.232336049,95.76766395,Healthcare,2,0
188673,59469,129204,31.5196133,68.4803867,Entertainment,0,0
133514,53650,79864,40.18305196,59.81694804,Healthcare,2,2
52078,15808,36270,30.3544683,69.6455317,Food,1,4
45604,6504,39100,14.26190685,85.73809315,Food,1,1
173442,67284,106158,38.79337185,61.20662815,Healthcare,2,0
133707,25729,107978,19.24282199,80.75717801,Healthcare,2,2
18473,3939,14534,21.32301196,78.67698804,Housing,3,3
157268,21216,136052,13.49034769,86.50965231,Healthcare,2,0
150112,21512,128600,14.33063313,85.66936687,Healthcare,2,0
228613,12596,216017,5.509747915,94.49025209,Entertainment,0,0
144945,15143,129802,10.44741109,89.55258891,Healthcare,2,2
216115,32435,183680,15.00821322,84.99178678,Entertainment,0,0
103266,20047,83219,19.41297232,80.58702768,Transportation,4,2
65045,38510,26535,59.20516565,40.79483435,Transportation,4,4
29268,3708,25560,12.66912669,87.33087331,Housing,3,1
19316,1048,18268,5.425553945,94.57444606,Housing,3,3
56291,5626,50665,9.994492903,90.0055071,Food,1,4
52556,27666,24890,52.64099247,47.35900753,Food,1,4
152866,28575,124291,18.6928421,81.3071579,Healthcare,2,0
249431,1805,247626,0.723647021,99.27635298,Entertainment,0,0
144854,33360,111494,23.03008547,76.96991453,Healthcare,2,2
201532,65956,135576,32.72730881,67.27269119,Entertainment,0,0
89179,36758,52421,41.21822402,58.78177598,Transportation,4,4
104505,30676,73829,29.35361944,70.64638056,Transportation,4,2
52728,7030,45698,13.33257472,86.66742528,Food,1,4
232540,48350,184190,20.79212179,79.20787821,Entertainment,0,0
45361,10131,35230,22.33416371,77.66583629,Food,1,1
39297,20732,18565,52.75720793,47.24279207,Food,1,1
233299,13438,219861,5.759990399,94.2400096,Entertainment,0,0
218509,53228,165281,24.35963736,75.64036264,Entertainment,0,0
59467,6405,53062,10.77067954,89.22932046,Food,1,4
84468,33124,51344,39.21485059,60.78514941,Transportation,4,4
27543,4195,23348,15.23073013,84.76926987,Housing,3,1
202791,12019,190772,5.926791623,94.07320838,Entertainment,0,0
18187,10742,7445,59.06416671,40.93583329,Housing,3,3
32856,7763,25093,23.62734356,76.37265644,Food,1,1
61476,20116,41360,32.72171254,67.27828746,Transportation,4,4
21657,2171,19486,10.02447246,89.97552754,Housing,3,3
195991,23930,172061,12.20974432,87.79025568,Entertainment,0,0
140223,16481,123742,11.75342134,88.24657866,Healthcare,2,2
25275,1857,23418,7.347181009,92.65281899,Housing,3,1
132077,23306,108771,17.64576724,82.35423276,Healthcare,2,2
43036,25167,17869,58.47894786,41.52105214,Food,1,1
167245,30047,137198,17.96585847,82.03414153,Healthcare,2,0
48993,15766,33227,32.18010736,67.81989264,Food,1,1
24732,13898,10834,56.19440401,43.80559599,Housing,3,3
58426,31191,27235,53.38547907,46.61452093,Food,1,4
98416,7796,90620,7.921476183,92.07852382,Transportation,4,4
11331,5617,5714,49.5719707,50.4280293,Housing,3,3
66440,34058,32382,51.26128838,48.73871162,Transportation,4,4
154980,21304,133676,13.74628984,86.25371016,Healthcare,2,0
88524,34795,53729,39.305725,60.694275,Transportation,4,4
11670,6173,5497,52.89631534,47.10368466,Housing,3,3
221480,56339,165141,25.43751129,74.56248871,Entertainment,0,0
11605,962,10643,8.289530375,91.71046963,Housing,3,3
130658,44265,86393,33.87852256,66.12147744,Healthcare,2,2
42266,4690,37576,11.09638953,88.90361047,Food,1,1
32350,5699,26651,17.61669243,82.38330757,Food,1,1
205168,44364,160804,21.62325509,78.37674491,Entertainment,0,0
17427,1128,16299,6.472714753,93.52728525,Housing,3,3
123080,21174,101906,17.20344491,82.79655509,Healthcare,2,2
28763,1470,27293,5.110732538,94.88926746,Housing,3,1
167791,55254,112537,32.93025252,67.06974748,Healthcare,2,0
165373,52458,112915,31.72101855,68.27898145,Healthcare,2,0
51166,28074,23092,54.86846734,45.13153266,Food,1,4
67820,30684,37136,45.24329106,54.75670894,Transportation,4,4
25783,4193,21590,16.26265369,83.73734631,Housing,3,1
139809,55914,83895,39.99313349,60.00686651,Healthcare,2,2
36911,85,36826,0.230283655,99.76971634,Food,1,1
123002,44057,78945,35.81811678,64.18188322,Healthcare,2,2
29519,8186,21333,27.73129171,72.26870829,Housing,3,1
69630,39372,30258,56.54459285,43.45540715,Transportation,4,4
40129,6190,33939,15.42525356,84.57474644,Food,1,1
21822,1218,20604,5.581523233,94.41847677,Housing,3,3
189899,45768,144131,24.10123276,75.89876724,Entertainment,0,0
40615,8635,31980,21.260618,78.739382,Food,1,1
49880,27733,22147,55.59943865,44.40056135,Food,1,1
13011,1529,11482,11.7515948,88.2484052,Housing,3,3
25303,12204,13099,48.23143501,51.76856499,Housing,3,1
132051,65443,66608,49.55888255,50.44111745,Healthcare,2,4
93443,29042,64401,31.07990968,68.92009032,Transportation,4,4
125518,49040,76478,39.07009353,60.92990647,Healthcare,2,2
73265,25540,47725,34.85975568,65.14024432,Transportation,4,4
131778,29393,102385,22.30493709,77.69506291,Healthcare,2,2
10359,1830,8529,17.66579786,82.33420214,Housing,3,3
21586,12074,9512,55.93440193,44.06559807,Housing,3,3
19610,6628,12982,33.7990821,66.2009179,Housing,3,3
16451,8268,8183,50.25834296,49.74165704,Housing,3,3
28430,10960,17470,38.55082659,61.44917341,Housing,3,1
16641,3486,13155,20.94826032,79.05173968,Housing,3,3
35295,20869,14426,59.12735515,40.87264485,Food,1,1
201632,41212,160420,20.439216,79.560784,Entertainment,0,0
58412,16899,41513,28.93069917,71.06930083,Food,1,4
46750,16850,29900,36.04278075,63.95721925,Food,1,1
104324,56561,47763,54.21667114,45.78332886,Transportation,4,4
16163,1258,14905,7.783208563,92.21679144,Housing,3,3
34322,14081,20241,41.02616398,58.97383602,Food,1,1
139344,31727,107617,22.76883109,77.23116891,Healthcare,2,2
39522,331,39191,0.837508223,99.16249178,Food,1,1
17319,8208,9111,47.39303655,52.60696345,Housing,3,3
15328,1145,14183,7.469989562,92.53001044,Housing,3,3
146933,56296,90637,38.31406151,61.68593849,Healthcare,2,2
241693,52505,189188,21.72383975,78.27616025,Entertainment,0,0
232010,57962,174048,24.98254386,75.01745614,Entertainment,0,0
24737,5306,19431,21.44965032,78.55034968,Housing,3,3
57944,1456,56488,2.512770951,97.48722905,Food,1,4
19285,6276,13009,32.54342753,67.45657247,Housing,3,3
15731,5461,10270,34.71489416,65.28510584,Housing,3,3
165153,40527,124626,24.53906378,75.46093622,Healthcare,2,0
46584,3462,43122,7.431736218,92.56826378,Food,1,4
13380,3427,9953,25.61285501,74.38714499,Housing,3,3
165296,3221,162075,1.948625496,98.0513745,Healthcare,2,0
174866,49869,124997,28.51840838,71.48159162,Healthcare,2,0
21689,5315,16374,24.50550971,75.49449029,Housing,3,3
126303,62054,64249,49.13105785,50.86894215,Healthcare,2,4
27730,15377,12353,55.45257843,44.54742157,Housing,3,1
228393,52012,176381,22.77302719,77.22697281,Entertainment,0,0
136934,55829,81105,40.77073627,59.22926373,Healthcare,2,2
44923,7278,37645,16.20105514,83.79894486,Food,1,1
225714,50734,174980,22.47711706,77.52288294,Entertainment,0,0
49034,24811,24223,50.59958396,49.40041604,Food,1,1
199746,23932,175814,11.98121614,88.01878386,Entertainment,0,0
42766,10568,32198,24.71121919,75.28878081,Food,1,1
16173,6182,9991,38.22420083,61.77579917,Housing,3,3
14822,6931,7891,46.76157064,53.23842936,Housing,3,3
54371,14146,40225,26.01754612,73.98245388,Food,1,4
212847,16666,196181,7.830037539,92.16996246,Entertainment,0,0
48295,394,47901,0.815819443,99.18418056,Food,1,4
91627,21009,70618,22.92883102,77.07116898,Transportation,4,4
167733,33918,133815,20.22142333,79.77857667,Healthcare,2,0
195839,19165,176674,9.786099806,90.21390019,Entertainment,0,0
223280,45945,177335,20.57730204,79.42269796,Entertainment,0,0
242950,22033,220917,9.068944227,90.93105577,Entertainment,0,0
66864,18596,48268,27.81167743,72.18832257,Transportation,4,4
57664,11224,46440,19.46448391,80.53551609,Food,1,4
10636,5347,5289,50.27265889,49.72734111,Housing,3,3
217387,56275,161112,25.88701256,74.11298744,Entertainment,0,0
233892,48087,185805,20.55948899,79.44051101,Entertainment,0,0
21239,1132,20107,5.329817788,94.67018221,Housing,3,3
161181,54420,106761,33.76328475,66.23671525,Healthcare,2,0
240411,1024,239387,0.425937249,99.57406275,Entertainment,0,0
234174,57755,176419,24.66328457,75.33671543,Entertainment,0,0
182163,37081,145082,20.35594495,79.64405505,Entertainment,0,0
14132,5959,8173,42.16671384,57.83328616,Housing,3,3
20750,6904,13846,33.27228916,66.72771084,Housing,3,3
50145,7698,42447,15.35148071,84.64851929,Food,1,4
20168,9944,10224,49.30583102,50.69416898,Housing,3,3
149666,7123,142543,4.759263961,95.24073604,Healthcare,2,2
30637,8100,22537,26.43861997,73.56138003,Food,1,1
97167,1625,95542,1.672378482,98.32762152,Transportation,4,4
104175,38031,66144,36.50683945,63.49316055,Transportation,4,2
142308,18040,124268,12.67672935,87.32327065,Healthcare,2,2
17965,5059,12906,28.16031172,71.83968828,Housing,3,3
163971,1389,162582,0.847101012,99.15289899,Healthcare,2,0
56458,30023,26435,53.17758334,46.82241666,Food,1,4
26920,9288,17632,34.50222883,65.49777117,Housing,3,1
37014,18930,18084,51.14281083,48.85718917,Food,1,1
50067,20278,29789,40.50172768,59.49827232,Food,1,4
63837,14024,49813,21.9684509,78.0315491,Transportation,4,4
212074,67910,144164,32.02184143,67.97815857,Entertainment,0,0
166671,29651,137020,17.79013746,82.20986254,Healthcare,2,0
114492,7187,107305,6.277294483,93.72270552,Transportation,4,2
19419,9733,9686,50.1210155,49.8789845,Housing,3,3
39315,18703,20612,47.57217347,52.42782653,Food,1,1
206915,43979,162936,21.25462146,78.74537854,Entertainment,0,0
148201,24164,124037,16.30488323,83.69511677,Healthcare,2,2
188036,69852,118184,37.14820566,62.85179434,Entertainment,0,0
18226,1684,16542,9.239547899,90.7604521,Housing,3,3
53119,8044,45075,15.14335737,84.85664263,Food,1,4
27364,15380,11984,56.20523315,43.79476685,Housing,3,1
38098,5965,32133,15.65698987,84.34301013,Food,1,1
12470,23,12447,0.184442662,99.81555734,Housing,3,3
169642,26634,143008,15.70012143,84.29987857,Healthcare,2,0
92877,38951,53926,41.93826243,58.06173757,Transportation,4,4
25445,8640,16805,33.95559049,66.04440951,Housing,3,1
75805,23306,52499,30.74467383,69.25532617,Transportation,4,4
177211,24801,152410,13.99518089,86.00481911,Healthcare,2,0
119078,43924,75154,36.8867465,63.1132535,Transportation,4,2
14113,8274,5839,58.62679799,41.37320201,Housing,3,3
37157,15296,21861,41.16586377,58.83413623,Food,1,1
54688,20693,33995,37.83828262,62.16171738,Food,1,4
73779,13427,60352,18.1989455,81.8010545,Transportation,4,4
50552,24524,26028,48.51242285,51.48757715,Food,1,4
56304,10738,45566,19.07146917,80.92853083,Food,1,4
25390,4333,21057,17.06577393,82.93422607,Housing,3,1
185154,22701,162453,12.26060469,87.73939531,Entertainment,0,0
27094,2478,24616,9.14593637,90.85406363,Housing,3,1
33606,5758,27848,17.13384515,82.86615485,Food,1,1
55982,31235,24747,55.79471973,44.20528027,Food,1,4
26646,14601,12045,54.79621707,45.20378293,Housing,3,1
141832,48708,93124,34.34203847,65.65796153,Healthcare,2,2
235693,57526,178167,24.40717374,75.59282626,Entertainment,0,0
43776,11831,31945,27.02622442,72.97377558,Food,1,1
164859,38029,126830,23.06759109,76.93240891,Healthcare,2,0
232225,50535,181690,21.76122295,78.23877705,Entertainment,0,0
218791,64125,154666,29.30879241,70.69120759,Entertainment,0,0
41986,9732,32254,23.17915496,76.82084504,Food,1,1
90214,18209,72005,20.18422861,79.81577139,Transportation,4,4
73202,28305,44897,38.66697631,61.33302369,Transportation,4,4
104144,43680,60464,41.94192656,58.05807344,Transportation,4,4
187209,39295,147914,20.98990967,79.01009033,Entertainment,0,0
29271,2209,27062,7.546718595,92.4532814,Housing,3,1
107668,10362,97306,9.624029424,90.37597058,Transportation,4,2
120352,57581,62771,47.84382478,52.15617522,Healthcare,2,4
53358,1148,52210,2.151504929,97.84849507,Food,1,4
175252,13316,161936,7.598201447,92.40179855,Healthcare,2,0
93006,19158,73848,20.59867105,79.40132895,Transportation,4,4
193547,65873,127674,34.03462725,65.96537275,Entertainment,0,0
51237,3317,47920,6.473837266,93.52616273,Food,1,4
195359,55282,140077,28.2976469,71.7023531,Entertainment,0,0
14739,529,14210,3.589117308,96.41088269,Housing,3,3
131964,36114,95850,27.36655451,72.63344549,Healthcare,2,2
26144,1699,24445,6.498623011,93.50137699,Housing,3,1
193742,27652,166090,14.27258932,85.72741068,Entertainment,0,0
170185,36778,133407,21.61060023,78.38939977,Healthcare,2,0
23438,4309,19129,18.38467446,81.61532554,Housing,3,3
119425,15793,103632,13.22419929,86.77580071,Transportation,4,2
49653,9030,40623,18.18621231,81.81378769,Food,1,4
23549,9268,14281,39.35623593,60.64376407,Housing,3,3
19996,10460,9536,52.31046209,47.68953791,Housing,3,3
91776,9927,81849,10.81655335,89.18344665,Transportation,4,4
71991,18150,53841,25.21148477,74.78851523,Transportation,4,4
29651,4731,24920,15.95561701,84.04438299,Housing,3,1
103738,4192,99546,4.040949315,95.95905069,Transportation,4,2
210115,28059,182056,13.3541156,86.6458844,Entertainment,0,0
46877,19117,27760,40.78119334,59.21880666,Food,1,1
12655,1609,11046,12.71434216,87.28565784,Housing,3,3
68763,30507,38256,44.36542908,55.63457092,Transportation,4,4
21058,4885,16173,23.19783455,76.80216545,Housing,3,3
51334,6310,45024,12.29204816,87.70795184,Food,1,4
55046,21538,33508,39.12727537,60.87272463,Food,1,4
51107,23782,27325,46.53374293,53.46625707,Food,1,4
208120,43278,164842,20.79473381,79.20526619,Entertainment,0,0
47571,11482,36089,24.13655378,75.86344622,Food,1,1
243725,3031,240694,1.24361473,98.75638527,Entertainment,0,0
114534,39189,75345,34.21604065,65.78395935,Transportation,4,2
47377,21830,25547,46.07721046,53.92278954,Food,1,1
29318,11055,18263,37.70721059,62.29278941,Housing,3,1
189481,903,188578,0.476564933,99.52343507,Entertainment,0,0
96678,12179,84499,12.59748857,87.40251143,Transportation,4,4
49774,29181,20593,58.62699401,41.37300599,Food,1,1
39774,22330,17444,56.14220345,43.85779655,Food,1,1
106414,56625,49789,53.21198339,46.78801661,Transportation,4,4
40807,157,40650,0.384737913,99.61526209,Food,1,4
15334,1679,13655,10.94952393,89.05047607,Housing,3,3
121893,11,121882,0.009024308,99.99097569,Healthcare,2,2
15970,1817,14153,11.37758297,88.62241703,Housing,3,3
31585,11970,19615,37.89773627,62.10226373,Food,1,1
30159,10906,19253,36.16167645,63.83832355,Food,1,1
38830,1124,37706,2.89466907,97.10533093,Food,1,1
152377,6948,145429,4.559743268,95.44025673,Healthcare,2,0
61507,27428,34079,44.59329832,55.40670168,Transportation,4,4
28009,15940,12069,56.91027884,43.08972116,Housing,3,1
42686,23102,19584,54.12078902,45.87921098,Food,1,1
122586,14567,108019,11.88308616,88.11691384,Healthcare,2,2
13538,1598,11940,11.80381149,88.19618851,Housing,3,3
193780,16255,177525,8.388378574,91.61162143,Entertainment,0,0
41368,8504,32864,20.55695223,79.44304777,Food,1,1
49967,18601,31366,37.22656954,62.77343046,Food,1,1
28786,10140,18646,35.22545682,64.77454318,Housing,3,1
96403,40483,55920,41.99350643,58.00649357,Transportation,4,4
114331,47403,66928,41.461196,58.538804,Transportation,4,4
67032,5654,61378,8.43477742,91.56522258,Transportation,4,4
51477,20026,31451,38.90281096,61.09718904,Food,1,4
194174,44075,150099,22.69871352,77.30128648,Entertainment,0,0
109556,8574,100982,7.82613458,92.17386542,Transportation,4,2
48019,14290,33729,29.75905371,70.24094629,Food,1,1
67372,3833,63539,5.689307131,94.31069287,Transportation,4,4
105799,8344,97455,7.886652993,92.11334701,Transportation,4,2
19493,3174,16319,16.28276817,83.71723183,Housing,3,3
155375,52435,102940,33.74738536,66.25261464,Healthcare,2,0
25815,15315,10500,59.32597327,40.67402673,Housing,3,1
188304,34330,153974,18.23115813,81.76884187,Entertainment,0,0
103221,47678,55543,46.19021323,53.80978677,Transportation,4,4
203179,12177,191002,5.99323749,94.00676251,Entertainment,0,0
170868,62275,108593,36.44626261,63.55373739,Healthcare,2,0
19202,861,18341,4.483907926,95.51609207,Housing,3,3
29027,3647,25380,12.5641644,87.4358356,Housing,3,1
11902,172,11730,1.445135271,98.55486473,Housing,3,3
12495,4382,8113,35.07002801,64.92997199,Housing,3,3
96407,25647,70760,26.60284004,73.39715996,Transportation,4,4
26566,3337,23229,12.56116841,87.43883159,Housing,3,1
173439,38948,134491,22.45631029,77.54368971,Healthcare,2,0
111928,66499,45429,59.41230076,40.58769924,Transportation,4,4
158109,26241,131868,16.59677817,83.40322183,Healthcare,2,0
199957,56341,143616,28.17655796,71.82344204,Entertainment,0,0
210408,5827,204581,2.769381392,97.23061861,Entertainment,0,0
43288,18727,24561,43.26141194,56.73858806,Food,1,1
177621,14921,162700,8.400470665,91.59952933,Healthcare,2,0
13083,800,12283,6.114805473,93.88519453,Housing,3,3
58754,1842,56912,3.135105695,96.86489431,Food,1,4
21585,7097,14488,32.87931434,67.12068566,Housing,3,3
176647,15457,161190,8.750219364,91.24978064,Healthcare,2,0
222408,61252,161156,27.54037625,72.45962375,Entertainment,0,0
23808,8835,14973,37.109375,62.890625,Housing,3,3
37644,20866,16778,55.42981617,44.57018383,Food,1,1
121739,25765,95974,21.16412982,78.83587018,Healthcare,2,2
17811,5576,12235,31.30649599,68.69350401,Housing,3,3
40908,17006,23902,41.57133079,58.42866921,Food,1,1
18504,11071,7433,59.83030696,40.16969304,Housing,3,3
159113,35498,123615,22.30993068,77.69006932,Healthcare,2,0
18189,5127,13062,28.18736599,71.81263401,Housing,3,3
56684,2624,54060,4.629172253,95.37082775,Food,1,4
110401,34616,75785,31.35478845,68.64521155,Transportation,4,2
161883,20069,141814,12.39722516,87.60277484,Healthcare,2,0
76522,36392,40130,47.55756514,52.44243486,Transportation,4,4
164099,33156,130943,20.20487632,79.79512368,Healthcare,2,0
11337,6436,4901,56.76986857,43.23013143,Housing,3,3
209870,24611,185259,11.72678325,88.27321675,Entertainment,0,0
127618,69087,58531,54.13578022,45.86421978,Healthcare,2,4
24907,6322,18585,25.38242261,74.61757739,Housing,3,3
65066,24831,40235,38.16278855,61.83721145,Transportation,4,4
184145,60914,123231,33.0793668,66.9206332,Entertainment,0,0
134867,14783,120084,10.96116915,89.03883085,Healthcare,2,2
204939,43820,161119,21.3819722,78.6180278,Entertainment,0,0
83338,36707,46631,44.04593343,55.95406657,Transportation,4,4
35283,258,35025,0.731230338,99.26876966,Food,1,1
234938,5435,229503,2.313376295,97.6866237,Entertainment,0,0
217830,49591,168239,22.76591838,77.23408162,Entertainment,0,0
176863,2297,174566,1.298745357,98.70125464,Healthcare,2,0
100991,22540,78451,22.31882049,77.68117951,Transportation,4,2
15722,7568,8154,48.13636942,51.86363058,Housing,3,3
171201,6042,165159,3.529184993,96.47081501,Healthcare,2,0
42561,20842,21719,48.96971406,51.03028594,Food,1,1
213818,35781,178037,16.73432545,83.26567455,Entertainment,0,0
14676,3900,10776,26.57399836,73.42600164,Housing,3,3
48959,8111,40848,16.56692334,83.43307666,Food,1,4
46643,3180,43463,6.817743284,93.18225672,Food,1,4
76781,41794,34987,54.43273727,45.56726273,Transportation,4,4
57688,16787,40901,29.09963944,70.90036056,Food,1,4
195992,52658,143334,26.86742316,73.13257684,Entertainment,0,0
240622,57853,182769,24.04310495,75.95689505,Entertainment,0,0
173681,7174,166507,4.130561201,95.8694388,Healthcare,2,0
95357,3792,91565,3.976635171,96.02336483,Transportation,4,4
14605,2962,11643,20.28072578,79.71927422,Housing,3,3
55636,8447,47189,15.18261557,84.81738443,Food,1,4
21933,9926,12007,45.25600693,54.74399307,Housing,3,3
216827,46420,170407,21.40877289,78.59122711,Entertainment,0,0
50155,1444,48711,2.879074868,97.12092513,Food,1,4
205674,56780,148894,27.60679522,72.39320478,Entertainment,0,0
39092,4924,34168,12.59592756,87.40407244,Food,1,1
62083,27787,34296,44.7578242,55.2421758,Transportation,4,4
29963,5880,24083,19.62420318,80.37579682,Housing,3,1
58442,33926,24516,58.05071695,41.94928305,Food,1,4
212016,50459,161557,23.7996189,76.2003811,Entertainment,0,0
198767,68486,130281,34.45541765,65.54458235,Entertainment,0,0
126901,52140,74761,41.08714667,58.91285333,Healthcare,2,2
16825,4891,11934,29.06983655,70.93016345,Housing,3,3
231499,7993,223506,3.452714699,96.5472853,Entertainment,0,0
133159,26363,106796,19.79813606,80.20186394,Healthcare,2,2
173678,49458,124220,28.47683644,71.52316356,Healthcare,2,0
198418,52969,145449,26.69566269,73.30433731,Entertainment,0,0
165470,14099,151371,8.520577748,91.47942225,Healthcare,2,0
95227,5871,89356,6.165268254,93.83473175,Transportation,4,4
54424,29248,25176,53.74099662,46.25900338,Food,1,4
18102,5009,13093,27.67097558,72.32902442,Housing,3,3
128183,47618,80565,37.14845182,62.85154818,Healthcare,2,2
57642,19452,38190,33.74622671,66.25377329,Food,1,4
163798,1066,162732,0.650801597,99.3491984,Healthcare,2,0
39663,5093,34570,12.84068275,87.15931725,Food,1,1
178844,33148,145696,18.5345888,81.4654112,Healthcare,2,0
81887,17640,64247,21.54188088,78.45811912,Transportation,4,4
25845,11832,14013,45.78061521,54.21938479,Housing,3,1
232482,61865,170617,26.61066233,73.38933767,Entertainment,0,0
29357,4628,24729,15.7645536,84.2354464,Housing,3,1
95748,57174,38574,59.71299662,40.28700338,Transportation,4,4
33876,7445,26431,21.977211,78.022789,Food,1,1
51357,26796,24561,52.17594486,47.82405514,Food,1,4
73366,10311,63055,14.05419404,85.94580596,Transportation,4,4
44650,19733,24917,44.19484882,55.80515118,Food,1,1
164772,48722,116050,29.56934431,70.43065569,Healthcare,2,0
13730,6559,7171,47.77130371,52.22869629,Housing,3,3
19005,6565,12440,34.54354117,65.45645883,Housing,3,3
213558,22224,191334,10.40654061,89.59345939,Entertainment,0,0
60310,31343,28967,51.96982258,48.03017742,Transportation,4,4
179692,50048,129644,27.85210249,72.14789751,Healthcare,2,0
85485,50017,35468,58.50968006,41.49031994,Transportation,4,4
13035,2052,10983,15.74223245,84.25776755,Housing,3,3
186601,22959,163642,12.30379258,87.69620742,Entertainment,0,0
124411,8963,115448,7.204346883,92.79565312,Healthcare,2,2
100374,21344,79030,21.26447088,78.73552912,Transportation,4,2
243256,2373,240883,0.975515506,99.02448449,Entertainment,0,0
68794,39001,29793,56.69244411,43.30755589,Transportation,4,4
231608,42458,189150,18.33183655,81.66816345,Entertainment,0,0
209948,56966,152982,27.13338541,72.86661459,Entertainment,0,0
191185,62818,128367,32.85718022,67.14281978,Entertainment,0,0
202998,23930,179068,11.78829348,88.21170652,Entertainment,0,0
47038,15155,31883,32.21863174,67.78136826,Food,1,1
187972,33414,154558,17.77605175,82.22394825,Entertainment,0,0
134891,18116,116775,13.43010282,86.56989718,Healthcare,2,2
112836,57508,55328,50.96600376,49.03399624,Transportation,4,4
154870,19986,134884,12.90501711,87.09498289,Healthcare,2,0
43919,22735,21184,51.76575059,48.23424941,Food,1,1
99544,56413,43131,56.67142168,43.32857832,Transportation,4,4
14656,3590,11066,24.49508734,75.50491266,Housing,3,3
203887,19500,184387,9.564121302,90.4358787,Entertainment,0,0
246804,7742,239062,3.136902157,96.86309784,Entertainment,0,0
26335,461,25874,1.750522119,98.24947788,Housing,3,1
208957,36896,172061,17.65722134,82.34277866,Entertainment,0,0
24145,4894,19251,20.26920688,79.73079312,Housing,3,3
226127,62487,163640,27.63358644,72.36641356,Entertainment,0,0
160791,19460,141331,12.10266744,87.89733256,Healthcare,2,0
35925,13000,22925,36.18649965,63.81350035,Food,1,1
16871,6386,10485,37.85193527,62.14806473,Housing,3,3
201686,39549,162137,19.60919449,80.39080551,Entertainment,0,0
32929,1939,30990,5.888426615,94.11157339,Food,1,1
140339,26736,113603,19.05101219,80.94898781,Healthcare,2,2
99860,58758,41102,58.84037653,41.15962347,Transportation,4,4
32794,3926,28868,11.97170214,88.02829786,Food,1,1
153101,9978,143123,6.51726638,93.48273362,Healthcare,2,0
122905,11261,111644,9.162361173,90.83763883,Healthcare,2,2
67770,1067,66703,1.574442969,98.42555703,Transportation,4,4
59754,29457,30297,49.29711818,50.70288182,Food,1,4
244580,39637,204943,16.20614932,83.79385068,Entertainment,0,0
74353,42213,32140,56.77376838,43.22623162,Transportation,4,4
185847,12435,173412,6.690987748,93.30901225,Entertainment,0,0
220845,15685,205160,7.102266295,92.8977337,Entertainment,0,0
178605,56832,121773,31.81993785,68.18006215,Healthcare,2,0
17549,6879,10670,39.19881475,60.80118525,Housing,3,3
28912,1401,27511,4.845738794,95.15426121,Housing,3,1
12352,4278,8074,34.63406736,65.36593264,Housing,3,3
73064,36297,36767,49.67836417,50.32163583,Transportation,4,4
111114,18366,92748,16.52897025,83.47102975,Transportation,4,2
39351,15323,24028,38.93928998,61.06071002,Food,1,1
41232,20504,20728,49.72836632,50.27163368,Food,1,1
27298,6466,20832,23.68671698,76.31328302,Housing,3,1
178937,67617,111320,37.78816008,62.21183992,Healthcare,2,0
18553,9297,9256,50.11049426,49.88950574,Housing,3,3
10201,1560,8641,15.29261837,84.70738163,Housing,3,3
145786,16685,129101,11.44485753,88.55514247,Healthcare,2,2
179204,20568,158636,11.47742238,88.52257762,Healthcare,2,0
129674,9133,120541,7.043046409,92.95695359,Healthcare,2,2
22053,9595,12458,43.50881966,56.49118034,Housing,3,3
177401,37754,139647,21.28172896,78.71827104,Healthcare,2,0
229762,40040,189722,17.42672853,82.57327147,Entertainment,0,0
159420,41471,117949,26.01367457,73.98632543,Healthcare,2,0
147972,43370,104602,29.30959911,70.69040089,Healthcare,2,2
69133,27873,41260,40.31793789,59.68206211,Transportation,4,4
52140,4391,47749,8.421557346,91.57844265,Food,1,4
164437,59837,104600,36.38901221,63.61098779,Healthcare,2,0
72338,25438,46900,35.1654732,64.8345268,Transportation,4,4
27600,15242,12358,55.22463768,44.77536232,Housing,3,1
242875,51319,191556,21.12979928,78.87020072,Entertainment,0,0
193649,48094,145555,24.83565626,75.16434374,Entertainment,0,0
188067,35978,152089,19.13041629,80.86958371,Entertainment,0,0
232883,5186,227697,2.226869286,97.77313071,Entertainment,0,0
41876,9349,32527,22.325437,77.674563,Food,1,1
191443,39521,151922,20.64374252,79.35625748,Entertainment,0,0
112424,39146,73278,34.81996727,65.18003273,Transportation,4,2
223798,57749,166049,25.80407332,74.19592668,Entertainment,0,0
87916,706,87210,0.803039265,99.19696074,Transportation,4,4
34507,2731,31776,7.914336222,92.08566378,Food,1,1
24486,830,23656,3.389692069,96.61030793,Housing,3,3
98366,4545,93821,4.620498953,95.37950105,Transportation,4,4
41561,23302,18259,56.06698588,43.93301412,Food,1,1
249132,18862,230270,7.571086813,92.42891319,Entertainment,0,0
39355,11480,27875,29.17037225,70.82962775,Food,1,1
215311,14534,200777,6.750235706,93.24976429,Entertainment,0,0
208392,24462,183930,11.73845445,88.26154555,Entertainment,0,0
36926,9458,27468,25.61338894,74.38661106,Food,1,1
51198,12752,38446,24.90722294,75.09277706,Food,1,4
222475,66388,156087,29.84065625,70.15934375,Entertainment,0,0
128258,28828,99430,22.47657066,77.52342934,Healthcare,2,2
191618,7143,184475,3.727729128,96.27227087,Entertainment,0,0
85789,2565,83224,2.989893809,97.01010619,Transportation,4,4
25061,3604,21457,14.38091058,85.61908942,Housing,3,1
180628,36329,144299,20.11260713,79.88739287,Entertainment,0,0
57958,4299,53659,7.417440215,92.58255978,Food,1,4
16413,7666,8747,46.70687869,53.29312131,Housing,3,3
212359,67693,144666,31.87668053,68.12331947,Entertainment,0,0
11147,4779,6368,42.87252175,57.12747825,Housing,3,3
141463,5469,135994,3.866028573,96.13397143,Healthcare,2,2
63631,10573,53058,16.61611479,83.38388521,Transportation,4,4
175091,45970,129121,26.25491887,73.74508113,Healthcare,2,0
193411,36310,157101,18.77349272,81.22650728,Entertainment,0,0
94265,27500,66765,29.1730759,70.8269241,Transportation,4,4
226532,48492,178040,21.40624724,78.59375276,Entertainment,0,0
28947,8209,20738,28.35872457,71.64127543,Housing,3,1
238833,32875,205958,13.76484824,86.23515176,Entertainment,0,0
228145,52468,175677,22.997655,77.002345,Entertainment,0,0
59330,11893,47437,20.04550817,79.95449183,Food,1,4
38774,6916,31858,17.83669469,82.16330531,Food,1,1
18262,7286,10976,39.89705399,60.10294601,Housing,3,3
116561,48747,67814,41.82102075,58.17897925,Transportation,4,4
154679,28487,126192,18.41685038,81.58314962,Healthcare,2,0
18758,3127,15631,16.67022071,83.32977929,Housing,3,3
231905,18295,213610,7.889006274,92.11099373,Entertainment,0,0
216825,35567,181258,16.40355125,83.59644875,Entertainment,0,0
52447,11001,41446,20.97546094,79.02453906,Food,1,4
31077,9807,21270,31.55710011,68.44289989,Food,1,1
54372,30527,23845,56.14470683,43.85529317,Food,1,4
58977,28040,30937,47.54395781,52.45604219,Food,1,4
84849,32216,52633,37.96862662,62.03137338,Transportation,4,4
117568,25404,92164,21.60792052,78.39207948,Transportation,4,2
197832,32135,165697,16.24358041,83.75641959,Entertainment,0,0
39636,455,39181,1.147946311,98.85205369,Food,1,1
35718,17219,18499,48.20818635,51.79181365,Food,1,1
18616,3751,14865,20.14933391,79.85066609,Housing,3,3
235787,49957,185830,21.18734281,78.81265719,Entertainment,0,0
230677,14547,216130,6.306220386,93.69377961,Entertainment,0,0
125368,61065,64303,48.70860188,51.29139812,Healthcare,2,4
24097,9199,14898,38.17487654,61.82512346,Housing,3,3
11360,4052,7308,35.66901408,64.33098592,Housing,3,3
27437,1324,26113,4.825600467,95.17439953,Housing,3,1
189307,39579,149728,20.90730929,79.09269071,Entertainment,0,0
68563,19301,49262,28.15075186,71.84924814,Transportation,4,4
198300,25271,173029,12.74382249,87.25617751,Entertainment,0,0
61962,8879,53083,14.32975049,85.67024951,Transportation,4,4
51834,17235,34599,33.2503762,66.7496238,Food,1,4
153321,19215,134106,12.53252979,87.46747021,Healthcare,2,0
140400,1819,138581,1.295584046,98.70441595,Healthcare,2,2
182127,31087,151040,17.06885854,82.93114146,Entertainment,0,0
64436,25162,39274,39.0495996,60.9504004,Transportation,4,4
26885,1454,25431,5.408220197,94.5917798,Housing,3,1
34684,20392,14292,58.79368008,41.20631992,Food,1,1
58195,18669,39526,32.08007561,67.91992439,Food,1,4
63774,23964,39810,37.57644181,62.42355819,Transportation,4,4
31694,8116,23578,25.60737048,74.39262952,Food,1,1
70893,23746,47147,33.49554963,66.50445037,Transportation,4,4
128476,66410,62066,51.69058813,48.30941187,Healthcare,2,4
12104,4325,7779,35.73198942,64.26801058,Housing,3,3
17386,4060,13326,23.3521224,76.6478776,Housing,3,3
63078,29110,33968,46.14921209,53.85078791,Transportation,4,4
179315,30353,148962,16.92719516,83.07280484,Healthcare,2,0
219230,54292,164938,24.76485882,75.23514118,Entertainment,0,0
119623,43746,75877,36.56989041,63.43010959,Transportation,4,2
78669,19076,59593,24.24843331,75.75156669,Transportation,4,4
52164,26785,25379,51.34767272,48.65232728,Food,1,4
103774,40581,63193,39.10517085,60.89482915,Transportation,4,4
225660,14268,211392,6.322786493,93.67721351,Entertainment,0,0
191714,5652,186062,2.948141502,97.0518585,Entertainment,0,0
45668,9567,36101,20.94902339,79.05097661,Food,1,1
37242,19305,17937,51.83663606,48.16336394,Food,1,1
162905,33957,128948,20.84466407,79.15533593,Healthcare,2,0
144121,13251,130870,9.194357519,90.80564248,Healthcare,2,2
148933,41636,107297,27.95619507,72.04380493,Healthcare,2,2
37929,17702,20227,46.67141238,53.32858762,Food,1,1
33163,5294,27869,15.96357386,84.03642614,Food,1,1
140040,16033,124007,11.44887175,88.55112825,Healthcare,2,2
237685,46680,191005,19.63943875,80.36056125,Entertainment,0,0
102823,14105,88718,13.71774797,86.28225203,Transportation,4,2
24494,10142,14352,41.40605863,58.59394137,Housing,3,3
44680,3039,41641,6.801700985,93.19829902,Food,1,4
176295,19101,157194,10.83468051,89.16531949,Healthcare,2,0
27894,321,27573,1.150785115,98.84921488,Housing,3,1
49090,24931,24159,50.78631086,49.21368914,Food,1,1
133411,9454,123957,7.086372188,92.91362781,Healthcare,2,2
11530,3681,7849,31.92541197,68.07458803,Housing,3,3
68092,13922,54170,20.44586736,79.55413264,Transportation,4,4
247513,43506,204007,17.57725857,82.42274143,Entertainment,0,0
40177,5975,34202,14.87169276,85.12830724,Food,1,1
154878,32456,122422,20.95584912,79.04415088,Healthcare,2,0
100806,12249,88557,12.15106244,87.84893756,Transportation,4,2
92197,20678,71519,22.42806165,77.57193835,Transportation,4,4
219073,5659,213414,2.583157212,97.41684279,Entertainment,0,0
64446,9705,54741,15.05911926,84.94088074,Transportation,4,4
164899,7636,157263,4.630713346,95.36928665,Healthcare,2,0
116189,66587,49602,57.30921172,42.69078828,Transportation,4,4
25968,13985,11983,53.8547443,46.1452557,Housing,3,1
45663,15380,30283,33.68153647,66.31846353,Food,1,1
218132,1012,217120,0.463939266,99.53606073,Entertainment,0,0
138023,17037,120986,12.34359491,87.65640509,Healthcare,2,2
191562,25766,165796,13.45047556,86.54952444,Entertainment,0,0
118570,64735,53835,54.59644092,45.40355908,Transportation,4,4
38260,3176,35084,8.301097752,91.69890225,Food,1,1
53408,21759,31649,40.74108748,59.25891252,Food,1,4
249452,1911,247541,0.766079246,99.23392075,Entertainment,0,0
15204,3737,11467,24.57905814,75.42094186,Housing,3,3
198865,48768,150097,24.52316898,75.47683102,Entertainment,0,0
41295,19073,22222,46.18718973,53.81281027,Food,1,1
15831,6454,9377,40.7681132,59.2318868,Housing,3,3
110068,16544,93524,15.03070829,84.96929171,Transportation,4,2
153574,65181,88393,42.44273119,57.55726881,Healthcare,2,0
100126,20682,79444,20.65597347,79.34402653,Transportation,4,2
235870,20927,214943,8.872260143,91.12773986,Entertainment,0,0
39894,18708,21186,46.89426982,53.10573018,Food,1,1
68736,15118,53618,21.99429702,78.00570298,Transportation,4,4
27295,7631,19664,27.95750137,72.04249863,Housing,3,1
45227,3612,41615,7.986379817,92.01362018,Food,1,4
108813,32320,76493,29.70233336,70.29766664,Transportation,4,2
10361,5759,4602,55.58343789,44.41656211,Housing,3,3
201676,60433,141243,29.96539003,70.03460997,Entertainment,0,0
34476,16794,17682,48.71214758,51.28785242,Food,1,1
107109,3619,103490,3.378801034,96.62119897,Transportation,4,2
248946,19332,229614,7.765539515,92.23446049,Entertainment,0,0
167443,57516,109927,34.34959957,65.65040043,Healthcare,2,0
96433,31502,64931,32.66724047,67.33275953,Transportation,4,4
56552,26944,29608,47.64464564,52.35535436,Food,1,4
90241,35952,54289,39.83998404,60.16001596,Transportation,4,4
15705,2244,13461,14.28844317,85.71155683,Housing,3,3
11291,6269,5022,55.52209725,44.47790275,Housing,3,3
93885,54994,38891,58.57591735,41.42408265,Transportation,4,4
138715,50542,88173,36.43585769,63.56414231,Healthcare,2,2
37636,5164,32472,13.72090552,86.27909448,Food,1,1
161470,21719,139751,13.45079581,86.54920419,Healthcare,2,0
215419,56370,159049,26.16760824,73.83239176,Entertainment,0,0
242123,28031,214092,11.57717359,88.42282641,Entertainment,0,0
244095,57805,186290,23.68135357,76.31864643,Entertainment,0,0
189708,30350,159358,15.99827103,84.00172897,Entertainment,0,0
147289,18998,128291,12.89845134,87.10154866,Healthcare,2,2
20822,2572,18250,12.35231966,87.64768034,Housing,3,3
23643,1919,21724,8.116567271,91.88343273,Housing,3,3
231021,51207,179814,22.16551742,77.83448258,Entertainment,0,0
127365,32298,95067,25.358615,74.641385,Healthcare,2,2
111194,54079,57115,48.63481843,51.36518157,Transportation,4,4
161049,60176,100873,37.36502555,62.63497445,Healthcare,2,0
50384,16656,33728,33.05811369,66.94188631,Food,1,4
227236,52160,175076,22.95410938,77.04589062,Entertainment,0,0
171329,22021,149308,12.85304881,87.14695119,Healthcare,2,0
35768,3755,32013,10.49821069,89.50178931,Food,1,1
71373,26965,44408,37.78039315,62.21960685,Transportation,4,4
131095,14185,116910,10.82039742,89.17960258,Healthcare,2,2
118493,53172,65321,44.87353683,55.12646317,Transportation,4,4
71455,19300,52155,27.0100063,72.9899937,Transportation,4,4
23419,64,23355,0.273282378,99.72671762,Housing,3,3
189227,53739,135488,28.39922421,71.60077579,Entertainment,0,0
38607,4465,34142,11.56526019,88.43473981,Food,1,1
57774,24225,33549,41.93062623,58.06937377,Food,1,4
23799,4605,19194,19.3495525,80.6504475,Housing,3,3
57225,14088,43137,24.61861075,75.38138925,Food,1,4
53044,860,52184,1.621295528,98.37870447,Food,1,4
225545,4722,220823,2.093595513,97.90640449,Entertainment,0,0
20330,7405,12925,36.42400394,63.57599606,Housing,3,3
47861,18834,29027,39.35145526,60.64854474,Food,1,1
51587,13526,38061,26.21978405,73.78021595,Food,1,4
127747,13869,113878,10.85661503,89.14338497,Healthcare,2,2
220079,12566,207513,5.709767856,94.29023214,Entertainment,0,0
83640,28805,54835,34.43926351,65.56073649,Transportation,4,4
149482,54182,95300,36.2465046,63.7534954,Healthcare,2,2
210479,17588,192891,8.356178051,91.64382195,Entertainment,0,0
189506,15641,173865,8.253564531,91.74643547,Entertainment,0,0
15338,544,14794,3.546746642,96.45325336,Housing,3,3
100315,43467,56848,43.3305089,56.6694911,Transportation,4,4
50670,20092,30578,39.65265443,60.34734557,Food,1,4
114894,43275,71619,37.66515223,62.33484777,Transportation,4,2
167044,939,166105,0.562127344,99.43787266,Healthcare,2,0
59027,31519,27508,53.39759771,46.60240229,Food,1,4
27109,2002,25107,7.385001291,92.61499871,Housing,3,1
130530,17956,112574,13.75622462,86.24377538,Healthcare,2,2
22168,7059,15109,31.8431974,68.1568026,Housing,3,3
146111,57172,88939,39.12915523,60.87084477,Healthcare,2,2
54659,29594,25065,54.14295907,45.85704093,Food,1,4
230075,21802,208273,9.476040422,90.52395958,Entertainment,0,0
17835,17,17818,0.095318195,99.90468181,Housing,3,3
20165,6694,13471,33.19613191,66.80386809,Housing,3,3
134426,43034,91392,32.01315222,67.98684778,Healthcare,2,2
71265,29790,41475,41.80172595,58.19827405,Transportation,4,4
54132,29728,24404,54.91760881,45.08239119,Food,1,4
24219,1749,22470,7.221602874,92.77839713,Housing,3,3
179139,63794,115345,35.61145256,64.38854744,Healthcare,2,0
59309,1991,57318,3.356994723,96.64300528,Food,1,4
20552,10812,9740,52.60801868,47.39198132,Housing,3,3
107053,27902,79151,26.06372544,73.93627456,Transportation,4,2
47896,20930,26966,43.6988475,56.3011525,Food,1,1
31644,14981,16663,47.34230818,52.65769182,Food,1,1
48434,21586,26848,44.56786555,55.43213445,Food,1,1
195842,35397,160445,18.07426395,81.92573605,Entertainment,0,0
39463,3355,36108,8.501634442,91.49836556,Food,1,1
172599,66725,105874,38.65897253,61.34102747,Healthcare,2,0
144801,18327,126474,12.65668055,87.34331945,Healthcare,2,2
204787,28250,176537,13.79482096,86.20517904,Entertainment,0,0
171864,36178,135686,21.05036541,78.94963459,Healthcare,2,0
158057,21478,136579,13.58876861,86.41123139,Healthcare,2,0
20187,2175,18012,10.77426066,89.22573934,Housing,3,3
60632,19048,41584,31.41575406,68.58424594,Transportation,4,4
43492,20347,23145,46.78331647,53.21668353,Food,1,1
43844,9220,34624,21.02910318,78.97089682,Food,1,1
95758,15571,80187,16.26078239,83.73921761,Transportation,4,4
59626,33946,25680,56.93153993,43.06846007,Food,1,4
10049,2463,7586,24.50990148,75.49009852,Housing,3,3
11966,6184,5782,51.67975932,48.32024068,Housing,3,3
32034,10785,21249,33.66735344,66.33264656,Food,1,1
20627,99,20528,0.479953459,99.52004654,Housing,3,3
26740,2409,24331,9.008975318,90.99102468,Housing,3,1
195077,14566,180511,7.466795163,92.53320484,Entertainment,0,0
104953,20055,84898,19.10855335,80.89144665,Transportation,4,2
63438,5518,57920,8.698256565,91.30174343,Transportation,4,4
108523,4329,104194,3.989016153,96.01098385,Transportation,4,2
142138,40277,101861,28.33654617,71.66345383,Healthcare,2,2
72749,26861,45888,36.9228443,63.0771557,Transportation,4,4
231784,25901,205883,11.1746281,88.8253719,Entertainment,0,0
27637,11342,16295,41.0391866,58.9608134,Housing,3,1
79483,41783,37700,52.56847376,47.43152624,Transportation,4,4
188894,7083,181811,3.749722066,96.25027793,Entertainment,0,0
28600,14340,14260,50.13986014,49.86013986,Housing,3,1
100114,53888,46226,53.82663763,46.17336237,Transportation,4,4
35991,9338,26653,25.94537523,74.05462477,Food,1,1
19719,11378,8341,57.70069476,42.29930524,Housing,3,3
118080,46247,71833,39.16581978,60.83418022,Transportation,4,2
29979,4078,25901,13.60285533,86.39714467,Housing,3,1
48527,19807,28720,40.8164527,59.1835473,Food,1,1
52514,3261,49253,6.209772632,93.79022737,Food,1,4
30466,5793,24673,19.01463927,80.98536073,Food,1,1
61348,14704,46644,23.96818152,76.03181848,Transportation,4,4
67754,1633,66121,2.410189804,97.5898102,Transportation,4,4
99870,14117,85753,14.13537599,85.86462401,Transportation,4,4
151524,56487,95037,37.27924289,62.72075711,Healthcare,2,0
124153,13542,110611,10.90750928,89.09249072,Healthcare,2,2
138441,17032,121409,12.30271379,87.69728621,Healthcare,2,2
46073,20226,25847,43.89989799,56.10010201,Food,1,1
29956,13711,16245,45.77046335,54.22953665,Housing,3,1
10868,5259,5609,48.38976813,51.61023187,Housing,3,3
66918,14664,52254,21.91338653,78.08661347,Transportation,4,4
127126,59641,67485,46.91487186,53.08512814,Healthcare,2,4
20849,10802,10047,51.8106384,48.1893616,Housing,3,3
166006,46533,119473,28.03091455,71.96908545,Healthcare,2,0
46596,25521,21075,54.77079578,45.22920422,Food,1,1
62574,28453,34121,45.47096238,54.52903762,Transportation,4,4
192056,40130,151926,20.89494731,79.10505269,Entertainment,0,0
172923,32422,140501,18.74938556,81.25061444,Healthcare,2,0
239801,18877,220924,7.87194382,92.12805618,Entertainment,0,0
215404,3960,211444,1.838405972,98.16159403,Entertainment,0,0
69031,36895,32136,53.44700207,46.55299793,Transportation,4,4
72764,14653,58111,20.13770546,79.86229454,Transportation,4,4
47587,14275,33312,29.99768844,70.00231156,Food,1,1
95750,780,94970,0.81462141,99.18537859,Transportation,4,4
49900,6450,43450,12.9258517,87.0741483,Food,1,4
203545,7420,196125,3.645385541,96.35461446,Entertainment,0,0
37238,21948,15290,58.93979268,41.06020732,Food,1,1
111037,39386,71651,35.4710592,64.5289408,Transportation,4,2
46207,4415,41792,9.554829355,90.44517065,Food,1,4
223354,580,222774,0.259677463,99.74032254,Entertainment,0,0
14731,5245,9486,35.60518634,64.39481366,Housing,3,3
10268,874,9394,8.511881574,91.48811843,Housing,3,3
23809,8420,15389,35.36477803,64.63522197,Housing,3,3
123797,51142,72655,41.31117878,58.68882122,Healthcare,2,2
49443,18045,31398,36.49657181,63.50342819,Food,1,1
29226,11635,17591,39.81044276,60.18955724,Housing,3,1
33448,19154,14294,57.26500837,42.73499163,Food,1,1
211604,2872,208732,1.357252226,98.64274777,Entertainment,0,0
11760,1199,10561,10.19557823,89.80442177,Housing,3,3
243523,8899,234624,3.654274956,96.34572504,Entertainment,0,0
21300,8908,12392,41.82159624,58.17840376,Housing,3,3
101770,54448,47322,53.50103174,46.49896826,Transportation,4,4
37897,5839,32058,15.40755205,84.59244795,Food,1,1
227508,27813,199695,12.22506461,87.77493539,Entertainment,0,0
50344,4491,45853,8.920626092,91.07937391,Food,1,4
171440,15093,156347,8.803663089,91.19633691,Healthcare,2,0
26965,11181,15784,41.46486186,58.53513814,Housing,3,1
205893,14659,191234,7.119717523,92.88028248,Entertainment,0,0
238858,44306,194552,18.54909612,81.45090388,Entertainment,0,0
38526,21505,17021,55.81944661,44.18055339,Food,1,1
51912,2068,49844,3.983664663,96.01633534,Food,1,4
177148,47677,129471,26.91365412,73.08634588,Healthcare,2,0
91958,34905,57053,37.95754584,62.04245416,Transportation,4,4
29068,16093,12975,55.36328609,44.63671391,Housing,3,1
16286,899,15387,5.520078595,94.4799214,Housing,3,3
134122,40025,94097,29.84223319,70.15776681,Healthcare,2,2
182461,50135,132326,27.4771047,72.5228953,Entertainment,0,0
172778,43141,129637,24.96903541,75.03096459,Healthcare,2,0
98408,42176,56232,42.8583042,57.1416958,Transportation,4,4
23428,2201,21227,9.394741335,90.60525866,Housing,3,3
224582,41804,182778,18.61413648,81.38586352,Entertainment,0,0
162381,50043,112338,30.81826076,69.18173924,Healthcare,2,0
192559,56869,135690,29.5332859,70.4667141,Entertainment,0,0
20246,6275,13971,30.99377655,69.00622345,Housing,3,3
67739,40153,27586,59.27604482,40.72395518,Transportation,4,4
72011,9219,62792,12.80221077,87.19778923,Transportation,4,4
47932,1997,45935,4.166318952,95.83368105,Food,1,4
12621,5992,6629,47.47642818,52.52357182,Housing,3,3
238378,29681,208697,12.45123292,87.54876708,Entertainment,0,0
112120,21488,90632,19.16518016,80.83481984,Transportation,4,2
194716,7295,187421,3.746482056,96.25351794,Entertainment,0,0
183558,10754,172804,5.858638686,94.14136131,Entertainment,0,0
157904,48479,109425,30.70156551,69.29843449,Healthcare,2,0
10111,3481,6630,34.42785086,65.57214914,Housing,3,3
107360,13332,94028,12.41803279,87.58196721,Transportation,4,2
240015,51402,188613,21.41616149,78.58383851,Entertainment,0,0
88576,24062,64514,27.16537211,72.83462789,Transportation,4,4
17103,9212,7891,53.86189557,46.13810443,Housing,3,3
41769,16979,24790,40.64976418,59.35023582,Food,1,1
248099,58068,190031,23.40517293,76.59482707,Entertainment,0,0
47245,18657,28588,39.48989311,60.51010689,Food,1,1
51477,2914,48563,5.660780543,94.33921946,Food,1,4
125348,13272,112076,10.58812267,89.41187733,Healthcare,2,2
139766,16811,122955,12.02796102,87.97203898,Healthcare,2,2
66391,11854,54537,17.85482972,82.14517028,Transportation,4,4
23410,10354,13056,44.22896198,55.77103802,Housing,3,3
16943,10057,6886,59.3578469,40.6421531,Housing,3,3
248784,2107,246677,0.846919416,99.15308058,Entertainment,0,0
51353,12108,39245,23.57797986,76.42202014,Food,1,4
233235,31259,201976,13.40236242,86.59763758,Entertainment,0,0
18441,8009,10432,43.43039965,56.56960035,Housing,3,3
61555,23772,37783,38.61912111,61.38087889,Transportation,4,4
58508,21430,37078,36.62746975,63.37253025,Food,1,4
47258,6946,40312,14.69804054,85.30195946,Food,1,1
178613,60617,117996,33.93761932,66.06238068,Healthcare,2,0
125609,10248,115361,8.158651052,91.84134895,Healthcare,2,2
175361,19277,156084,10.99275209,89.00724791,Healthcare,2,0
63444,31932,31512,50.33100057,49.66899943,Transportation,4,4
146651,15978,130673,10.89525472,89.10474528,Healthcare,2,2
29715,10580,19135,35.60491334,64.39508666,Housing,3,1
192604,5679,186925,2.948536894,97.05146311,Entertainment,0,0
144631,21865,122766,15.11778249,84.88221751,Healthcare,2,2
149807,2120,147687,1.415154165,98.58484583,Healthcare,2,2
54807,2525,52282,4.607075739,95.39292426,Food,1,4
134660,27778,106882,20.62824892,79.37175108,Healthcare,2,2
113794,15710,98084,13.8056488,86.1943512,Transportation,4,2
11771,6895,4876,58.57616175,41.42383825,Housing,3,3
131995,65963,66032,49.97386265,50.02613735,Healthcare,2,4
149325,23330,125995,15.62363971,84.37636029,Healthcare,2,2
22198,3088,19110,13.91116317,86.08883683,Housing,3,3
18091,6274,11817,34.68022774,65.31977226,Housing,3,3
224246,69266,154980,30.88839935,69.11160065,Entertainment,0,0
239315,18529,220786,7.742515095,92.2574849,Entertainment,0,0
99952,47004,52948,47.02657275,52.97342725,Transportation,4,4
240355,15598,224757,6.489567515,93.51043249,Entertainment,0,0
55438,1694,53744,3.055665789,96.94433421,Food,1,4
211193,2252,208941,1.066323221,98.93367678,Entertainment,0,0
159509,16200,143309,10.15616674,89.84383326,Healthcare,2,0
214027,27163,186864,12.6913894,87.3086106,Entertainment,0,0
173846,10076,163770,5.795934333,94.20406567,Healthcare,2,0
46453,5326,41127,11.46535208,88.53464792,Food,1,4
224890,14954,209936,6.649473076,93.35052692,Entertainment,0,0
189702,41616,148086,21.93756523,78.06243477,Entertainment,0,0
118978,69650,49328,58.54023433,41.45976567,Transportation,4,4
125773,38267,87506,30.42544902,69.57455098,Healthcare,2,2
57674,5075,52599,8.799459028,91.20054097,Food,1,4
23845,1935,21910,8.114908786,91.88509121,Housing,3,3
15683,8951,6732,57.07453931,42.92546069,Housing,3,3
118796,26135,92661,21.99989899,78.00010101,Transportation,4,2
100732,26210,74522,26.01953699,73.98046301,Transportation,4,2
73502,13839,59663,18.8280591,81.1719409,Transportation,4,4
155331,60760,94571,39.11646741,60.88353259,Healthcare,2,0
23262,2239,21023,9.625139713,90.37486029,Housing,3,3
35280,2059,33221,5.8361678,94.1638322,Food,1,1
217974,48566,169408,22.28063898,77.71936102,Entertainment,0,0
229243,23707,205536,10.34142809,89.65857191,Entertainment,0,0
14862,1996,12866,13.43022473,86.56977527,Housing,3,3
25106,1241,23865,4.943041504,95.0569585,Housing,3,1
26880,7677,19203,28.56026786,71.43973214,Housing,3,1
93393,30839,62554,33.02067607,66.97932393,Transportation,4,4
20075,9698,10377,48.30884184,51.69115816,Housing,3,3
91957,51643,40314,56.15994432,43.84005568,Transportation,4,4
45354,20508,24846,45.21762138,54.78237862,Food,1,1
77502,15608,61894,20.13883513,79.86116487,Transportation,4,4
35969,12551,23418,34.89393645,65.10606355,Food,1,1
145473,9446,136027,6.493301162,93.50669884,Healthcare,2,2
67813,31591,36222,46.58546296,53.41453704,Transportation,4,4
249424,25305,224119,10.14537494,89.85462506,Entertainment,0,0
162661,64351,98310,39.56141915,60.43858085,Healthcare,2,0
130742,40781,89961,31.19196586,68.80803414,Healthcare,2,2
32446,14323,18123,44.14411638,55.85588362,Food,1,1
34389,11451,22938,33.29843845,66.70156155,Food,1,1
28093,10417,17676,37.08041149,62.91958851,Housing,3,1
127446,42624,84822,33.44475307,66.55524693,Healthcare,2,2
140797,11819,128978,8.394354993,91.60564501,Healthcare,2,2
149788,42096,107692,28.10371992,71.89628008,Healthcare,2,2
36511,2830,33681,7.751088713,92.24891129,Food,1,1
227837,23275,204562,10.21563662,89.78436338,Entertainment,0,0
99711,41030,58681,41.14892038,58.85107962,Transportation,4,4
213831,2735,211096,1.279047472,98.72095253,Entertainment,0,0
168072,62469,105603,37.16799943,62.83200057,Healthcare,2,0
129595,18451,111144,14.237432,85.762568,Healthcare,2,2
147464,1813,145651,1.229452612,98.77054739,Healthcare,2,2
13217,4666,8551,35.30301884,64.69698116,Housing,3,3
104745,54268,50477,51.80963292,48.19036708,Transportation,4,4
10473,2841,7632,27.12689774,72.87310226,Housing,3,3
37896,17023,20873,44.92030821,55.07969179,Food,1,1
26234,10234,16000,39.01044446,60.98955554,Housing,3,1
234428,57819,176609,24.66386268,75.33613732,Entertainment,0,0
187314,61879,125435,33.03490396,66.96509604,Entertainment,0,0
141582,23141,118441,16.34459183,83.65540817,Healthcare,2,2
120080,40462,79618,33.69586942,66.30413058,Healthcare,2,2
175016,42279,132737,24.15721991,75.84278009,Healthcare,2,0
154853,1384,153469,0.893750848,99.10624915,Healthcare,2,0
144345,6626,137719,4.590391077,95.40960892,Healthcare,2,2
124808,29166,95642,23.36869431,76.63130569,Healthcare,2,2
22143,5260,16883,23.75468545,76.24531455,Housing,3,3
129575,64575,65000,49.83600232,50.16399768,Healthcare,2,4
21074,10745,10329,50.9869982,49.0130018,Housing,3,3
53671,18780,34891,34.99096346,65.00903654,Food,1,4
152261,30581,121680,20.08459159,79.91540841,Healthcare,2,0
107433,11806,95627,10.98917465,89.01082535,Transportation,4,2
76104,24920,51184,32.74466519,67.25533481,Transportation,4,4
126848,53081,73767,41.84614657,58.15385343,Healthcare,2,2
96829,42689,54140,44.08699873,55.91300127,Transportation,4,4
104651,17067,87584,16.30849204,83.69150796,Transportation,4,2
51296,2113,49183,4.11922957,95.88077043,Food,1,4
48596,12441,36155,25.6008725,74.3991275,Food,1,1
112373,50184,62189,44.65841439,55.34158561,Transportation,4,4
44144,17188,26956,38.93620877,61.06379123,Food,1,1
169295,3018,166277,1.782687026,98.21731297,Healthcare,2,0
29485,8485,21000,28.77734441,71.22265559,Housing,3,1
166459,53359,113100,32.05534095,67.94465905,Healthcare,2,0
76367,21196,55171,27.75544411,72.24455589,Transportation,4,4
31359,13914,17445,44.37003731,55.62996269,Food,1,1
160743,59647,101096,37.10705909,62.89294091,Healthcare,2,0
52765,28767,23998,54.5190941,45.4809059,Food,1,4
96662,8406,88256,8.696281889,91.30371811,Transportation,4,4
63016,2576,60440,4.087850705,95.9121493,Transportation,4,4
61047,18333,42714,30.03095975,69.96904025,Transportation,4,4
132760,50333,82427,37.91277493,62.08722507,Healthcare,2,2
83901,23038,60863,27.45855234,72.54144766,Transportation,4,4
29473,17617,11856,59.77335188,40.22664812,Housing,3,1
164782,19303,145479,11.71426491,88.28573509,Healthcare,2,0
167947,16110,151837,9.59231186,90.40768814,Healthcare,2,0
242279,48736,193543,20.11565179,79.88434821,Entertainment,0,0
173377,58200,115177,33.56846641,66.43153359,Healthcare,2,0
181232,51750,129482,28.5545599,71.4454401,Entertainment,0,0
125117,34491,90626,27.56699729,72.43300271,Healthcare,2,2
79835,12699,67136,15.90655727,84.09344273,Transportation,4,4
86421,42752,43669,49.46945765,50.53054235,Transportation,4,4
128581,11695,116886,9.095434007,90.90456599,Healthcare,2,2
16035,751,15284,4.683504833,95.31649517,Housing,3,3
34886,20884,14002,59.86355558,40.13644442,Food,1,1
57457,31417,26040,54.67915137,45.32084863,Food,1,4
65294,21316,43978,32.64618495,67.35381505,Transportation,4,4
156252,67273,88979,43.05416891,56.94583109,Healthcare,2,0
98412,29859,68553,30.3408121,69.6591879,Transportation,4,4
121729,15506,106223,12.73813142,87.26186858,Healthcare,2,2
206979,29893,177086,14.44252799,85.55747201,Entertainment,0,0
227092,42280,184812,18.61800504,81.38199496,Entertainment,0,0
14416,26,14390,0.180355161,99.81964484,Housing,3,3
61646,29667,31979,48.12477695,51.87522305,Transportation,4,4
23793,522,23271,2.193922582,97.80607742,Housing,3,3
229738,64930,164808,28.2626296,71.7373704,Entertainment,0,0
20670,11650,9020,56.36187712,43.63812288,Housing,3,3
127511,59352,68159,46.54657245,53.45342755,Healthcare,2,4
43363,125,43238,0.288264188,99.71173581,Food,1,4
115428,2741,112687,2.374640469,97.62535953,Transportation,4,2
68005,7243,60762,10.65068745,89.34931255,Transportation,4,4
94219,12555,81664,13.32533778,86.67466222,Transportation,4,4
156911,9911,147000,6.316319442,93.68368056,Healthcare,2,0
24537,10370,14167,42.2627053,57.7372947,Housing,3,3
197879,43983,153896,22.22721966,77.77278034,Entertainment,0,0
46067,15310,30757,33.23420236,66.76579764,Food,1,1
119194,27482,91712,23.05652969,76.94347031,Transportation,4,2
130219,42051,88168,32.2925226,67.7074774,Healthcare,2,2
143758,12383,131375,8.613781494,91.38621851,Healthcare,2,2
76491,26192,50299,34.24193696,65.75806304,Transportation,4,4
95588,20096,75492,21.02355944,78.97644056,Transportation,4,4
242288,18246,224042,7.530707257,92.46929274,Entertainment,0,0
143111,59276,83835,41.41959738,58.58040262,Healthcare,2,2
149991,55296,94695,36.86621197,63.13378803,Healthcare,2,2
29733,9767,19966,32.84902297,67.15097703,Housing,3,1
82976,49286,33690,59.39789819,40.60210181,Transportation,4,4
54494,30087,24407,55.21158293,44.78841707,Food,1,4
247381,31271,216110,12.64082529,87.35917471,Entertainment,0,0
28651,12134,16517,42.35105232,57.64894768,Housing,3,1
19549,1348,18201,6.895493376,93.10450662,Housing,3,3
182150,51177,130973,28.09607466,71.90392534,Entertainment,0,0
216258,51614,164644,23.86686273,76.13313727,Entertainment,0,0
28248,16259,11989,57.55805721,42.44194279,Housing,3,1
248825,2668,246157,1.072239526,98.92776047,Entertainment,0,0
106521,30149,76372,28.30333925,71.69666075,Transportation,4,2
233707,2833,230874,1.212201603,98.7877984,Entertainment,0,0
156713,4671,152042,2.980607863,97.01939214,Healthcare,2,0
59808,2356,57452,3.939272338,96.06072766,Food,1,4
62975,33363,29612,52.97816594,47.02183406,Transportation,4,4
172483,36065,136418,20.909307,79.090693,Healthcare,2,0
210310,54534,155776,25.93029338,74.06970662,Entertainment,0,0
30126,13303,16823,44.15787028,55.84212972,Food,1,1
26109,5785,20324,22.15711057,77.84288943,Housing,3,1
117057,21357,95700,18.24495758,81.75504242,Transportation,4,2
121943,57138,64805,46.85631812,53.14368188,Healthcare,2,4
157507,38462,119045,24.41923216,75.58076784,Healthcare,2,0
219469,41457,178012,18.88968374,81.11031626,Entertainment,0,0
34982,16504,18478,47.17854897,52.82145103,Food,1,1
17985,1847,16138,10.26966917,89.73033083,Housing,3,3
14867,3115,11752,20.95244501,79.04755499,Housing,3,3
96122,13846,82276,14.40461081,85.59538919,Transportation,4,4
12533,4310,8223,34.38921248,65.61078752,Housing,3,3
122403,35746,86657,29.20353259,70.79646741,Healthcare,2,2
75934,19358,56576,25.49319146,74.50680854,Transportation,4,4
57992,6579,51413,11.34466823,88.65533177,Food,1,4
173527,61262,112265,35.30401609,64.69598391,Healthcare,2,0
23473,12256,11217,52.2131811,47.7868189,Housing,3,3
24914,5985,18929,24.02263787,75.97736213,Housing,3,3
49332,20369,28963,41.28962945,58.71037055,Food,1,1
176756,40426,136330,22.87107651,77.12892349,Healthcare,2,0
139915,17933,121982,12.81706751,87.18293249,Healthcare,2,2
74862,28527,46335,38.10611525,61.89388475,Transportation,4,4
162505,53678,108827,33.03159903,66.96840097,Healthcare,2,0
125410,12012,113398,9.578183558,90.42181644,Healthcare,2,2
154815,46899,107916,30.2935762,69.7064238,Healthcare,2,0
46424,5762,40662,12.41168361,87.58831639,Food,1,4
92615,50189,42426,54.19100578,45.80899422,Transportation,4,4
118815,47259,71556,39.7752809,60.2247191,Transportation,4,2
29328,13379,15949,45.61852155,54.38147845,Housing,3,1
150714,44149,106565,29.29323089,70.70676911,Healthcare,2,0
48703,4618,44085,9.481962097,90.5180379,Food,1,4
42577,4904,37673,11.5179557,88.4820443,Food,1,1
140508,15909,124599,11.32248698,88.67751302,Healthcare,2,2
200651,6096,194555,3.038110949,96.96188905,Entertainment,0,0
109686,54618,55068,49.79486899,50.20513101,Transportation,4,4
29819,13440,16379,45.071934,54.928066,Housing,3,1
129682,58609,71073,45.19439861,54.80560139,Healthcare,2,2
200389,62521,137868,31.19981636,68.80018364,Entertainment,0,0
84461,11805,72656,13.97686506,86.02313494,Transportation,4,4
12854,6370,6484,49.55655827,50.44344173,Housing,3,3
163932,54714,109218,33.37603397,66.62396603,Healthcare,2,0
232485,37621,194864,16.18211928,83.81788072,Entertainment,0,0
181455,11583,169872,6.383400843,93.61659916,Entertainment,0,0
56983,32309,24674,56.69936648,43.30063352,Food,1,4
39099,5716,33383,14.61929973,85.38070027,Food,1,1
213435,59372,154063,27.81736829,72.18263171,Entertainment,0,0
53574,27808,25766,51.90577519,48.09422481,Food,1,4
201415,14635,186780,7.266092396,92.7339076,Entertainment,0,0
86202,12463,73739,14.45790121,85.54209879,Transportation,4,4
38009,21651,16358,56.96282459,43.03717541,Food,1,1
15360,1713,13647,11.15234375,88.84765625,Housing,3,3
129720,54011,75709,41.63660191,58.36339809,Healthcare,2,2
64540,29461,35079,45.64766037,54.35233963,Transportation,4,4
75509,5125,70384,6.787270392,93.21272961,Transportation,4,4
73526,1816,71710,2.469874602,97.5301254,Transportation,4,4
22206,7212,14994,32.47770873,67.52229127,Housing,3,3
121736,15285,106451,12.55585858,87.44414142,Healthcare,2,2
190069,25714,164355,13.52877113,86.47122887,Entertainment,0,0
52440,22754,29686,43.39054157,56.60945843,Food,1,4
18522,2543,15979,13.72961883,86.27038117,Housing,3,3
113786,4122,109664,3.622589774,96.37741023,Transportation,4,2
14494,2261,12233,15.59955844,84.40044156,Housing,3,3
16666,6347,10319,38.08352334,61.91647666,Housing,3,3
144159,3797,140362,2.633897294,97.36610271,Healthcare,2,2
14829,2187,12642,14.74812867,85.25187133,Housing,3,3
29457,5699,23758,19.34684455,80.65315545,Housing,3,1
29854,1937,27917,6.488242782,93.51175722,Housing,3,1
148244,55294,92950,37.29931734,62.70068266,Healthcare,2,2
45108,14120,30988,31.30265141,68.69734859,Food,1,1
213466,33453,180013,15.67134813,84.32865187,Entertainment,0,0
219046,3349,215697,1.528902605,98.4710974,Entertainment,0,0
136803,67996,68807,49.70358837,50.29641163,Healthcare,2,4
244378,22027,222351,9.013495487,90.98650451,Entertainment,0,0
56095,503,55592,0.89669311,99.10330689,Food,1,4
99171,52218,46953,52.65450585,47.34549415,Transportation,4,4
105755,39175,66580,37.04316581,62.95683419,Transportation,4,2
111621,49628,61993,44.4611677,55.5388323,Transportation,4,4
192931,36376,156555,18.85440909,81.14559091,Entertainment,0,0
236534,22006,214528,9.303525075,90.69647493,Entertainment,0,0
63520,19344,44176,30.4534005,69.5465995,Transportation,4,4
117839,32623,85216,27.68438293,72.31561707,Transportation,4,2
49373,21463,27910,43.47112794,56.52887206,Food,1,1
140625,67398,73227,47.92746667,52.07253333,Healthcare,2,2
27348,3837,23511,14.03027644,85.96972356,Housing,3,1
47291,13515,33776,28.57837644,71.42162356,Food,1,1
133240,65159,68081,48.90348244,51.09651756,Healthcare,2,4
32895,10541,22354,32.04438364,67.95561636,Food,1,1
210292,11611,198681,5.521370285,94.47862971,Entertainment,0,0
17298,2800,14498,16.18684241,83.81315759,Housing,3,3
74682,4834,69848,6.472777912,93.52722209,Transportation,4,4
136796,14873,121923,10.87239393,89.12760607,Healthcare,2,2
244313,46559,197754,19.05711116,80.94288884,Entertainment,0,0
201586,28079,173507,13.92904269,86.07095731,Entertainment,0,0
189320,36738,152582,19.40523981,80.59476019,Entertainment,0,0
86264,24073,62191,27.90619494,72.09380506,Transportation,4,4
140604,65625,74979,46.6736366,53.3263634,Healthcare,2,2
27036,8638,18398,31.9499926,68.0500074,Housing,3,1
209544,65266,144278,31.14668041,68.85331959,Entertainment,0,0
39182,16739,22443,42.72114747,57.27885253,Food,1,1
213526,33207,180319,15.55173609,84.44826391,Entertainment,0,0
148073,44277,103796,29.90214286,70.09785714,Healthcare,2,2
10001,508,9493,5.079492051,94.92050795,Housing,3,3
64257,5046,59211,7.852840936,92.14715906,Transportation,4,4
23044,10223,12821,44.36295782,55.63704218,Housing,3,3
126991,37103,89888,29.21703113,70.78296887,Healthcare,2,2
41956,23505,18451,56.02297645,43.97702355,Food,1,1
24942,2434,22508,9.758640045,90.24135996,Housing,3,3
177228,12545,164683,7.078452615,92.92154739,Healthcare,2,0
142257,67703,74554,47.59203414,52.40796586,Healthcare,2,2
81377,394,80983,0.484166288,99.51583371,Transportation,4,4
136552,45253,91299,33.13975628,66.86024372,Healthcare,2,2
215848,31523,184325,14.60425855,85.39574145,Entertainment,0,0
78631,45723,32908,58.14882171,41.85117829,Transportation,4,4
187714,36302,151412,19.33899443,80.66100557,Entertainment,0,0
60132,24708,35424,41.08960287,58.91039713,Transportation,4,4
137557,17659,119898,12.83758733,87.16241267,Healthcare,2,2
183684,7762,175922,4.225735502,95.7742645,Entertainment,0,0
78197,20262,57935,25.91147998,74.08852002,Transportation,4,4
148698,47966,100732,32.25732693,67.74267307,Healthcare,2,2
99327,2216,97111,2.231014729,97.76898527,Transportation,4,4
81212,7383,73829,9.091021031,90.90897897,Transportation,4,4
145550,4924,140626,3.383029887,96.61697011,Healthcare,2,2
46701,6339,40362,13.57358515,86.42641485,Food,1,1
17182,9726,7456,56.6057502,43.3942498,Housing,3,3
17631,932,16699,5.286143724,94.71385628,Housing,3,3
48144,17278,30866,35.88816883,64.11183117,Food,1,1
132668,61839,70829,46.6118431,53.3881569,Healthcare,2,4
110563,6420,104143,5.806644176,94.19335582,Transportation,4,2
158706,23120,135586,14.56781722,85.43218278,Healthcare,2,0
103864,5833,98031,5.615997843,94.38400216,Transportation,4,2
124491,31907,92584,25.62996522,74.37003478,Healthcare,2,2
96441,3042,93399,3.154260118,96.84573988,Transportation,4,4
209190,53030,156160,25.35016014,74.64983986,Entertainment,0,0
226326,27651,198675,12.21733252,87.78266748,Entertainment,0,0
100300,42993,57307,42.86440678,57.13559322,Transportation,4,4
37429,16039,21390,42.85179941,57.14820059,Food,1,1
22366,12105,10261,54.12232853,45.87767147,Housing,3,3
40903,8783,32120,21.47275261,78.52724739,Food,1,1
86208,1553,84655,1.801456941,98.19854306,Transportation,4,4
88691,19508,69183,21.99546741,78.00453259,Transportation,4,4
205122,66479,138643,32.40949289,67.59050711,Entertainment,0,0
190675,34121,156554,17.89484725,82.10515275,Entertainment,0,0
28166,11028,17138,39.15358943,60.84641057,Housing,3,1
168537,15201,153336,9.019384468,90.98061553,Healthcare,2,0
244749,54881,189868,22.42338069,77.57661931,Entertainment,0,0
67549,21656,45893,32.05969,67.94031,Transportation,4,4
10419,2562,7857,24.58969191,75.41030809,Housing,3,3
202957,28732,174225,14.15669329,85.84330671,Entertainment,0,0
207411,13420,193991,6.470245069,93.52975493,Entertainment,0,0
69192,27473,41719,39.70545728,60.29454272,Transportation,4,4
112698,56611,56087,50.23247972,49.76752028,Transportation,4,4
50063,8540,41523,17.05850628,82.94149372,Food,1,4
104139,54990,49149,52.80442486,47.19557514,Transportation,4,4
53433,7924,45509,14.82978684,85.17021316,Food,1,4
39965,15788,24177,39.5045665,60.4954335,Food,1,1
163968,67463,96505,41.14400371,58.85599629,Healthcare,2,0
124186,54021,70165,43.50007247,56.49992753,Healthcare,2,4
54646,23627,31019,43.23646745,56.76353255,Food,1,4
94596,34474,60122,36.44340141,63.55659859,Transportation,4,4
105948,30319,75629,28.61686865,71.38313135,Transportation,4,2
17480,10338,7142,59.14187643,40.85812357,Housing,3,3
104876,46166,58710,44.0196041,55.9803959,Transportation,4,4
24398,14367,10031,58.88597426,41.11402574,Housing,3,3
33018,2359,30659,7.144587801,92.8554122,Food,1,1
37172,3287,33885,8.842677284,91.15732272,Food,1,1
47469,16645,30824,35.06498978,64.93501022,Food,1,1
60529,33467,27062,55.29085232,44.70914768,Transportation,4,4
193898,1289,192609,0.664782515,99.33521749,Entertainment,0,0
136809,12223,124586,8.934353734,91.06564627,Healthcare,2,2
19341,10308,9033,53.29610672,46.70389328,Housing,3,3
132069,12614,119455,9.551068002,90.448932,Healthcare,2,2
152049,61801,90248,40.64544982,59.35455018,Healthcare,2,0
22286,9069,13217,40.69370906,59.30629094,Housing,3,3
88479,24916,63563,28.16035443,71.83964557,Transportation,4,4
140626,55011,85615,39.11865516,60.88134484,Healthcare,2,2
23050,1047,22003,4.542299349,95.45770065,Housing,3,3
36800,5627,31173,15.29076087,84.70923913,Food,1,1
30570,4086,26484,13.36604514,86.63395486,Food,1,1
198349,6190,192159,3.120761889,96.87923811,Entertainment,0,0
215066,48467,166599,22.53587271,77.46412729,Entertainment,0,0
18634,7991,10643,42.88397553,57.11602447,Housing,3,3
157846,32432,125414,20.54660872,79.45339128,Healthcare,2,0
201748,6535,195213,3.239189484,96.76081052,Entertainment,0,0
51032,6418,44614,12.57642264,87.42357736,Food,1,4
194447,49081,145366,25.2413254,74.7586746,Entertainment,0,0
43830,20196,23634,46.07802875,53.92197125,Food,1,1
96573,30647,65926,31.73454278,68.26545722,Transportation,4,4
66173,36765,29408,55.55891376,44.44108624,Transportation,4,4
111223,15278,95945,13.73636748,86.26363252,Transportation,4,2
131719,31703,100016,24.06866132,75.93133868,Healthcare,2,2
18245,975,17270,5.343929844,94.65607016,Housing,3,3
37134,6446,30688,17.35875478,82.64124522,Food,1,1
96931,43345,53586,44.71737628,55.28262372,Transportation,4,4
244016,17638,226378,7.228214543,92.77178546,Entertainment,0,0
67635,36532,31103,54.01345457,45.98654543,Transportation,4,4
71648,30076,41572,41.97744529,58.02255471,Transportation,4,4
57207,12318,44889,21.53232996,78.46767004,Food,1,4
113417,15167,98250,13.3727748,86.6272252,Transportation,4,2
84714,45627,39087,53.86004675,46.13995325,Transportation,4,4
32462,5575,26887,17.17392644,82.82607356,Food,1,1
162628,58634,103994,36.05406203,63.94593797,Healthcare,2,0
29502,6368,23134,21.58497729,78.41502271,Housing,3,1
14308,8564,5744,59.85462678,40.14537322,Housing,3,3
170826,39682,131144,23.22948497,76.77051503,Healthcare,2,0
195629,37498,158131,19.16791478,80.83208522,Entertainment,0,0
89039,42070,46969,47.24895832,52.75104168,Transportation,4,4
245116,21904,223212,8.936177157,91.06382284,Entertainment,0,0
39816,1386,38430,3.481012658,96.51898734,Food,1,1
69888,22122,47766,31.65350275,68.34649725,Transportation,4,4
224884,11649,213235,5.180003913,94.81999609,Entertainment,0,0
208148,65632,142516,31.53141034,68.46858966,Entertainment,0,0
38789,11456,27333,29.53414628,70.46585372,Food,1,1
128155,61985,66170,48.36721158,51.63278842,Healthcare,2,4
174603,4703,169900,2.693539057,97.30646094,Healthcare,2,0
57205,27785,29420,48.57092911,51.42907089,Food,1,4
170027,14794,155233,8.700971022,91.29902898,Healthcare,2,0
61808,7238,54570,11.71045819,88.28954181,Transportation,4,4
80185,31922,48263,39.81043836,60.18956164,Transportation,4,4
140579,53939,86640,38.36917321,61.63082679,Healthcare,2,2
179672,8025,171647,4.466472238,95.53352776,Healthcare,2,0
36084,9034,27050,25.03602705,74.96397295,Food,1,1
147052,62323,84729,42.38160651,57.61839349,Healthcare,2,2
56903,21106,35797,37.09119027,62.90880973,Food,1,4
65427,24096,41331,36.82883213,63.17116787,Transportation,4,4
224188,11474,212714,5.118025943,94.88197406,Entertainment,0,0
39291,8857,30434,22.54205798,77.45794202,Food,1,1
165121,21089,144032,12.7718461,87.2281539,Healthcare,2,0
54622,29672,24950,54.32243418,45.67756582,Food,1,4
13795,4423,9372,32.06234143,67.93765857,Housing,3,3
92731,22199,70532,23.93913578,76.06086422,Transportation,4,4
39393,16145,23248,40.98443886,59.01556114,Food,1,1
210915,7105,203810,3.36865562,96.63134438,Entertainment,0,0
149410,49994,99416,33.46094639,66.53905361,Healthcare,2,2
12483,106,12377,0.849154851,99.15084515,Housing,3,3
104756,36057,68699,34.41998549,65.58001451,Transportation,4,2
33737,11806,21931,34.99422,65.00578,Food,1,1
120764,40080,80684,33.18869862,66.81130138,Healthcare,2,2
51232,20921,30311,40.83580575,59.16419425,Food,1,4
25851,12779,13072,49.43329078,50.56670922,Housing,3,1
97368,43731,53637,44.91311314,55.08688686,Transportation,4,4
127172,66537,60635,52.32047935,47.67952065,Healthcare,2,4
17453,2043,15410,11.70572394,88.29427606,Housing,3,3
22739,8593,14146,37.78970051,62.21029949,Housing,3,3
26144,6902,19242,26.3999388,73.6000612,Housing,3,1
216423,57456,158967,26.54801015,73.45198985,Entertainment,0,0
21103,8992,12111,42.61005544,57.38994456,Housing,3,3
248388,23524,224864,9.47066686,90.52933314,Entertainment,0,0
10170,1657,8513,16.29301868,83.70698132,Housing,3,3
50377,24294,26083,48.22438811,51.77561189,Food,1,4
91852,6558,85294,7.139746549,92.86025345,Transportation,4,4
195310,45291,150019,23.18928882,76.81071118,Entertainment,0,0
249470,4595,244875,1.841904838,98.15809516,Entertainment,0,0
223961,22661,201300,10.11827952,89.88172048,Entertainment,0,0
73804,25327,48477,34.31656821,65.68343179,Transportation,4,4
14035,3981,10054,28.36480228,71.63519772,Housing,3,3
231684,40214,191470,17.35726248,82.64273752,Entertainment,0,0
65598,37095,28503,56.54898015,43.45101985,Transportation,4,4
247815,50885,196930,20.53346246,79.46653754,Entertainment,0,0
10624,321,10303,3.021460843,96.97853916,Housing,3,3
95208,54472,40736,57.21367952,42.78632048,Transportation,4,4
178603,27876,150727,15.60780054,84.39219946,Healthcare,2,0
179969,17166,162803,9.538309376,90.46169062,Healthcare,2,0
140224,52954,87270,37.76386353,62.23613647,Healthcare,2,2
178274,55930,122344,31.37305496,68.62694504,Healthcare,2,0
97142,15038,82104,15.48043071,84.51956929,Transportation,4,4
170410,55275,115135,32.43647673,67.56352327,Healthcare,2,0
238832,14433,224399,6.043160046,93.95683995,Entertainment,0,0
18851,3065,15786,16.2590844,83.7409156,Housing,3,3
102040,34574,67466,33.88279106,66.11720894,Transportation,4,2
100531,58931,41600,58.61972924,41.38027076,Transportation,4,4
72313,29139,43174,40.29565915,59.70434085,Transportation,4,4
15664,942,14722,6.013789581,93.98621042,Housing,3,3
38065,20087,17978,52.77026139,47.22973861,Food,1,1
64493,35769,28724,55.46183307,44.53816693,Transportation,4,4
40867,20302,20565,49.67822448,50.32177552,Food,1,1
46182,1634,44548,3.538175047,96.46182495,Food,1,4
52395,17467,34928,33.33715049,66.66284951,Food,1,4
85110,17473,67637,20.52990248,79.47009752,Transportation,4,4
122559,55221,67338,45.05666659,54.94333341,Healthcare,2,4
149941,29855,120086,19.91116506,80.08883494,Healthcare,2,2
147703,11967,135736,8.102069694,91.89793031,Healthcare,2,2
24446,2076,22370,8.492186861,91.50781314,Housing,3,3
17853,4386,13467,24.56729961,75.43270039,Housing,3,3
36656,14937,21719,40.74912702,59.25087298,Food,1,1
68950,37777,31173,54.78897752,45.21102248,Transportation,4,4
24285,9702,14583,39.95058678,60.04941322,Housing,3,3
109770,30341,79429,27.64052109,72.35947891,Transportation,4,2
231984,10705,221279,4.614542382,95.38545762,Entertainment,0,0
121347,33970,87377,27.99409957,72.00590043,Healthcare,2,2
129265,41660,87605,32.22836808,67.77163192,Healthcare,2,2
245744,64682,181062,26.32088678,73.67911322,Entertainment,0,0
83756,48257,35499,57.61617078,42.38382922,Transportation,4,4
210645,667,209978,0.316646491,99.68335351,Entertainment,0,0
159842,20483,139359,12.81452935,87.18547065,Healthcare,2,0
52696,727,51969,1.379611356,98.62038864,Food,1,4
96025,27216,68809,28.34261911,71.65738089,Transportation,4,4
160630,23270,137360,14.48670858,85.51329142,Healthcare,2,0
52176,11050,41126,21.17831953,78.82168047,Food,1,4
94800,7989,86811,8.42721519,91.57278481,Transportation,4,4
123078,13441,109637,10.92071694,89.07928306,Healthcare,2,2
191695,49140,142555,25.63447143,74.36552857,Entertainment,0,0
22059,11439,10620,51.85638515,48.14361485,Housing,3,3
99227,16028,83199,16.15286162,83.84713838,Transportation,4,4
26100,2888,23212,11.0651341,88.9348659,Housing,3,1
40602,3823,36779,9.415792326,90.58420767,Food,1,1
86389,27898,58491,32.29346329,67.70653671,Transportation,4,4
65619,23978,41641,36.54124568,63.45875432,Transportation,4,4
154968,6834,148134,4.409942698,95.5900573,Healthcare,2,0
136502,65085,71417,47.68062006,52.31937994,Healthcare,2,2
162415,45323,117092,27.90567374,72.09432626,Healthcare,2,0
207166,56239,150927,27.14682911,72.85317089,Entertainment,0,0
28902,87,28815,0.301017231,99.69898277,Housing,3,1
15846,2848,12998,17.97299003,82.02700997,Housing,3,3
20462,9619,10843,47.00909002,52.99090998,Housing,3,3
134734,22565,112169,16.74781421,83.25218579,Healthcare,2,2
49027,2914,46113,5.943663696,94.0563363,Food,1,4
23285,667,22618,2.864505046,97.13549495,Housing,3,3
75735,30065,45670,39.69762989,60.30237011,Transportation,4,4
152990,52876,100114,34.56173606,65.43826394,Healthcare,2,0
41672,20343,21329,48.81695143,51.18304857,Food,1,1
33194,10092,23102,30.40308489,69.59691511,Food,1,1
10005,860,9145,8.595702149,91.40429785,Housing,3,3
96543,16069,80474,16.6443968,83.3556032,Transportation,4,4
12887,5124,7763,39.76099946,60.23900054,Housing,3,3
152841,46821,106020,30.63379591,69.36620409,Healthcare,2,0
104193,909,103284,0.872419452,99.12758055,Transportation,4,2
25134,4159,20975,16.54730644,83.45269356,Housing,3,1
223293,12538,210755,5.615043911,94.38495609,Entertainment,0,0
54921,18006,36915,32.78527339,67.21472661,Food,1,4
43859,127,43732,0.289564286,99.71043571,Food,1,4
207155,64199,142956,30.99080399,69.00919601,Entertainment,0,0
137572,52849,84723,38.4155206,61.5844794,Healthcare,2,2
55219,9035,46184,16.36212173,83.63787827,Food,1,4
25227,14528,10699,57.58909105,42.41090895,Housing,3,1
20080,9449,10631,47.05677291,52.94322709,Housing,3,3
221179,36554,184625,16.52688546,83.47311454,Entertainment,0,0
65081,24947,40134,38.33223214,61.66776786,Transportation,4,4
29325,7518,21807,25.63682864,74.36317136,Housing,3,1
197155,58481,138674,29.66244833,70.33755167,Entertainment,0,0
10037,2819,7218,28.0860815,71.9139185,Housing,3,3
26112,8013,18099,30.68704044,69.31295956,Housing,3,1
55133,1459,53674,2.646327971,97.35367203,Food,1,4
195797,68231,127566,34.84782709,65.15217291,Entertainment,0,0
26906,1700,25206,6.318293317,93.68170668,Housing,3,1
31244,8038,23206,25.7265395,74.2734605,Food,1,1
14328,3243,11085,22.63400335,77.36599665,Housing,3,3
33152,19099,14053,57.61040058,42.38959942,Food,1,1
227276,34504,192772,15.18154139,84.81845861,Entertainment,0,0
146742,60036,86706,40.91262215,59.08737785,Healthcare,2,2
236556,34010,202546,14.37714537,85.62285463,Entertainment,0,0
161457,46533,114924,28.82067671,71.17932329,Healthcare,2,0
74252,33350,40902,44.91461509,55.08538491,Transportation,4,4
125341,41588,83753,33.17988527,66.82011473,Healthcare,2,2
194153,23998,170155,12.36035498,87.63964502,Entertainment,0,0
169976,10152,159824,5.972607898,94.0273921,Healthcare,2,0
96392,27091,69301,28.10502946,71.89497054,Transportation,4,4
194730,60481,134249,31.05890207,68.94109793,Entertainment,0,0
156069,14052,142017,9.003709898,90.9962901,Healthcare,2,0
80517,45872,34645,56.97181962,43.02818038,Transportation,4,4
10126,2566,7560,25.34070709,74.65929291,Housing,3,3
57136,34137,22999,59.74691963,40.25308037,Food,1,1
117534,22476,95058,19.12297718,80.87702282,Transportation,4,2
202871,31236,171635,15.3969764,84.6030236,Entertainment,0,0
45990,17468,28522,37.98217004,62.01782996,Food,1,1
13799,4203,9596,30.45872889,69.54127111,Housing,3,3
178764,13545,165219,7.577028932,92.42297107,Healthcare,2,0
23910,5264,18646,22.01589293,77.98410707,Housing,3,3
31630,3452,28178,10.91368954,89.08631046,Food,1,1
218159,3772,214387,1.729014159,98.27098584,Entertainment,0,0
242653,64930,177723,26.75837513,73.24162487,Entertainment,0,0
180169,58265,121904,32.33908164,67.66091836,Entertainment,0,0
82161,26794,55367,32.6115797,67.3884203,Transportation,4,4
72372,31102,41270,42.97518377,57.02481623,Transportation,4,4
11768,38,11730,0.322909585,99.67709041,Housing,3,3
162771,58002,104769,35.63411173,64.36588827,Healthcare,2,0
239395,21605,217790,9.024833434,90.97516657,Entertainment,0,0
56216,13470,42746,23.96114985,76.03885015,Food,1,4
94525,3965,90560,4.194657498,95.8053425,Transportation,4,4
241031,30117,210914,12.49507325,87.50492675,Entertainment,0,0
87199,38846,48353,44.54867602,55.45132398,Transportation,4,4
169823,40981,128842,24.13159584,75.86840416,Healthcare,2,0
63739,32961,30778,51.71245234,48.28754766,Transportation,4,4
186773,54858,131915,29.37148303,70.62851697,Entertainment,0,0
25710,12637,13073,49.1520809,50.8479191,Housing,3,1
43511,21804,21707,50.11146607,49.88853393,Food,1,1
117489,49587,67902,42.2056533,57.7943467,Transportation,4,4
81277,24447,56830,30.07862003,69.92137997,Transportation,4,4
57829,20155,37674,34.85275554,65.14724446,Food,1,4
56759,1919,54840,3.38096161,96.61903839,Food,1,4
21515,5660,15855,26.30722752,73.69277248,Housing,3,3
186443,56386,130057,30.24302334,69.75697666,Entertainment,0,0
42256,21672,20584,51.28739114,48.71260886,Food,1,1
230522,66624,163898,28.90136299,71.09863701,Entertainment,0,0
109976,846,109130,0.769258747,99.23074125,Transportation,4,2
215745,19660,196085,9.112609794,90.88739021,Entertainment,0,0
61647,32576,29071,52.84279851,47.15720149,Transportation,4,4
17104,6617,10487,38.68685688,61.31314312,Housing,3,3
171902,26161,145741,15.21855476,84.78144524,Healthcare,2,0
120947,34782,86165,28.75805105,71.24194895,Healthcare,2,2
78166,34584,43582,44.24430059,55.75569941,Transportation,4,4
29768,9244,20524,31.05348025,68.94651975,Housing,3,1
48676,15022,33654,30.8612047,69.1387953,Food,1,1
55181,1728,53453,3.131512658,96.86848734,Food,1,4
150304,16014,134290,10.65440707,89.34559293,Healthcare,2,0
139149,62107,77042,44.63345047,55.36654953,Healthcare,2,2
30509,5407,25102,17.72263922,82.27736078,Food,1,1
87810,42188,45622,48.04464184,51.95535816,Transportation,4,4
91260,25764,65496,28.23142669,71.76857331,Transportation,4,4
56193,32740,23453,58.26348478,41.73651522,Food,1,4
231206,49546,181660,21.42937467,78.57062533,Entertainment,0,0
223013,48422,174591,21.71263559,78.28736441,Entertainment,0,0
204243,23354,180889,11.43441881,88.56558119,Entertainment,0,0
19848,10232,9616,51.55179363,48.44820637,Housing,3,3
107722,19103,88619,17.73361059,82.26638941,Transportation,4,2
63073,16327,46746,25.88587827,74.11412173,Transportation,4,4
146119,66676,79443,45.63130052,54.36869948,Healthcare,2,2
219006,58458,160548,26.69241939,73.30758061,Entertainment,0,0
236495,60220,176275,25.46354046,74.53645954,Entertainment,0,0
23166,5324,17842,22.98195632,77.01804368,Housing,3,3
74587,18121,56466,24.29511845,75.70488155,Transportation,4,4
43808,14713,29095,33.58518992,66.41481008,Food,1,1
124502,16622,107880,13.35078955,86.64921045,Healthcare,2,2
73484,38735,34749,52.71215503,47.28784497,Transportation,4,4
29797,8736,21061,29.31838776,70.68161224,Housing,3,1
55322,13715,41607,24.7912223,75.2087777,Food,1,4
218352,10564,207788,4.838059647,95.16194035,Entertainment,0,0
24798,7101,17697,28.63537382,71.36462618,Housing,3,3
23337,8054,15283,34.51171959,65.48828041,Housing,3,3
59708,19861,39847,33.26354927,66.73645073,Food,1,4
181004,12474,168530,6.891560408,93.10843959,Entertainment,0,0
22084,7298,14786,33.04654954,66.95345046,Housing,3,3
240000,4856,235144,2.023333333,97.97666667,Entertainment,0,0
132218,36375,95843,27.51138272,72.48861728,Healthcare,2,2
120141,34084,86057,28.36999858,71.63000142,Healthcare,2,2
51123,4569,46554,8.93726894,91.06273106,Food,1,4
16427,8627,7800,52.5171973,47.4828027,Housing,3,3
52743,3415,49328,6.474792864,93.52520714,Food,1,4
96089,1886,94203,1.962763688,98.03723631,Transportation,4,4
196219,66534,129685,33.90803133,66.09196867,Entertainment,0,0
184944,41570,143374,22.47707414,77.52292586,Entertainment,0,0
131639,50952,80687,38.70585465,61.29414535,Healthcare,2,2
26257,2468,23789,9.399398256,90.60060174,Housing,3,1
155005,41922,113083,27.04557917,72.95442083,Healthcare,2,0
11326,3121,8205,27.55606569,72.44393431,Housing,3,3
159690,29335,130355,18.36996681,81.63003319,Healthcare,2,0
55616,30453,25163,54.75582566,45.24417434,Food,1,4
223540,8870,214670,3.967969938,96.03203006,Entertainment,0,0
33087,1639,31448,4.953607157,95.04639284,Food,1,1
109793,51499,58294,46.90554043,53.09445957,Transportation,4,4
180565,61636,118929,34.13507601,65.86492399,Entertainment,0,0
89253,11189,78064,12.53627329,87.46372671,Transportation,4,4
14591,3665,10926,25.11822356,74.88177644,Housing,3,3
30190,15914,14276,52.71281881,47.28718119,Food,1,1
92724,6512,86212,7.022992968,92.97700703,Transportation,4,4
96845,32387,64458,33.4420982,66.5579018,Transportation,4,4
61414,36215,25199,58.96863907,41.03136093,Transportation,4,4
28942,14625,14317,50.53209868,49.46790132,Housing,3,1
80052,18348,61704,22.92010193,77.07989807,Transportation,4,4
79652,4552,75100,5.714859639,94.28514036,Transportation,4,4
132319,17510,114809,13.23317135,86.76682865,Healthcare,2,2
249448,36681,212767,14.70486835,85.29513165,Entertainment,0,0
81942,47872,34070,58.42181055,41.57818945,Transportation,4,4
203856,19288,184568,9.461580724,90.53841928,Entertainment,0,0
14669,4392,10277,29.94069125,70.05930875,Housing,3,3
70748,21192,49556,29.95420365,70.04579635,Transportation,4,4
23786,13155,10631,55.30564197,44.69435803,Housing,3,3
39789,226,39563,0.56799618,99.43200382,Food,1,1
26459,10737,15722,40.57976492,59.42023508,Housing,3,1
128123,23940,104183,18.68516972,81.31483028,Healthcare,2,2
139137,24460,114677,17.57979545,82.42020455,Healthcare,2,2
55538,10245,45293,18.4468292,81.5531708,Food,1,4
29896,1359,28537,4.54575863,95.45424137,Housing,3,1
169493,56028,113465,33.05623241,66.94376759,Healthcare,2,0
23235,2142,21093,9.218850872,90.78114913,Housing,3,3
114159,1167,112992,1.022258429,98.97774157,Transportation,4,2
46184,8066,38118,17.46492292,82.53507708,Food,1,1
39165,11242,27923,28.70420018,71.29579982,Food,1,1
26959,16166,10793,59.96513224,40.03486776,Housing,3,1
142228,27500,114728,19.33515201,80.66484799,Healthcare,2,2
24805,14254,10551,57.46422092,42.53577908,Housing,3,3
24384,12622,11762,51.76345144,48.23654856,Housing,3,3
36597,21252,15345,58.07033363,41.92966637,Food,1,1
108450,52445,56005,48.35869064,51.64130936,Transportation,4,4
97589,53879,43710,55.21011589,44.78988411,Transportation,4,4
69107,37121,31986,53.71525316,46.28474684,Transportation,4,4
206359,13764,192595,6.669929589,93.33007041,Entertainment,0,0
125281,58281,67000,46.52022254,53.47977746,Healthcare,2,4
244093,24121,219972,9.88188928,90.11811072,Entertainment,0,0
99621,5712,93909,5.73373084,94.26626916,Transportation,4,4
162710,18369,144341,11.28941061,88.71058939,Healthcare,2,0
14016,1165,12851,8.311929224,91.68807078,Housing,3,3
169917,60717,109200,35.73332863,64.26667137,Healthcare,2,0
68360,17179,51181,25.1301931,74.8698069,Transportation,4,4
215151,17352,197799,8.065033395,91.9349666,Entertainment,0,0
22375,2047,20328,9.148603352,90.85139665,Housing,3,3
72010,39942,32068,55.46729621,44.53270379,Transportation,4,4
233439,14051,219388,6.019131336,93.98086866,Entertainment,0,0
51903,20001,31902,38.53534478,61.46465522,Food,1,4
58688,22864,35824,38.95856052,61.04143948,Food,1,4
211162,57850,153312,27.39602769,72.60397231,Entertainment,0,0
91949,24505,67444,26.65064329,73.34935671,Transportation,4,4
35487,20559,14928,57.93389128,42.06610872,Food,1,1
156866,4869,151997,3.103923094,96.89607691,Healthcare,2,0
29432,14688,14744,49.90486545,50.09513455,Housing,3,1
100263,17202,83061,17.15687741,82.84312259,Transportation,4,2
31804,15218,16586,47.84932713,52.15067287,Food,1,1
22768,10225,12543,44.90952214,55.09047786,Housing,3,3
140572,42113,98459,29.95831318,70.04168682,Healthcare,2,2
153530,65740,87790,42.81899303,57.18100697,Healthcare,2,0
151276,32328,118948,21.37021074,78.62978926,Healthcare,2,0
29262,13329,15933,45.55054337,54.44945663,Housing,3,1
134933,17335,117598,12.84711672,87.15288328,Healthcare,2,2
90838,5400,85438,5.944648715,94.05535128,Transportation,4,4
188802,22318,166484,11.82084936,88.17915064,Entertainment,0,0
162362,69321,93041,42.69533512,57.30466488,Healthcare,2,0
34562,1470,33092,4.253226086,95.74677391,Food,1,1
20485,2344,18141,11.44251892,88.55748108,Housing,3,3
139188,56275,82913,40.43092795,59.56907205,Healthcare,2,2
14821,4200,10621,28.33816881,71.66183119,Housing,3,3
122086,52648,69438,43.12369969,56.87630031,Healthcare,2,4
159414,4711,154703,2.955198414,97.04480159,Healthcare,2,0
81711,13210,68501,16.16673398,83.83326602,Transportation,4,4
80195,24360,55835,30.3759586,69.6240414,Transportation,4,4
13892,2174,11718,15.64929456,84.35070544,Housing,3,3
85068,32726,52342,38.47040015,61.52959985,Transportation,4,4
129889,5324,124565,4.098884432,95.90111557,Healthcare,2,2
201457,68318,133139,33.91195143,66.08804857,Entertainment,0,0
179738,52134,127604,29.00555253,70.99444747,Healthcare,2,0
16034,1307,14727,8.151428215,91.84857178,Housing,3,3
140459,46752,93707,33.28515795,66.71484205,Healthcare,2,2
15074,2444,12630,16.21334749,83.78665251,Housing,3,3
58327,16107,42220,27.6149982,72.3850018,Food,1,4
188003,34926,153077,18.57736313,81.42263687,Entertainment,0,0
70765,15114,55651,21.35801597,78.64198403,Transportation,4,4
204553,2240,202313,1.095070715,98.90492928,Entertainment,0,0
212429,17855,194574,8.405161254,91.59483875,Entertainment,0,0
33948,17642,16306,51.96771533,48.03228467,Food,1,1
248337,65829,182508,26.50793076,73.49206924,Entertainment,0,0
40806,3503,37303,8.584521884,91.41547812,Food,1,1
127354,21599,105755,16.95981281,83.04018719,Healthcare,2,2
47140,12918,34222,27.403479,72.596521,Food,1,1
196342,46816,149526,23.84410875,76.15589125,Entertainment,0,0
152169,69351,82818,45.57498571,54.42501429,Healthcare,2,0
38588,7743,30845,20.06582357,79.93417643,Food,1,1
170308,36473,133835,21.4159053,78.5840947,Healthcare,2,0
41793,16445,25348,39.34869476,60.65130524,Food,1,1
91921,44015,47906,47.88350867,52.11649133,Transportation,4,4
13997,5418,8579,38.70829463,61.29170537,Housing,3,3
173547,51863,121684,29.88412361,70.11587639,Healthcare,2,0
104516,18245,86271,17.45665735,82.54334265,Transportation,4,2
102308,32750,69558,32.01118192,67.98881808,Transportation,4,2
189475,52709,136766,27.81844571,72.18155429,Entertainment,0,0
30444,11073,19371,36.37169886,63.62830114,Food,1,1
33692,13894,19798,41.23827615,58.76172385,Food,1,1
62445,4256,58189,6.815597726,93.18440227,Transportation,4,4
33347,8178,25169,24.52394518,75.47605482,Food,1,1
248941,69645,179296,27.97650849,72.02349151,Entertainment,0,0
25566,4486,21080,17.54674177,82.45325823,Housing,3,1
30483,13780,16703,45.20552439,54.79447561,Food,1,1
74015,43907,30108,59.3217591,40.6782409,Transportation,4,4
158099,75,158024,0.04743863,99.95256137,Healthcare,2,0
206581,2208,204373,1.068830144,98.93116986,Entertainment,0,0
223290,49515,173775,22.17519817,77.82480183,Entertainment,0,0
158220,15828,142392,10.00379219,89.99620781,Healthcare,2,0
113631,21776,91855,19.16378453,80.83621547,Transportation,4,2
78502,335,78167,0.42674072,99.57325928,Transportation,4,4
223579,39592,183987,17.70828208,82.29171792,Entertainment,0,0
26431,9032,17399,34.17199501,65.82800499,Housing,3,1
224779,27153,197626,12.07986511,87.92013489,Entertainment,0,0
177795,38921,138874,21.89094182,78.10905818,Healthcare,2,0
149966,45165,104801,30.11682648,69.88317352,Healthcare,2,2
120951,32954,87997,27.24574414,72.75425586,Healthcare,2,2
128744,35437,93307,27.52516622,72.47483378,Healthcare,2,2
144312,53410,90902,37.01008925,62.98991075,Healthcare,2,2
27871,4954,22917,17.77474795,82.22525205,Housing,3,1
226327,48363,177964,21.36863918,78.63136082,Entertainment,0,0
159105,30492,128613,19.16470255,80.83529745,Healthcare,2,0
21280,9575,11705,44.99530075,55.00469925,Housing,3,3
69029,33757,35272,48.90263512,51.09736488,Transportation,4,4
23139,9986,13153,43.15657548,56.84342452,Housing,3,3
78469,16387,62082,20.88340619,79.11659381,Transportation,4,4
135057,22398,112659,16.58410893,83.41589107,Healthcare,2,2
212263,58920,153343,27.75801718,72.24198282,Entertainment,0,0
152380,763,151617,0.50072188,99.49927812,Healthcare,2,0
35685,7653,28032,21.44598571,78.55401429,Food,1,1
12603,6882,5721,54.60604618,45.39395382,Housing,3,3
59986,14804,45182,24.67909179,75.32090821,Food,1,4
130400,36838,93562,28.25,71.75,Healthcare,2,2
55018,19059,35959,34.64139009,65.35860991,Food,1,4
15084,2362,12722,15.6589764,84.3410236,Housing,3,3
31462,7520,23942,23.90184985,76.09815015,Food,1,1
232751,33091,199660,14.21733956,85.78266044,Entertainment,0,0
11339,5562,5777,49.05194462,50.94805538,Housing,3,3
224694,8567,216127,3.812740883,96.18725912,Entertainment,0,0
160827,54210,106617,33.70702681,66.29297319,Healthcare,2,0
89168,12926,76242,14.49623183,85.50376817,Transportation,4,4
165917,60143,105774,36.24884732,63.75115268,Healthcare,2,0
243256,55637,187619,22.87178939,77.12821061,Entertainment,0,0
156535,7023,149512,4.486536557,95.51346344,Healthcare,2,0
48416,3378,45038,6.977032386,93.02296761,Food,1,4
125062,33132,91930,26.49245974,73.50754026,Healthcare,2,2
229425,62307,167118,27.15789474,72.84210526,Entertainment,0,0
236550,43173,193377,18.2511097,81.7488903,Entertainment,0,0
115987,3478,112509,2.998611913,97.00138809,Transportation,4,2
194797,10858,183939,5.574007813,94.42599219,Entertainment,0,0
37384,11554,25830,30.90627006,69.09372994,Food,1,1
41306,22719,18587,55.00169467,44.99830533,Food,1,1
24948,8624,16324,34.56790123,65.43209877,Housing,3,3
14507,117,14390,0.806507203,99.1934928,Housing,3,3
137121,40687,96434,29.67233319,70.32766681,Healthcare,2,2
10909,6129,4780,56.18296819,43.81703181,Housing,3,3
72540,1714,70826,2.362834298,97.6371657,Transportation,4,4
53329,30206,23123,56.64085207,43.35914793,Food,1,4
55089,5825,49264,10.57379876,89.42620124,Food,1,4
20114,7391,12723,36.74555036,63.25444964,Housing,3,3
242764,33020,209744,13.60168724,86.39831276,Entertainment,0,0
58062,27983,30079,48.1950329,51.8049671,Food,1,4
47519,21472,26047,45.18613607,54.81386393,Food,1,1
169394,3121,166273,1.842450146,98.15754985,Healthcare,2,0
54184,19783,34401,36.51077809,63.48922191,Food,1,4
243960,32357,211603,13.26323988,86.73676012,Entertainment,0,0
188847,30554,158293,16.17923504,83.82076496,Entertainment,0,0
172168,61379,110789,35.65064356,64.34935644,Healthcare,2,0
51474,15227,36247,29.58192486,70.41807514,Food,1,4
109509,52219,57290,47.68466519,52.31533481,Transportation,4,4
20488,562,19926,2.743069114,97.25693089,Housing,3,3
129290,69601,59689,53.8332431,46.1667569,Healthcare,2,4
73315,31634,41681,43.14805974,56.85194026,Transportation,4,4
90657,44014,46643,48.55002923,51.44997077,Transportation,4,4
57338,29100,28238,50.751683,49.248317,Food,1,4
127122,40412,86710,31.78993408,68.21006592,Healthcare,2,2
28565,16309,12256,57.09434623,42.90565377,Housing,3,1
20043,4199,15844,20.94995759,79.05004241,Housing,3,3
248030,57646,190384,23.24154336,76.75845664,Entertainment,0,0
119422,28419,91003,23.79712281,76.20287719,Transportation,4,2
81113,10223,70890,12.60340513,87.39659487,Transportation,4,4
29743,3315,26428,11.14547961,88.85452039,Housing,3,1
150784,7161,143623,4.749177632,95.25082237,Healthcare,2,0
111423,22805,88618,20.46704899,79.53295101,Transportation,4,2
101916,24462,77454,24.00211939,75.99788061,Transportation,4,2
87259,11382,75877,13.0439267,86.9560733,Transportation,4,4
25965,13829,12136,53.2601579,46.7398421,Housing,3,1
126853,49790,77063,39.25015569,60.74984431,Healthcare,2,2
