Income,Savings,Expenses,Saving Percentage,Expense Percentage,Expense Category
109946,306,109640,0.27831844723773486,99.72168155276226,Healthcare
89852,38262,51590,42.58335930196323,57.41664069803677,Transportation
14261,887,13374,6.219760185120258,93.78023981487974,Housing
70141,9371,60770,13.360231533625127,86.63976846637487,Transportation
86390,4491,81899,5.198518347030907,94.80148165296909,Transportation
144309,21326,122983,14.778011073460423,85.22198892653958,Healthcare
20254,19092,1162,94.26286165695666,5.737138343043349,Housing
58008,49379,8629,85.12446559095297,14.875534409047027,Transportation
103926,8463,95463,8.14329426707465,91.85670573292535,Healthcare
18789,1120,17669,5.960934589387407,94.0390654106126,Housing
38901,11440,27461,29.407984370581737,70.59201562941827,Food
144041,37322,106719,25.910678209676412,74.0893217903236,Healthcare
71393,13262,58131,18.57605087333492,81.42394912666508,Transportation
61160,2274,58886,3.718116415958143,96.28188358404186,Transportation
48644,31933,16711,65.64632842693857,34.353671573061426,Food
104667,8906,95761,8.508890099076117,91.49110990092389,Healthcare
16592,12182,4410,73.42092574734812,26.57907425265188,Housing
152774,4462,148312,2.9206540379907575,97.07934596200924,Entertainment
145425,9466,135959,6.509197180677324,93.49080281932267,Healthcare
167212,14571,152641,8.71408750568141,91.2859124943186,Entertainment
175382,46760,128622,26.661801097033905,73.3381989029661,Entertainment
42281,21031,21250,49.74101842435136,50.25898157564863,Food
71824,28797,43027,40.09384049899755,59.906159501002456,Transportation
188363,36671,151692,19.46826075184617,80.53173924815383,Entertainment
75429,7400,68029,9.810550318842886,90.18944968115711,Transportation
163236,22027,141209,13.493959665760006,86.50604033424,Entertainment
10850,10698,152,98.59907834101382,1.400921658986175,Housing
163637,9039,154598,5.523811851842798,94.4761881481572,Entertainment
108254,25208,83046,23.28597557596024,76.71402442403976,Healthcare
174372,33053,141319,18.955451563324388,81.04454843667561,Entertainment
14881,6949,7932,46.69713056918218,53.30286943081782,Housing
30832,19383,11449,62.86650233523612,37.13349766476388,Food
74257,44433,29824,59.8367830642229,40.16321693577709,Transportation
57397,7338,50059,12.78464031221144,87.21535968778856,Transportation
185337,160,185177,0.08632922729945991,99.91367077270054,Entertainment
37357,35897,1460,96.09176325722086,3.908236742779131,Food
75252,36955,38297,49.108329346728326,50.89167065327167,Transportation
21807,9580,12227,43.93084789287843,56.06915210712157,Housing
39707,38231,1476,96.28277129977081,3.717228700229179,Food
149659,4889,144770,3.266759767204111,96.7332402327959,Healthcare
79694,40004,39690,50.1970035385349,49.802996461465106,Transportation
20185,6331,13854,31.36487490710924,68.63512509289076,Housing
182152,518,181634,0.2843778822082656,99.71562211779174,Entertainment
19684,10640,9044,54.054054054054056,45.94594594594595,Housing
168547,33276,135271,19.742861041727235,80.25713895827276,Entertainment
16006,2568,13438,16.04398350618518,83.95601649381483,Housing
70373,32140,38233,45.67092492859477,54.32907507140523,Transportation
28833,12467,16366,43.23865015780529,56.76134984219471,Food
15619,9280,6339,59.414815289071,40.58518471092899,Housing
30317,16244,14073,53.58049938978131,46.41950061021869,Food
45082,16874,28208,37.42957277849253,62.57042722150747,Food
196628,8303,188325,4.222694631486869,95.77730536851313,Entertainment
61137,19203,41934,31.409784582167916,68.59021541783208,Transportation
169424,39326,130098,23.211587496458588,76.78841250354141,Entertainment
29152,8911,20241,30.567371020856204,69.4326289791438,Food
140642,3841,136801,2.7310476244649537,97.26895237553505,Healthcare
40631,20056,20575,49.361325096601114,50.638674903398886,Food
158445,9611,148834,6.065827258670201,93.9341727413298,Entertainment
42628,5696,36932,13.36210941165431,86.63789058834568,Food
48730,45512,3218,93.39626513441411,6.6037348655858805,Food
18183,17961,222,98.77907935984162,1.2209206401583896,Housing
131512,22426,109086,17.05243627957905,82.94756372042094,Healthcare
108712,7904,100808,7.27058650378983,92.72941349621017,Healthcare
14295,6197,8098,43.35082196572228,56.64917803427771,Housing
10866,182,10684,1.6749493833977545,98.32505061660225,Housing
174023,18922,155101,10.873275371646276,89.12672462835373,Entertainment
36665,8219,28446,22.416473476067093,77.58352652393292,Food
180886,5811,175075,3.2125205930807246,96.78747940691927,Entertainment
125475,40935,84540,32.6240286909743,67.3759713090257,Healthcare
33803,8307,25496,24.57474188681478,75.42525811318522,Food
54009,44464,9545,82.32701957081228,17.672980429187728,Transportation
24653,10831,13822,43.93380116010222,56.06619883989779,Housing
43367,23380,19987,53.91196070745037,46.08803929254963,Food
48309,41984,6325,86.90720155664576,13.092798443354239,Food
35365,3153,32212,8.915594514350346,91.08440548564965,Food
166762,13336,153426,7.997025701298857,92.00297429870115,Entertainment
15137,963,14174,6.361894695117923,93.63810530488207,Housing
137696,28853,108843,20.95413083894957,79.04586916105043,Healthcare
195705,42369,153336,21.649421322909483,78.35057867709052,Entertainment
28328,22014,6314,77.71109855972888,22.28890144027111,Food
150206,27409,122797,18.247606620241534,81.75239337975847,Entertainment
11267,4406,6861,39.105351912665306,60.89464808733469,Housing
75129,31645,43484,42.1208854104274,57.8791145895726,Transportation
39592,31711,7881,80.09446352798545,19.90553647201455,Food
98206,31969,66237,32.553000834979535,67.44699916502047,Transportation
25364,10358,15006,40.83740734899858,59.162592651001425,Food
49091,40387,8704,82.26966246358803,17.73033753641197,Food
28919,17451,11468,60.34441024931706,39.65558975068294,Food
181377,10977,170400,6.052035263567046,93.94796473643295,Entertainment
105105,27299,77806,25.973074544503117,74.02692545549688,Healthcare
129290,3260,126030,2.521463376904633,97.47853662309537,Healthcare
145057,22743,122314,15.678664249226165,84.32133575077383,Healthcare
162459,32795,129664,20.186631703999165,79.81336829600085,Entertainment
8301,7527,774,90.67582219009758,9.324177809902421,Housing
30205,28885,1320,95.62986260552888,4.370137394471114,Food
48250,38411,9839,79.60829015544041,20.391709844559585,Food
166776,968,165808,0.5804192449752962,99.41958075502471,Entertainment
143611,4544,139067,3.1641030283195577,96.83589697168044,Healthcare
138670,36126,102544,26.051777601499964,73.94822239850004,Healthcare
127273,41150,86123,32.33207357412805,67.66792642587195,Healthcare
10920,9274,1646,84.92673992673993,15.073260073260073,Housing
68158,19945,48213,29.262889169283135,70.73711083071686,Transportation
81616,48926,32690,59.94657910213683,40.05342089786316,Transportation
154858,16312,138546,10.533521032171409,89.46647896782859,Entertainment
145908,23401,122507,16.038188447514873,83.96181155248513,Healthcare
37392,34642,2750,92.64548566538296,7.354514334617031,Food
13618,4236,9382,31.105889264209136,68.89411073579087,Housing
137691,37814,99877,27.462942385486343,72.53705761451366,Healthcare
172581,38973,133608,22.58243955012429,77.41756044987571,Entertainment
26049,25933,116,99.5546854005912,0.44531459940880647,Food
79085,42235,36850,53.40456470885756,46.59543529114244,Transportation
103737,16473,87264,15.87958009196333,84.12041990803667,Healthcare
61908,5609,56299,9.060218388576597,90.9397816114234,Transportation
10757,3920,6837,36.44138700381147,63.55861299618852,Housing
199571,28357,171214,14.20897825836419,85.7910217416358,Entertainment
64773,46389,18384,71.61780371451067,28.382196285489325,Transportation
103645,20445,83200,19.72598774663515,80.27401225336484,Healthcare
24002,14025,9977,58.43263061411549,41.56736938588451,Housing
43005,6548,36457,15.226136495756307,84.77386350424369,Food
66449,9491,56958,14.283134433926769,85.71686556607322,Transportation
142214,42042,100172,29.56249033147229,70.43750966852771,Healthcare
52273,17350,34923,33.191131176706904,66.8088688232931,Transportation
147235,20860,126375,14.1678269433219,85.8321730566781,Healthcare
56164,16065,40099,28.603731927925363,71.39626807207465,Transportation
29026,10458,18568,36.029766416316406,63.97023358368359,Food
56476,31555,24921,55.873291309582825,44.12670869041717,Transportation
47907,34618,13289,72.26083870833072,27.739161291669273,Food
67208,36199,31009,53.86114748244256,46.13885251755743,Transportation
198426,8598,189828,4.3331015088748455,95.66689849112515,Entertainment
20763,9177,11586,44.19881520011559,55.80118479988441,Housing
100731,1832,98899,1.8187052645163853,98.18129473548362,Healthcare
46696,44387,2309,95.05525098509509,4.944749014904917,Food
20600,10998,9602,53.3883495145631,46.6116504854369,Housing
57211,45702,11509,79.88323923720962,20.116760762790374,Transportation
196490,32568,163922,16.574889307343884,83.42511069265612,Entertainment
152873,9368,143505,6.127962426327736,93.87203757367226,Entertainment
16120,6616,9504,41.04218362282878,58.95781637717121,Housing
113055,28231,84824,24.97103179868206,75.02896820131795,Healthcare
16389,15927,462,97.18103606077247,2.8189639392275305,Housing
195332,34626,160706,17.72674216206254,82.27325783793746,Entertainment
12555,9146,3409,72.84747112704102,27.15252887295898,Housing
122362,35847,86515,29.2958598257629,70.7041401742371,Healthcare
121039,28006,93033,23.137996843992433,76.86200315600756,Healthcare
9016,7869,1147,87.27817213842059,12.721827861579415,Housing
129033,28305,100728,21.936248866569017,78.06375113343098,Healthcare
141433,14892,126541,10.529367262237244,89.47063273776276,Healthcare
88525,4414,84111,4.9861621011013835,95.01383789889861,Transportation
16553,3727,12826,22.5155560925512,77.48444390744879,Housing
8386,6031,2355,71.91748151681374,28.082518483186263,Housing
61673,31042,30631,50.333209021776135,49.66679097822386,Transportation
132162,44387,87775,33.58529683267505,66.41470316732494,Healthcare
116207,34831,81376,29.973237412548297,70.02676258745171,Healthcare
35309,17492,17817,49.539777393865585,50.46022260613441,Food
157712,21364,136348,13.546210814649488,86.45378918535052,Entertainment
81359,40392,40967,49.646627908405954,50.35337209159405,Transportation
110248,3515,106733,3.1882664538132213,96.81173354618677,Healthcare
72924,1909,71015,2.617793867588174,97.38220613241182,Transportation
12297,10173,2124,82.7274945108563,17.272505489143693,Housing
90582,46628,43954,51.47601068644985,48.52398931355015,Transportation
58838,15407,43431,26.1854583772392,73.8145416227608,Transportation
20990,6873,14117,32.744163887565506,67.2558361124345,Housing
98368,13201,85167,13.420014638906963,86.57998536109304,Transportation
132287,40178,92109,30.37184303824261,69.6281569617574,Healthcare
14368,11040,3328,76.83741648106904,23.16258351893096,Housing
41914,28018,13896,66.84639977095958,33.153600229040414,Food
9154,4499,4655,49.1479134804457,50.8520865195543,Housing
177265,25575,151690,14.427551970214086,85.57244802978592,Entertainment
187833,29476,158357,15.69266316355486,84.30733683644513,Entertainment
184143,44163,139980,23.98299147944804,76.01700852055197,Entertainment
39392,20922,18470,53.11230706742486,46.88769293257514,Food
23422,9700,13722,41.41405516181368,58.58594483818632,Housing
176330,6349,169981,3.6006351726875745,96.39936482731243,Entertainment
110684,32556,78128,29.413465360847095,70.58653463915292,Healthcare
130650,30496,100154,23.341752774588596,76.6582472254114,Healthcare
13870,1531,12339,11.038211968276856,88.96178803172315,Housing
11636,10916,720,93.81230663458233,6.18769336541767,Housing
49847,45825,4022,91.93130980801251,8.068690191987482,Food
191164,31676,159488,16.570065493502963,83.42993450649703,Entertainment
63542,19551,43991,30.76862547606308,69.23137452393692,Transportation
83277,6107,77170,7.333357349568308,92.6666426504317,Transportation
177800,46339,131461,26.062429696287964,73.93757030371204,Entertainment
47079,3010,44069,6.393508783109242,93.60649121689076,Food
63081,30953,32128,49.068657757486406,50.93134224251359,Transportation
49291,46073,3218,93.4714248037167,6.528575196283297,Food
66060,20733,45327,31.385104450499547,68.61489554950046,Transportation
141522,18383,123139,12.989499865745255,87.01050013425474,Healthcare
12805,806,11999,6.2944162436548226,93.70558375634518,Housing
100566,21762,78804,21.639520315017005,78.36047968498299,Healthcare
47779,43298,4481,90.62140270830281,9.37859729169719,Food
16782,13997,2785,83.40483851745918,16.595161482540817,Housing
199623,22981,176642,11.512200497938615,88.48779950206138,Entertainment
47707,42771,4936,89.65350996709078,10.346490032909216,Food
81321,665,80656,0.8177469534314631,99.18225304656853,Transportation
48825,41401,7424,84.79467485919099,15.205325140809013,Food
159365,26296,133069,16.50048630502306,83.49951369497694,Entertainment
76729,2024,74705,2.637855308944467,97.36214469105553,Transportation
23282,19330,3952,83.02551327205566,16.974486727944335,Housing
29733,26930,2803,90.57276426865772,9.42723573134228,Food
23751,2964,20787,12.479474548440066,87.52052545155993,Housing
26222,2860,23362,10.906872092136375,89.09312790786362,Food
71605,24134,47471,33.70435025487047,66.29564974512952,Transportation
162675,23195,139480,14.25849085600123,85.74150914399877,Entertainment
17435,3709,13726,21.273300831660453,78.72669916833954,Housing
40384,3170,37214,7.849643423137877,92.15035657686212,Food
166082,12938,153144,7.790127768210883,92.20987223178912,Entertainment
20997,19956,1041,95.0421488784112,4.957851121588798,Housing
138806,33295,105511,23.986715271674136,76.01328472832587,Healthcare
20175,8356,11819,41.41759603469641,58.5824039653036,Housing
176284,1769,174515,1.0034943613714233,98.99650563862858,Entertainment
11419,7239,4180,63.394342762063225,36.605657237936775,Housing
49905,43790,6115,87.74671876565475,12.253281234345256,Food
114634,19163,95471,16.716680914911805,83.2833190850882,Healthcare
124915,40133,84782,32.128247208101506,67.87175279189849,Healthcare
158624,40550,118074,25.563596933629213,74.43640306637079,Entertainment
87906,21573,66333,24.540986963347212,75.45901303665279,Transportation
187391,4132,183259,2.2050151821592285,97.79498481784077,Entertainment
128526,20491,108035,15.943077665219487,84.05692233478051,Healthcare
120638,41424,79214,34.33743928115519,65.66256071884482,Healthcare
123212,11202,112010,9.091646917508035,90.90835308249197,Healthcare
44919,19680,25239,43.812195284846055,56.187804715153945,Food
120725,30416,90309,25.194450196728102,74.8055498032719,Healthcare
114456,4722,109734,4.125602851750891,95.87439714824912,Healthcare
190442,19644,170798,10.314951533800318,89.68504846619967,Entertainment
8392,1787,6605,21.294089609151573,78.70591039084843,Housing
167652,42510,125142,25.35609476773316,74.64390523226683,Entertainment
99509,41831,57678,42.03740365193098,57.96259634806902,Transportation
174846,24491,150355,14.007183464305731,85.99281653569427,Entertainment
105970,8981,96989,8.47504010569029,91.52495989430972,Healthcare
32420,2042,30378,6.298581122763726,93.70141887723628,Food
71738,23241,48497,32.39705595360897,67.60294404639103,Transportation
15629,8325,7304,53.26636381086441,46.73363618913558,Housing
16567,3530,13037,21.307418361803585,78.69258163819642,Housing
93485,45210,48275,48.360699577472325,51.639300422527675,Transportation
124313,9476,114837,7.622694328026835,92.37730567197316,Healthcare
66941,24003,42938,35.85694865627941,64.14305134372059,Transportation
58954,38562,20392,65.41031991043866,34.589680089561355,Transportation
17518,13258,4260,75.68215549720287,24.317844502797122,Housing
40675,28091,12584,69.06207744314689,30.937922556853103,Food
117242,46211,71031,39.415056037938626,60.584943962061374,Healthcare
185615,35732,149883,19.25059935888802,80.74940064111198,Entertainment
108632,21852,86780,20.11561970690036,79.88438029309964,Healthcare
35235,31213,4022,88.58521356605648,11.414786433943522,Food
12931,3510,9421,27.144072384193024,72.85592761580698,Housing
51507,15222,36285,29.553264604810998,70.44673539518901,Transportation
19411,5906,13505,30.426047086703417,69.5739529132966,Housing
13793,4523,9270,32.791995939969546,67.20800406003045,Housing
131877,47046,84831,35.67415091335108,64.32584908664893,Healthcare
32951,17380,15571,52.74498497769415,47.25501502230585,Food
42742,40860,1882,95.59683683496327,4.403163165036732,Food
93033,12697,80336,13.647845388195586,86.35215461180441,Transportation
124237,44231,80006,35.602115311863614,64.39788468813639,Healthcare
9734,1843,7891,18.93363468255599,81.06636531744401,Housing
170157,13423,156734,7.888597001592647,92.11140299840736,Entertainment
115684,12460,103224,10.770720237889423,89.22927976211058,Healthcare
85170,26940,58230,31.630855935188446,68.36914406481155,Transportation
126045,21971,104074,17.431076202943395,82.5689237970566,Healthcare
35226,9752,25474,27.68409697382615,72.31590302617384,Food
155306,8077,147229,5.200700552457729,94.79929944754227,Entertainment
66935,5574,61361,8.32748188541122,91.67251811458877,Transportation
46121,19790,26331,42.90887014592052,57.09112985407949,Food
52587,2648,49939,5.0354650388879385,94.96453496111205,Transportation
113645,4917,108728,4.326631176030622,95.67336882396937,Healthcare
160383,5151,155232,3.2116870241858555,96.78831297581415,Entertainment
49475,4686,44789,9.47145022738757,90.52854977261244,Food
13560,689,12871,5.0811209439528024,94.9188790560472,Housing
93748,8562,85186,9.132994837223194,90.8670051627768,Transportation
181753,25357,156396,13.951351559534093,86.0486484404659,Entertainment
59181,47993,11188,81.09528395937885,18.904716040621146,Transportation
41925,24845,17080,59.26058437686345,40.73941562313655,Food
8719,6516,2203,74.73334097947011,25.266659020529875,Housing
68121,13334,54787,19.5739933353885,80.4260066646115,Transportation
188470,30403,158067,16.131479811110523,83.86852018888948,Entertainment
190205,20195,170010,10.617491653742016,89.38250834625798,Entertainment
166374,21873,144501,13.146885931696058,86.85311406830394,Entertainment
10113,9444,669,93.38475229902106,6.615247700978938,Housing
85273,24673,60600,28.934129208541975,71.06587079145802,Transportation
103993,41290,62703,39.7045955016203,60.2954044983797,Healthcare
13085,5637,7448,43.079862437905994,56.920137562094,Housing
102780,18230,84550,17.736913796458456,82.26308620354155,Healthcare
50732,799,49933,1.5749428368682488,98.42505716313174,Transportation
127604,46458,81146,36.40794959405661,63.59205040594339,Healthcare
10811,7098,3713,65.65535103135696,34.34464896864305,Housing
157390,47434,109956,30.137874070779592,69.86212592922041,Entertainment
175224,35706,139518,20.37734556910012,79.62265443089987,Entertainment
199670,17604,182066,8.816547303050031,91.18345269694996,Entertainment
139810,41476,98334,29.665975252127886,70.33402474787212,Healthcare
27736,13611,14125,49.07340640323046,50.92659359676954,Food
26261,13157,13104,50.10091009481741,49.89908990518259,Food
25067,15855,9212,63.25048869030997,36.74951130969003,Food
57973,15329,42644,26.441619374536423,73.55838062546358,Transportation
67772,4274,63498,6.3064392374431915,93.6935607625568,Transportation
124452,26265,98187,21.104522225436313,78.89547777456369,Healthcare
169605,27835,141770,16.411662392028536,83.58833760797147,Entertainment
48502,13304,35198,27.429796709414045,72.57020329058595,Food
128515,3851,124664,2.996537369178695,97.0034626308213,Healthcare
146554,6553,140001,4.471389385482484,95.52861061451752,Healthcare
100184,9475,90709,9.457598019643855,90.54240198035615,Healthcare
133638,38294,95344,28.655023271823882,71.3449767281761,Healthcare
9228,7226,2002,78.30515821413091,21.694841785869095,Housing
121985,48022,73963,39.367135303520925,60.632864696479075,Healthcare
132153,27724,104429,20.97871406627167,79.02128593372832,Healthcare
16491,138,16353,0.8368200836820083,99.16317991631799,Housing
118281,40134,78147,33.93106246988105,66.06893753011896,Healthcare
46438,45158,1280,97.24363667685947,2.7563633231405316,Food
20183,12874,7309,63.78635485309418,36.21364514690581,Housing
57284,28488,28796,49.7311640248586,50.2688359751414,Transportation
155281,37012,118269,23.835498225797103,76.1645017742029,Entertainment
109815,13890,95925,12.648545280699357,87.35145471930065,Healthcare
13588,13109,479,96.4748307329997,3.5251692670002943,Housing
68194,43967,24227,64.47341408335045,35.52658591664956,Transportation
168816,8566,160250,5.074163586389916,94.92583641361009,Entertainment
170956,44588,126368,26.081564847095155,73.91843515290483,Entertainment
165765,15873,149892,9.575604017735952,90.42439598226404,Entertainment
145581,15775,129806,10.835892046352203,89.1641079536478,Healthcare
9868,7878,1990,79.83380624239967,20.166193757600322,Housing
118096,1439,116657,1.2185002032244954,98.7814997967755,Healthcare
62613,37305,25308,59.58027885582866,40.41972114417134,Transportation
125256,40128,85128,32.03678865683081,67.96321134316919,Healthcare
139310,15624,123686,11.215275285334865,88.78472471466513,Healthcare
86725,6057,80668,6.984145286826175,93.01585471317382,Transportation
108274,17229,91045,15.912407410828083,84.0875925891719,Healthcare
72539,3400,69139,4.687133817670495,95.3128661823295,Transportation
95531,13769,81762,14.413122441929845,85.58687755807016,Transportation
185808,28213,157595,15.18395332816671,84.81604667183329,Entertainment
100723,31145,69578,30.921438003236602,69.0785619967634,Healthcare
137487,38440,99047,27.959007033392247,72.04099296660775,Healthcare
99962,15563,84399,15.568916188151496,84.43108381184851,Transportation
134053,33457,100596,24.958038984580725,75.04196101541928,Healthcare
114426,13111,101315,11.458060231066366,88.54193976893363,Healthcare
50353,21586,28767,42.86934244235696,57.13065755764304,Transportation
19757,16654,3103,84.29417421673331,15.705825783266691,Housing
65541,35676,29865,54.43310294319586,45.56689705680414,Transportation
18410,4967,13443,26.979902227050516,73.02009777294948,Housing
31954,25500,6454,79.80221568504724,20.197784314952745,Food
166906,30273,136633,18.137754184990353,81.86224581500964,Entertainment
90400,39994,50406,44.24115044247788,55.758849557522126,Transportation
49452,7642,41810,15.453368923400468,84.54663107659954,Food
148156,22357,125799,15.090175220713304,84.90982477928671,Healthcare
100909,4617,96292,4.57540952739597,95.42459047260404,Healthcare
85435,25039,60396,29.307660794756245,70.69233920524375,Transportation
72354,29849,42505,41.254111728446254,58.745888271553746,Transportation
198403,8262,190141,4.164251548615696,95.8357484513843,Entertainment
61255,4018,57237,6.559464533507469,93.44053546649253,Transportation
124081,20683,103398,16.668950121291736,83.33104987870826,Healthcare
170321,4507,165814,2.64617986038128,97.35382013961872,Entertainment
9296,8436,860,90.7487091222031,9.251290877796901,Housing
67291,5499,61792,8.171969505580241,91.82803049441975,Transportation
178235,46993,131242,26.36575307880046,73.63424692119955,Entertainment
103196,25451,77745,24.66277762703981,75.33722237296018,Healthcare
142801,31912,110889,22.34718244269998,77.65281755730001,Healthcare
111295,38405,72890,34.50739026910463,65.49260973089537,Healthcare
37162,20689,16473,55.67246111619396,44.32753888380604,Food
24389,23873,516,97.88429209889703,2.1157079011029563,Housing
22839,11949,10890,52.31840273216866,47.68159726783134,Housing
190700,45609,145091,23.916622968012586,76.08337703198742,Entertainment
95882,4311,91571,4.496151519576146,95.50384848042385,Transportation
58931,6680,52251,11.335290424394632,88.66470957560537,Transportation
34216,22044,12172,64.42599953238252,35.57400046761749,Food
156591,46745,109846,29.85165175520943,70.14834824479057,Entertainment
30455,9424,21031,30.94401576095879,69.05598423904121,Food
38491,35362,3129,91.87082694655894,8.129173053441065,Food
78055,21076,56979,27.001473320094803,72.9985266799052,Transportation
72332,26355,45977,36.4361555051706,63.563844494829404,Transportation
106087,47130,58957,44.425801464835466,55.574198535164534,Healthcare
90041,21057,68984,23.38601303850468,76.61398696149531,Transportation
102247,20010,82237,19.570256340039315,80.42974365996068,Healthcare
125191,33012,92179,26.3693076978377,73.63069230216229,Healthcare
152672,43739,108933,28.648999161601342,71.35100083839866,Entertainment
95657,30171,65486,31.5408177132881,68.4591822867119,Transportation
34077,3805,30272,11.165889016051883,88.83411098394812,Food
32212,9927,22285,30.81770768657643,69.18229231342356,Food
135866,1404,134462,1.033371115658075,98.96662888434193,Healthcare
32300,11523,20777,35.6749226006192,64.3250773993808,Food
21930,10077,11853,45.95075239398085,54.04924760601916,Housing
41981,6054,35927,14.420809413782425,85.57919058621758,Food
195247,22253,172994,11.397358218052005,88.602641781948,Entertainment
117159,19195,97964,16.383717853515307,83.61628214648469,Healthcare
36976,15596,21380,42.1787105149286,57.821289485071404,Food
18238,13760,4478,75.44686917425156,24.553130825748436,Housing
18601,11704,6897,62.92134831460674,37.07865168539326,Housing
136211,16191,120020,11.886705185337455,88.11329481466255,Healthcare
113028,4030,108998,3.56548819761475,96.43451180238525,Healthcare
41036,13210,27826,32.191246710205675,67.80875328979434,Food
43232,39619,3613,91.64276461880088,8.35723538119911,Food
10659,4596,6063,43.11849141570504,56.88150858429496,Housing
116268,18268,98000,15.711975780094264,84.28802421990574,Healthcare
160979,37628,123351,23.37447741630896,76.62552258369104,Entertainment
25454,9896,15558,38.877975956627644,61.122024043372356,Food
99391,32275,67116,32.47275910293689,67.52724089706311,Transportation
38437,66,38371,0.17170955069334234,99.82829044930665,Food
126919,46152,80767,36.36334985305589,63.63665014694412,Healthcare
174884,13663,161221,7.812607213924659,92.18739278607534,Entertainment
46261,24486,21775,52.93011391885173,47.06988608114827,Food
30160,27547,2613,91.33620689655172,8.663793103448276,Food
51526,33528,17998,65.07006171641501,34.92993828358499,Transportation
52366,32017,20349,61.1408165603636,38.85918343963641,Transportation
65296,47605,17691,72.90645675079638,27.093543249203627,Transportation
42034,36902,5132,87.79083598991294,12.209164010087074,Food
21379,7006,14373,32.770475700453716,67.22952429954628,Housing
9899,7734,2165,78.12910394989393,21.87089605010607,Housing
34031,19880,14151,58.417325379800765,41.58267462019923,Food
147208,18213,128995,12.372289549481007,87.62771045051899,Healthcare
169674,29488,140186,17.379209543006,82.620790456994,Entertainment
197759,17829,179930,9.015518889152958,90.98448111084704,Entertainment
96030,25215,70815,26.257419556388626,73.74258044361137,Transportation
20087,17508,2579,87.16085030118983,12.839149698810177,Housing
56807,39197,17610,69.00029925889415,30.99970074110585,Transportation
101939,28390,73549,27.849988718743564,72.15001128125644,Healthcare
40387,39182,1205,97.01636665263574,2.983633347364251,Food
20015,12234,7781,61.12415688233824,38.87584311766175,Housing
119363,46281,73082,38.773321716109685,61.226678283890315,Healthcare
89466,20317,69149,22.70918561241142,77.29081438758858,Transportation
29273,20151,9122,68.83817852628702,31.161821473712976,Food
112195,7526,104669,6.707963813004144,93.29203618699586,Healthcare
151259,13598,137661,8.98987828823409,91.01012171176592,Entertainment
159603,45463,114140,28.485053539093876,71.51494646090613,Entertainment
8504,1214,7290,14.275634995296333,85.72436500470367,Housing
59588,28264,31324,47.43236893334228,52.56763106665772,Transportation
159446,33490,125956,21.00397626782735,78.99602373217265,Entertainment
183707,29610,154097,16.118057559047834,83.88194244095217,Entertainment
82357,3809,78548,4.6249863399589595,95.37501366004105,Transportation
23649,4945,18704,20.909975051799233,79.09002494820076,Housing
76583,5791,70792,7.561730410143243,92.43826958985676,Transportation
104002,30783,73219,29.598469260206535,70.40153073979346,Healthcare
169978,33061,136917,19.450164138888564,80.54983586111145,Entertainment
183025,49601,133424,27.10066930747166,72.89933069252834,Entertainment
137063,34555,102508,25.211034341871986,74.78896565812802,Healthcare
8768,5490,3278,62.61405109489051,37.38594890510949,Housing
187678,48246,139432,25.70679568196592,74.29320431803407,Entertainment
168376,21814,146562,12.955528103767758,87.04447189623224,Entertainment
31032,4243,26789,13.672982727507089,86.32701727249291,Food
78288,3688,74600,4.710811363171878,95.28918863682813,Transportation
14229,7641,6588,53.70018975332068,46.29981024667932,Housing
75736,29092,46644,38.41237984578007,61.58762015421993,Transportation
196018,38305,157713,19.541572712710057,80.45842728728995,Entertainment
78068,22258,55810,28.511041655992216,71.48895834400778,Transportation
112942,1669,111273,1.477749641408865,98.52225035859114,Healthcare
45471,43129,2342,94.84946449385323,5.150535506146775,Food
24749,15587,9162,62.980322437270196,37.01967756272981,Housing
96024,35814,60210,37.29692576855786,62.70307423144214,Transportation
97600,35476,62124,36.34836065573771,63.65163934426229,Transportation
102020,15919,86101,15.603803175847872,84.39619682415213,Healthcare
184144,24240,159904,13.16361108697541,86.83638891302459,Entertainment
9914,7365,2549,74.28888440589067,25.71111559410934,Housing
13445,10706,2739,79.62811454072146,20.37188545927854,Housing
59245,33481,25764,56.51278588910456,43.48721411089544,Transportation
82671,42471,40200,51.37351671081758,48.62648328918242,Transportation
77074,47655,29419,61.830189168850715,38.169810831149285,Transportation
10720,8905,1815,83.06902985074626,16.93097014925373,Housing
40230,7170,33060,17.822520507084267,82.17747949291574,Food
21350,12418,8932,58.16393442622952,41.83606557377049,Housing
166203,19928,146275,11.990156615704892,88.00984338429511,Entertainment
37445,9637,27808,25.736413406329284,74.26358659367071,Food
119651,15115,104536,12.632573066668895,87.3674269333311,Healthcare
23493,20447,3046,87.03443578938406,12.965564210615929,Housing
10049,5423,4626,53.965568713304805,46.034431286695195,Housing
41411,6937,34474,16.75158774238729,83.24841225761271,Food
105143,23246,81897,22.108937351987294,77.8910626480127,Healthcare
23106,17844,5262,77.22669436509997,22.773305634900026,Housing
12737,854,11883,6.704875559393892,93.2951244406061,Housing
110858,42261,68597,38.12174132674232,61.87825867325768,Healthcare
165736,19158,146578,11.559347395858474,88.44065260414152,Entertainment
10307,7133,3174,69.20539439216067,30.79460560783933,Housing
100021,14717,85304,14.713910078883435,85.28608992111657,Healthcare
154258,15846,138412,10.272400783103631,89.72759921689637,Entertainment
190668,39913,150755,20.933245222061384,79.06675477793861,Entertainment
182278,21400,160878,11.740308759148114,88.2596912408519,Entertainment
24753,18202,6551,73.53452106815335,26.465478931846643,Housing
26549,25719,830,96.87370522430223,3.1262947756977666,Food
17146,4971,12175,28.99218476612621,71.0078152338738,Housing
48000,42358,5642,88.24583333333334,11.754166666666666,Food
18160,14124,4036,77.77533039647577,22.22466960352423,Housing
83403,32543,50860,39.01898013260914,60.98101986739086,Transportation
153744,7159,146585,4.656441877406598,95.3435581225934,Entertainment
23717,7355,16362,31.0115107306995,68.9884892693005,Housing
51869,18055,33814,34.808845360427235,65.19115463957277,Transportation
109911,1778,108133,1.6176724804614642,98.38232751953853,Healthcare
196000,47951,148049,24.464795918367347,75.53520408163266,Entertainment
96586,14260,82326,14.764044478495848,85.23595552150415,Transportation
119704,18704,101000,15.62520884849295,84.37479115150705,Healthcare
31366,30499,867,97.23586048587643,2.7641395141235736,Food
14265,466,13799,3.2667367683140554,96.73326323168594,Housing
31590,2044,29546,6.470402025957582,93.52959797404242,Food
50433,4151,46282,8.230721947930917,91.76927805206908,Transportation
13450,3712,9738,27.598513011152413,72.40148698884758,Housing
143832,362,143470,0.2516825184937983,99.7483174815062,Healthcare
71810,26651,45159,37.11321542960591,62.88678457039409,Transportation
22899,22074,825,96.39722258613914,3.602777413860867,Housing
24639,4804,19835,19.497544543203862,80.50245545679614,Housing
26263,21431,4832,81.60149259414385,18.398507405856147,Food
24077,294,23783,1.2210823607592307,98.77891763924077,Housing
152440,7804,144636,5.1193912358960905,94.88060876410391,Entertainment
188411,16489,171922,8.75161216701785,91.24838783298215,Entertainment
163511,24966,138545,15.268697518821364,84.73130248117864,Entertainment
9105,3008,6097,33.036792970895114,66.9632070291049,Housing
51080,29657,21423,58.059906029757244,41.940093970242756,Transportation
144853,46117,98736,31.83710382249591,68.1628961775041,Healthcare
45470,40722,4748,89.55795029689907,10.442049703100945,Food
33186,249,32937,0.7503163984812873,99.24968360151871,Food
106999,39950,67049,37.33679754016392,62.66320245983608,Healthcare
136293,8998,127295,6.601953145062475,93.39804685493752,Healthcare
117777,6060,111717,5.145316997376398,94.8546830026236,Healthcare
148227,31335,116892,21.13987330243478,78.86012669756522,Healthcare
127826,13698,114128,10.716129738863769,89.28387026113623,Healthcare
24063,10258,13805,42.629763537381045,57.37023646261896,Housing
23770,16478,7292,69.322675641565,30.677324358435005,Housing
136534,29674,106860,21.73378059677443,78.26621940322556,Healthcare
195486,18021,177465,9.218562966145912,90.78143703385409,Entertainment
11420,301,11119,2.635726795096322,97.36427320490367,Housing
13119,5694,7425,43.402698376400636,56.597301623599364,Housing
41379,678,40701,1.6385122888421664,98.36148771115784,Food
44066,35967,8099,81.6207506921436,18.379249307856398,Food
150367,48415,101952,32.197889164510826,67.80211083548917,Entertainment
146538,7061,139477,4.818545360247853,95.18145463975215,Healthcare
122871,24496,98375,19.9363560156587,80.0636439843413,Healthcare
90932,18454,72478,20.294285839968328,79.70571416003168,Transportation
87137,11179,75958,12.829222947771898,87.1707770522281,Transportation
82263,18093,64170,21.99409211917873,78.00590788082127,Transportation
76842,28365,48477,36.913406730694156,63.086593269305844,Transportation
106612,22706,83906,21.297790117435188,78.70220988256482,Healthcare
104562,32847,71715,31.41389797440753,68.58610202559248,Healthcare
55783,1234,54549,2.2121434845741534,97.78785651542584,Transportation
20880,15517,5363,74.31513409961686,25.68486590038314,Housing
72105,256,71849,0.3550377921087303,99.64496220789127,Transportation
64780,29294,35486,45.2207471441803,54.77925285581969,Transportation
91758,33547,58211,36.56029991935308,63.43970008064692,Transportation
41693,31625,10068,75.85206149713382,24.14793850286619,Food
109523,45406,64117,41.45795860230271,58.54204139769729,Healthcare
15941,14388,1553,90.25782573238818,9.742174267611817,Housing
53219,20141,33078,37.8455063041395,62.1544936958605,Transportation
43985,22559,21426,51.28793907013755,48.71206092986245,Food
131284,39423,91861,30.028792541360716,69.97120745863928,Healthcare
21979,11755,10224,53.48287001228446,46.51712998771554,Housing
173642,37479,136163,21.58406376337522,78.41593623662479,Entertainment
38394,3670,34724,9.558785226858364,90.44121477314164,Food
198323,2339,195984,1.1793891782597077,98.8206108217403,Entertainment
154831,28640,126191,18.49758769238718,81.50241230761281,Entertainment
8614,5392,3222,62.595774320873,37.404225679127,Housing
21913,9105,12808,41.550677679916035,58.449322320083965,Housing
189156,39601,149555,20.935629850493772,79.06437014950623,Entertainment
185430,39419,146011,21.258156716820366,78.74184328317963,Entertainment
32065,13068,18997,40.75471698113208,59.24528301886792,Food
166247,8109,158138,4.87768200328427,95.12231799671574,Entertainment
59778,36331,23447,60.77653986416407,39.22346013583592,Transportation
100988,1965,99023,1.9457757357309777,98.05422426426902,Healthcare
188197,22369,165828,11.885949297810274,88.11405070218973,Entertainment
61940,27412,34528,44.25573135292218,55.744268647077824,Transportation
192845,9752,183093,5.056910990692007,94.943089009308,Entertainment
189138,7127,182011,3.768148124649727,96.23185187535027,Entertainment
18626,1993,16633,10.700096639106626,89.29990336089337,Housing
47491,45875,1616,96.59725000526416,3.4027499947358444,Food
163337,19843,143494,12.148502788712905,87.85149721128708,Entertainment
31520,3962,27558,12.569796954314722,87.43020304568529,Food
65188,37375,27813,57.33417193348469,42.66582806651531,Transportation
178917,2919,175998,1.6314827545733497,98.36851724542664,Entertainment
148482,28475,120007,19.1774087094732,80.8225912905268,Healthcare
91834,565,91269,0.6152405427183831,99.38475945728162,Transportation
175657,48988,126669,27.888441678953868,72.11155832104613,Entertainment
181796,4270,177526,2.3487865519593387,97.65121344804066,Entertainment
83093,47928,35165,57.67994897283767,42.320051027162336,Transportation
181262,6107,175155,3.3691562489655857,96.6308437510344,Entertainment
117264,24643,92621,21.014974757811434,78.98502524218857,Healthcare
41345,22852,18493,55.271495948724144,44.72850405127585,Food
174261,28380,145881,16.285915953655724,83.71408404634427,Entertainment
181354,38614,142740,21.292058625671338,78.70794137432866,Entertainment
32125,21585,10540,67.19066147859922,32.809338521400775,Food
64692,4311,60381,6.663884251530329,93.33611574846967,Transportation
96871,48157,48714,49.712504258240344,50.287495741759656,Transportation
49648,18074,31574,36.40428617466968,63.59571382533032,Food
12014,11093,921,92.3339437323123,7.666056267687697,Housing
98625,9611,89014,9.744993662864385,90.25500633713561,Transportation
171308,11002,160306,6.422350386438462,93.57764961356155,Entertainment
185002,31415,153587,16.98089750381077,83.01910249618923,Entertainment
90796,32535,58261,35.83307634697564,64.16692365302437,Transportation
160350,9543,150807,5.95135640785781,94.04864359214218,Entertainment
106403,4521,101882,4.248940349426238,95.75105965057377,Healthcare
182401,1567,180834,0.8590961672359253,99.14090383276407,Entertainment
193008,20739,172269,10.745150460084556,89.25484953991545,Entertainment
129830,10985,118845,8.461064468920897,91.5389355310791,Healthcare
157057,28950,128107,18.432798283425765,81.56720171657423,Entertainment
137998,2010,135988,1.456542848447079,98.54345715155291,Healthcare
28058,26660,1398,95.01746382493407,4.982536175065935,Food
143978,20943,123035,14.545972301323815,85.45402769867619,Healthcare
36988,2148,34840,5.807288850437979,94.19271114956203,Food
15446,1431,14015,9.26453450731581,90.73546549268418,Housing
69382,47783,21599,68.86944740710848,31.13055259289153,Transportation
59309,9609,49700,16.201588291827548,83.79841170817245,Transportation
86736,7423,79313,8.558153477218225,91.44184652278177,Transportation
68848,27105,41743,39.36933534743202,60.63066465256798,Transportation
14989,7236,7753,48.275401961438384,51.72459803856161,Housing
11849,7519,4330,63.45683180015192,36.54316819984808,Housing
106561,38278,68283,35.92120944810953,64.07879055189046,Healthcare
143733,30105,113628,20.945085679697772,79.05491432030223,Healthcare
180832,23531,157301,13.01263050787471,86.98736949212528,Entertainment
58072,26149,31923,45.02858520457364,54.97141479542636,Transportation
190286,1019,189267,0.5355097064418822,99.46449029355811,Entertainment
68595,7399,61196,10.786500473795465,89.21349952620453,Transportation
23795,860,22935,3.614204664845556,96.38579533515444,Housing
20207,238,19969,1.1778096699163656,98.82219033008364,Housing
15184,5796,9388,38.171759747102215,61.82824025289779,Housing
18453,10478,7975,56.78209505229502,43.21790494770498,Housing
116353,45650,70703,39.23405498783873,60.76594501216127,Healthcare
198911,5244,193667,2.636354952717547,97.36364504728246,Entertainment
32270,7130,25140,22.09482491478153,77.90517508521847,Food
43257,35585,7672,82.26414221975634,17.73585778024366,Food
8814,345,8469,3.9142273655547988,96.08577263444519,Housing
47798,17587,30211,36.79442654504372,63.20557345495628,Food
118688,35989,82699,30.32235777837692,69.67764222162309,Healthcare
190377,20105,170272,10.560624445179826,89.43937555482017,Entertainment
130413,18174,112239,13.9357272664535,86.0642727335465,Healthcare
122734,2473,120261,2.014926589209184,97.98507341079082,Healthcare
45691,19183,26508,41.98419820095861,58.01580179904139,Food
16208,7339,8869,45.28010858835143,54.71989141164857,Housing
42514,767,41747,1.8041115867714164,98.19588841322859,Food
14564,9783,4781,67.17248008788795,32.82751991211206,Housing
102000,14849,87151,14.557843137254903,85.4421568627451,Healthcare
79370,36382,42988,45.83847801436311,54.161521985636895,Transportation
50365,34568,15797,68.63496475727192,31.365035242728084,Transportation
60845,37629,23216,61.84402991207166,38.155970087928345,Transportation
21283,6652,14631,31.25499224733355,68.74500775266644,Housing
78616,7903,70713,10.05266103592144,89.94733896407855,Transportation
9312,4311,5001,46.295103092783506,53.704896907216494,Housing
169920,37622,132298,22.141007532956685,77.85899246704332,Entertainment
91834,27197,64637,29.61539299170242,70.38460700829758,Transportation
21409,16514,4895,77.13578401606802,22.86421598393199,Housing
167598,11123,156475,6.636714041933675,93.36328595806633,Entertainment
41662,3089,38573,7.414430416206614,92.58556958379339,Food
46089,31376,14713,68.07698149233006,31.923018507669944,Food
39353,9746,29607,24.765583310039897,75.2344166899601,Food
54268,5988,48280,11.034126925628362,88.96587307437164,Transportation
29568,16079,13489,54.37973484848485,45.62026515151515,Food
28872,1806,27066,6.255195344970906,93.74480465502909,Food
116490,28004,88486,24.039831745214183,75.96016825478583,Healthcare
46210,41515,4695,89.83986150183942,10.160138498160572,Food
168202,41150,127052,24.464631811750156,75.53536818824983,Entertainment
194350,32786,161564,16.869565217391305,83.1304347826087,Entertainment
29604,27773,1831,93.81502499662207,6.184975003377922,Food
72175,34651,37524,48.00969864911673,51.99030135088327,Transportation
93418,22554,70864,24.1430987604102,75.8569012395898,Transportation
24433,20335,4098,83.22760201367004,16.772397986329963,Housing
8823,928,7895,10.517964411198005,89.482035588802,Housing
80414,33270,47144,41.37339269281469,58.62660730718532,Transportation
174284,46429,127855,26.639852195267494,73.3601478047325,Entertainment
45075,3435,41640,7.620632279534109,92.3793677204659,Food
18181,7057,11124,38.81524668610087,61.18475331389912,Housing
137831,7066,130765,5.1265680434735295,94.87343195652646,Healthcare
196334,42967,153367,21.884645552986235,78.11535444701376,Entertainment
28909,27573,1336,95.37860181950258,4.6213981804974225,Food
58792,41473,17319,70.54191046400871,29.458089535991288,Transportation
98826,13877,84949,14.041851334669014,85.958148665331,Transportation
12858,10040,2818,78.08368331000155,21.916316689998443,Housing
195490,32664,162826,16.70878305795693,83.29121694204306,Entertainment
19171,13545,5626,70.65359136195295,29.346408638047052,Housing
39023,20013,19010,51.28513953309587,48.71486046690413,Food
191192,4930,186262,2.5785597723754132,97.42144022762459,Entertainment
173612,422,173190,0.24307075547773194,99.75692924452227,Entertainment
18805,3083,15722,16.394575910662056,83.60542408933794,Housing
190111,22407,167704,11.786272230433799,88.21372776956619,Entertainment
130581,26149,104432,20.02511850881828,79.97488149118172,Healthcare
18047,11754,6293,65.1299384939325,34.87006150606749,Housing
15158,10248,4910,67.60786383427893,32.39213616572107,Housing
53018,20725,32293,39.09049756686409,60.90950243313592,Transportation
9307,8848,459,95.06822821532181,4.931771784678199,Housing
14614,3252,11362,22.252634460106748,77.74736553989325,Housing
80821,37743,43078,46.69949641801017,53.30050358198983,Transportation
22289,17055,5234,76.51756471802234,23.482435281977658,Housing
127461,17509,109952,13.736750849279385,86.26324915072061,Healthcare
9102,5243,3859,57.60272467589541,42.39727532410459,Housing
22871,1013,21858,4.429189803681518,95.57081019631848,Housing
113281,36303,76978,32.04685693099461,67.95314306900539,Healthcare
182831,1783,181048,0.9752175506341921,99.02478244936582,Entertainment
171261,36476,134785,21.29848593666976,78.70151406333024,Entertainment
133472,662,132810,0.4959841764564853,99.50401582354351,Healthcare
147610,38995,108615,26.41758688435743,73.58241311564258,Healthcare
159821,32750,127071,20.491675061475025,79.50832493852498,Entertainment
192728,44775,147953,23.23222365198622,76.76777634801378,Entertainment
8406,166,8240,1.974779919105401,98.0252200808946,Housing
78344,3770,74574,4.81211069131012,95.18788930868988,Transportation
43377,41266,2111,95.1333656085022,4.866634391497798,Food
26583,14374,12209,54.07215137493887,45.92784862506113,Food
20297,10965,9332,54.02276198452973,45.97723801547027,Housing
10433,5311,5122,50.9057797373718,49.0942202626282,Housing
104862,34364,70498,32.77068909614541,67.22931090385458,Healthcare
142486,4876,137610,3.4220905913563437,96.57790940864366,Healthcare
53651,45117,8534,84.0934931315353,15.906506868464707,Transportation
162865,22842,140023,14.025112823504129,85.97488717649587,Entertainment
108799,25143,83656,23.109587404295993,76.890412595704,Healthcare
17130,12312,4818,71.87390542907181,28.126094570928196,Housing
187084,45228,141856,24.17523679202925,75.82476320797075,Entertainment
20855,19642,1213,94.18364900503477,5.816350994965235,Housing
158292,43046,115246,27.19404644580901,72.80595355419099,Entertainment
59678,44111,15567,73.91501055665405,26.084989443345957,Transportation
20867,19127,1740,91.661475056309,8.338524943690995,Housing
104902,42889,62013,40.88482583744828,59.11517416255172,Healthcare
172943,44539,128404,25.753571986145722,74.24642801385427,Entertainment
49901,5074,44827,10.168132903148233,89.83186709685177,Food
89398,13828,75570,15.46790755945323,84.53209244054676,Transportation
31241,1893,29348,6.059345091386319,93.94065490861368,Food
167339,3291,164048,1.9666664674702252,98.03333353252978,Entertainment
11959,6285,5674,52.55456141817878,47.44543858182122,Housing
127916,2708,125208,2.1170142906282248,97.88298570937177,Healthcare
194066,49649,144417,25.583564354394895,74.4164356456051,Entertainment
125531,44740,80791,35.640598736567064,64.35940126343294,Healthcare
155096,31495,123601,20.306777737659257,79.69322226234074,Entertainment
89829,16331,73498,18.180097741263957,81.81990225873605,Transportation
179098,17788,161310,9.931992540396879,90.06800745960312,Entertainment
142704,15748,126956,11.035429980939568,88.96457001906043,Healthcare
95455,26490,68965,27.751296422397985,72.24870357760202,Transportation
21489,5546,15943,25.808553213271907,74.1914467867281,Housing
138527,45344,93183,32.732969024089165,67.26703097591084,Healthcare
182574,27803,154771,15.228345766648044,84.77165423335195,Entertainment
20686,13716,6970,66.305714009475,33.69428599052499,Housing
119419,2387,117032,1.9988444049941803,98.00115559500581,Healthcare
16571,7208,9363,43.49767666405165,56.50232333594835,Housing
109439,18156,91283,16.590063871197653,83.40993612880234,Healthcare
111333,47941,63392,43.06090736798613,56.93909263201387,Healthcare
82061,22419,59642,27.319920546910225,72.68007945308977,Transportation
136008,13942,122066,10.250867596023763,89.74913240397623,Healthcare
109665,1099,108566,1.00214288970957,98.99785711029043,Healthcare
192733,13768,178965,7.143561299829297,92.85643870017071,Entertainment
197902,21652,176250,10.940768663277783,89.0592313367222,Entertainment
129613,21725,107888,16.761435967071204,83.23856403292879,Healthcare
85368,5813,79555,6.809343079374004,93.190656920626,Transportation
19344,1750,17594,9.046732837055417,90.95326716294458,Housing
156192,17842,138350,11.423120262241344,88.57687973775865,Entertainment
80029,45494,34535,56.846893001287036,43.153106998712964,Transportation
115195,26631,88564,23.118190893701986,76.88180910629802,Healthcare
94195,49377,44818,52.41997982907798,47.58002017092202,Transportation
27132,23706,3426,87.37284387439186,12.627156125608138,Food
59386,18232,41154,30.700838581483854,69.29916141851615,Transportation
181609,13138,168471,7.234222973531048,92.76577702646895,Entertainment
109320,16575,92745,15.161909989023052,84.83809001097696,Healthcare
8136,1029,7107,12.64749262536873,87.35250737463127,Housing
190376,10928,179448,5.74021935538093,94.25978064461907,Entertainment
93345,34790,58555,37.270341207349084,62.72965879265092,Transportation
35638,34724,914,97.43532184746618,2.564678152533812,Food
8726,3760,4966,43.089617235846895,56.9103827641531,Housing
25221,14226,10995,56.40537647198764,43.59462352801237,Food
35474,9247,26227,26.066978632237696,73.93302136776231,Food
193316,39386,153930,20.37389559063916,79.62610440936085,Entertainment
97993,26666,71327,27.212147806475972,72.78785219352403,Transportation
18222,4675,13547,25.655800680496103,74.3441993195039,Housing
23265,19488,3777,83.76531270148291,16.234687298517088,Housing
45901,13840,32061,30.151848543604714,69.84815145639529,Food
22282,16285,5997,73.08589893187326,26.91410106812674,Housing
36411,14519,21892,39.875312405591714,60.124687594408286,Food
78084,16480,61604,21.105476153885558,78.89452384611444,Transportation
37007,3149,33858,8.509200961980167,91.49079903801983,Food
35755,26655,9100,74.54901412389876,25.450985876101246,Food
174943,2827,172116,1.6159549110281632,98.38404508897185,Entertainment
192420,24832,167588,12.90510341960295,87.09489658039705,Entertainment
18213,3259,14954,17.89381211222753,82.10618788777248,Housing
73260,13864,59396,18.924378924378924,81.07562107562107,Transportation
184726,19450,165276,10.529107976137631,89.47089202386238,Entertainment
31480,31390,90,99.7141041931385,0.28589580686149935,Food
137652,23434,114218,17.024089733530936,82.97591026646907,Healthcare
45289,29432,15857,64.9870829561262,35.012917043873784,Food
133608,24578,109030,18.395605053589605,81.6043949464104,Healthcare
24009,16994,7015,70.78179016202257,29.218209837977426,Housing
151300,339,150961,0.22405816259087907,99.77594183740912,Entertainment
45581,27586,17995,60.52083104802439,39.4791689519756,Food
29369,1317,28052,4.484320201573087,95.51567979842692,Food
44157,10672,33485,24.168308535453043,75.83169146454696,Food
106787,36782,70005,34.44426756065813,65.55573243934187,Healthcare
13901,9325,4576,67.08150492770304,32.918495072296956,Housing
151105,17654,133451,11.683266602693491,88.3167333973065,Entertainment
17078,6090,10988,35.659913338798454,64.34008666120154,Housing
148567,43722,104845,29.429146445711364,70.57085355428863,Healthcare
32866,12118,20748,36.87093044483661,63.12906955516338,Food
87634,35057,52577,40.003879772690965,59.996120227309035,Transportation
180886,11008,169878,6.085600875689661,93.91439912431035,Entertainment
60840,10,60830,0.01643655489809336,99.98356344510191,Transportation
174669,11723,162946,6.711551563242475,93.28844843675752,Entertainment
8226,264,7962,3.209336250911744,96.79066374908825,Housing
78226,45853,32373,58.61606115613734,41.38393884386266,Transportation
135246,3093,132153,2.286943791313606,97.71305620868638,Healthcare
31534,21061,10473,66.78822857867698,33.211771421323014,Food
32929,2080,30849,6.316620607974734,93.68337939202527,Food
180658,21207,159451,11.738754995627096,88.2612450043729,Entertainment
138534,26,138508,0.018767955880866792,99.98123204411912,Healthcare
38331,26128,12203,68.16414912212048,31.835850877879523,Food
139625,35200,104425,25.210384959713515,74.78961504028648,Healthcare
165091,15915,149176,9.640137863360208,90.35986213663979,Entertainment
78027,11929,66098,15.28829764056032,84.71170235943968,Transportation
172436,36892,135544,21.394604374956504,78.6053956250435,Entertainment
57148,40399,16749,70.69188773010428,29.30811226989571,Transportation
176235,13349,162886,7.574545351377422,92.42545464862258,Entertainment
123451,10057,113394,8.146552073292238,91.85344792670776,Healthcare
14318,12310,2008,85.97569492945942,14.024305070540578,Housing
61442,31476,29966,51.228801145796034,48.77119885420396,Transportation
135124,34723,100401,25.697137444125396,74.30286255587461,Healthcare
160716,21803,138913,13.566166405336123,86.43383359466388,Entertainment
186746,28893,157853,15.471817334775578,84.52818266522442,Entertainment
31365,30563,802,97.44300972421489,2.5569902757851106,Food
23023,8007,15016,34.778265213047824,65.22173478695218,Housing
47415,32991,14424,69.57924707371085,30.420752926289147,Food
122108,45545,76563,37.2989484718446,62.7010515281554,Healthcare
166633,27144,139489,16.28969051748453,83.71030948251547,Entertainment
20975,6924,14051,33.01072705601907,66.98927294398092,Housing
15350,15183,167,98.91205211726385,1.0879478827361562,Housing
143422,24346,119076,16.97508053157814,83.02491946842187,Healthcare
170170,44746,125424,26.294881588999235,73.70511841100075,Entertainment
118589,3902,114687,3.2903557665550767,96.70964423344492,Healthcare
33882,5603,28279,16.536804202821557,83.46319579717844,Food
67264,46874,20390,69.6866079923882,30.3133920076118,Transportation
39554,5820,33734,14.714061788946756,85.28593821105325,Food
25921,21304,4617,82.18818718413642,17.811812815863586,Food
130184,20758,109426,15.945123824740367,84.05487617525964,Healthcare
88380,9432,78948,10.672097759674134,89.32790224032587,Transportation
23787,17159,6628,72.136040694497,27.863959305503005,Housing
20306,10503,9803,51.72362848419186,48.27637151580814,Housing
10832,5679,5153,52.42799113737075,47.57200886262925,Housing
43438,41247,2191,94.95602928311617,5.043970716883835,Food
177445,24734,152711,13.93896700386035,86.06103299613966,Entertainment
163616,14732,148884,9.00400938783493,90.99599061216507,Entertainment
9605,5622,3983,58.5320145757418,41.467985424258195,Housing
67107,9474,57633,14.117752246412445,85.88224775358756,Transportation
74562,18033,56529,24.18524181218315,75.81475818781685,Transportation
171616,8039,163577,4.684295170613463,95.31570482938653,Entertainment
18695,9135,9560,48.863332441829364,51.136667558170636,Housing
9646,13,9633,0.13477088948787064,99.86522911051213,Housing
65532,16672,48860,25.44100592077153,74.55899407922847,Transportation
186231,48242,137989,25.904387561684146,74.09561243831585,Entertainment
78364,30720,47644,39.20167423817059,60.79832576182941,Transportation
97757,36665,61092,37.50626553597185,62.49373446402815,Transportation
178015,40857,137158,22.95143667668455,77.04856332331545,Entertainment
78083,22080,56003,28.277602038856088,71.72239796114391,Transportation
105488,36282,69206,34.39443349006522,65.60556650993477,Healthcare
40162,9343,30819,23.263283701010906,76.7367162989891,Food
182801,10886,171915,5.955109654761189,94.04489034523881,Entertainment
139092,22131,116961,15.911051678026055,84.08894832197394,Healthcare
24282,23932,350,98.55860308047113,1.4413969195288692,Housing
105623,30540,75083,28.914156954451208,71.08584304554878,Healthcare
85053,37820,47233,44.466391544096034,55.53360845590397,Transportation
27995,3744,24251,13.373816752991605,86.6261832470084,Food
91382,38367,53015,41.98529250837145,58.01470749162855,Transportation
99893,25965,73928,25.992812309170816,74.00718769082918,Transportation
68896,246,68650,0.35705991639572693,99.64294008360427,Transportation
178707,6360,172347,3.5588980845741913,96.4411019154258,Entertainment
52094,44498,7596,85.41866625715053,14.581333742849464,Transportation
156660,1238,155422,0.7902463934635516,99.20975360653644,Entertainment
125094,48952,76142,39.132172606200136,60.867827393799864,Healthcare
83530,12511,71019,14.977852268645995,85.022147731354,Transportation
21171,5774,15397,27.2731566765859,72.7268433234141,Housing
168641,32158,136483,19.068909695744214,80.93109030425578,Entertainment
194159,8366,185793,4.308839662338599,95.6911603376614,Entertainment
28085,11110,16975,39.558483176072635,60.441516823927365,Food
158775,46807,111968,29.480081876869786,70.51991812313022,Entertainment
175349,10108,165241,5.764503932158154,94.23549606784185,Entertainment
106440,30921,75519,29.050169109357384,70.94983089064262,Healthcare
26606,11970,14636,44.98985191310231,55.01014808689769,Food
104960,27257,77703,25.968940548780488,74.03105945121952,Healthcare
45976,589,45387,1.281103184270054,98.71889681572995,Food
31252,4939,26313,15.803788557532316,84.19621144246769,Food
118014,21446,96568,18.17242022132967,81.82757977867033,Healthcare
23596,529,23067,2.24190540769622,97.75809459230378,Housing
20345,7426,12919,36.50036864094372,63.49963135905627,Housing
147469,5445,142024,3.692301432843513,96.30769856715648,Healthcare
25288,22337,2951,88.33043340714963,11.669566592850364,Food
117190,20531,96659,17.51941291919106,82.48058708080895,Healthcare
197180,31369,165811,15.908814281367277,84.09118571863272,Entertainment
13432,4260,9172,31.715306730196545,68.28469326980345,Housing
180277,38003,142274,21.08033748065477,78.91966251934524,Entertainment
53465,18643,34822,34.869540821097914,65.13045917890209,Transportation
80783,45559,35224,56.396766646447894,43.603233353552106,Transportation
31998,5233,26765,16.354147134195888,83.64585286580412,Food
193210,414,192796,0.21427462346669426,99.7857253765333,Entertainment
17689,12046,5643,68.09881847475833,31.90118152524167,Housing
37331,864,36467,2.3144303661836005,97.6855696338164,Food
44839,42968,1871,95.82729320457636,4.172706795423626,Food
176926,16638,160288,9.403931587217254,90.59606841278274,Entertainment
15312,5320,9992,34.74399164054336,65.25600835945663,Housing
13366,8711,4655,65.17282657489152,34.827173425108484,Housing
124022,8212,115810,6.6214058796020066,93.37859412039799,Healthcare
196344,7862,188482,4.004196715967892,95.9958032840321,Entertainment
100982,43436,57546,43.013606385296384,56.986393614703616,Healthcare
36455,6837,29618,18.75462899465094,81.24537100534907,Food
141717,41783,99934,29.483407071840357,70.51659292815964,Healthcare
155476,36953,118523,23.76765545807713,76.23234454192287,Entertainment
12780,4177,8603,32.683881064162755,67.31611893583724,Housing
50387,26617,23770,52.82513346696569,47.17486653303432,Transportation
125361,48295,77066,38.52474054929364,61.47525945070637,Healthcare
15617,1524,14093,9.758596401357494,90.2414035986425,Housing
18136,9,18127,0.04962505513895015,99.95037494486105,Housing
74545,12638,61907,16.953518009256154,83.04648199074384,Transportation
137154,14755,122399,10.757980080785103,89.2420199192149,Healthcare
112570,2369,110201,2.1044683308163807,97.89553166918363,Healthcare
12465,635,11830,5.094263939029282,94.90573606097071,Housing
10105,3627,6478,35.89312221672439,64.1068777832756,Housing
74844,46484,28360,62.10785099673989,37.892149003260116,Transportation
108939,25168,83771,23.10283736770119,76.89716263229882,Healthcare
36781,31351,5430,85.23694298686823,14.76305701313178,Food
193725,10663,183062,5.5041940895599435,94.49580591044005,Entertainment
16427,8580,7847,52.23108297315395,47.76891702684605,Housing
108255,32419,75836,29.946884670454022,70.05311532954597,Healthcare
166772,13603,153169,8.156645000359774,91.84335499964023,Entertainment
83173,18105,65068,21.76788140382095,78.23211859617905,Transportation
14731,7241,7490,49.15484352725545,50.845156472744556,Housing
16691,7494,9197,44.89844826553232,55.10155173446768,Housing
8830,1651,7179,18.69762174405436,81.30237825594564,Housing
51598,11600,39998,22.481491530679484,77.51850846932051,Transportation
14426,11599,2827,80.4034382365174,19.5965617634826,Housing
13056,8110,4946,62.1170343137255,37.88296568627451,Housing
8661,2472,6189,28.541738829234497,71.4582611707655,Housing
108251,2818,105433,2.6032092082290235,97.39679079177098,Healthcare
31568,12716,18852,40.28129751647238,59.71870248352762,Food
107378,13036,94342,12.140289444765221,87.85971055523478,Healthcare
82472,47279,35193,57.327335338054134,42.67266466194587,Transportation
22051,11022,11029,49.984127703959004,50.015872296040996,Housing
17031,15037,1994,88.29193823028595,11.708061769714051,Housing
190152,1629,188523,0.8566830745929572,99.14331692540705,Entertainment
90160,44132,46028,48.94853593611357,51.05146406388642,Transportation
53689,14683,39006,27.348246381940434,72.65175361805957,Transportation
155544,46748,108796,30.05451833564779,69.9454816643522,Entertainment
43051,29932,13119,69.52684025922743,30.47315974077257,Food
88620,7032,81588,7.9350033852403525,92.06499661475965,Transportation
9542,5293,4249,55.470551247118,44.529448752882,Housing
102787,35001,67786,34.05197155282283,65.94802844717718,Healthcare
22376,5889,16487,26.318376832320347,73.68162316767966,Housing
136520,45682,90838,33.4617638441254,66.5382361558746,Healthcare
45863,11669,34194,25.443167695091905,74.5568323049081,Food
14614,9433,5181,64.5476939920624,35.452306007937594,Housing
16160,112,16048,0.6930693069306931,99.3069306930693,Housing
185163,22852,162311,12.34155851871054,87.65844148128946,Entertainment
140161,45313,94848,32.329249934004466,67.67075006599553,Healthcare
60814,41916,18898,68.92491860426875,31.075081395731246,Transportation
27177,5002,22175,18.405269161423263,81.59473083857674,Food
41728,32167,9561,77.08732745398773,22.91267254601227,Food
78352,18680,59672,23.841127220747396,76.1588727792526,Transportation
43030,41017,2013,95.32186846386243,4.678131536137578,Food
153527,26261,127266,17.105134601731294,82.8948653982687,Entertainment
91510,25218,66292,27.557643973336248,72.44235602666376,Transportation
194918,26809,168109,13.753988856852626,86.24601114314737,Entertainment
11228,3719,7509,33.122550765942286,66.87744923405772,Housing
138249,40545,97704,29.327517739730485,70.6724822602695,Healthcare
176833,31862,144971,18.01813010015099,81.98186989984902,Entertainment
125445,20446,104999,16.298776356172027,83.70122364382797,Healthcare
17283,13318,3965,77.0583810681016,22.941618931898397,Housing
107177,25774,81403,24.04807001502188,75.95192998497812,Healthcare
96608,24853,71755,25.725612785690625,74.27438721430939,Transportation
45626,14086,31540,30.872747994564502,69.12725200543551,Food
23523,14300,9223,60.7915657016537,39.2084342983463,Housing
40803,24503,16300,60.051956963948726,39.948043036051274,Food
22859,8073,14786,35.316505533925366,64.68349446607463,Housing
51910,25703,26207,49.514544403775766,50.48545559622424,Transportation
95488,36145,59343,37.85292392761394,62.14707607238606,Transportation
19473,17368,2105,89.19016073537719,10.809839264622811,Housing
60266,9705,50561,16.103607340789168,83.89639265921083,Transportation
102697,23705,78992,23.082465894816792,76.91753410518321,Healthcare
62819,22686,40133,36.113277829955905,63.886722170044095,Transportation
171405,5743,165662,3.35054403313789,96.6494559668621,Entertainment
9252,6996,2256,75.61608300907912,24.38391699092088,Housing
17032,5347,11685,31.393846876467823,68.60615312353218,Housing
95824,48848,46976,50.97679078310235,49.02320921689765,Transportation
10169,2172,7997,21.359032353230408,78.64096764676958,Housing
101923,31976,69947,31.37270292279466,68.62729707720534,Healthcare
15016,14027,989,93.41369206180075,6.586307938199254,Housing
127691,2994,124697,2.3447228074022446,97.65527719259775,Healthcare
23728,23275,453,98.09086311530682,1.9091368846931893,Housing
9619,8512,1107,88.49152718577815,11.508472814221852,Housing
24662,11116,13546,45.07339226340118,54.92660773659882,Housing
25883,20224,5659,78.13622841247151,21.863771587528493,Food
15927,3318,12609,20.832548502542853,79.16745149745715,Housing
87339,34283,53056,39.25279657426808,60.747203425731925,Transportation
183051,32263,150788,17.625142719788474,82.37485728021153,Entertainment
62530,30868,31662,49.36510474972013,50.63489525027987,Transportation
56573,33002,23571,58.335248263305814,41.664751736694186,Transportation
121147,17435,103712,14.391606890802084,85.6083931091979,Healthcare
165211,24159,141052,14.62311831536641,85.37688168463359,Entertainment
126009,18901,107108,14.999722242062074,85.00027775793792,Healthcare
166501,38553,127948,23.15481588699167,76.84518411300833,Entertainment
191352,25476,165876,13.313683682428195,86.68631631757181,Entertainment
20707,19624,1083,94.76988458009369,5.230115419906312,Housing
30878,6785,24093,21.973573417967486,78.02642658203251,Food
192887,49029,143858,25.418509282636986,74.58149071736302,Entertainment
17588,11829,5759,67.25608369342734,32.743916306572665,Housing
35879,11087,24792,30.901084199671118,69.09891580032888,Food
81601,17629,63972,21.60390191296675,78.39609808703325,Transportation
50761,24142,26619,47.56013474911842,52.43986525088158,Transportation
49254,19800,29454,40.19978072846875,59.80021927153124,Food
115676,24365,91311,21.06314187904146,78.93685812095855,Healthcare
61158,35135,26023,57.44955688544427,42.55044311455574,Transportation
188136,35658,152478,18.95331037122082,81.04668962877918,Entertainment
180615,44494,136121,24.634720261329345,75.36527973867065,Entertainment
158784,11170,147614,7.034713825070536,92.96528617492946,Entertainment
33208,23853,9355,71.82907733076367,28.170922669236333,Food
199761,49213,150548,24.635939948238146,75.36406005176187,Entertainment
49001,14011,34990,28.59329401440787,71.40670598559214,Food
38013,22760,15253,59.87425354483993,40.125746455160076,Food
185191,23663,161528,12.77761878277022,87.22238121722978,Entertainment
163937,29550,134387,18.025217004093037,81.97478299590696,Entertainment
171018,1821,169197,1.064800196470547,98.93519980352946,Entertainment
127108,30484,96624,23.982754822670486,76.01724517732951,Healthcare
23747,5744,18003,24.188318524445194,75.8116814755548,Housing
30556,67,30489,0.21926953789763057,99.78073046210237,Food
36684,3513,33171,9.576382073928688,90.42361792607132,Food
127893,17743,110150,13.873315975072911,86.12668402492709,Healthcare
25738,6200,19538,24.088895796099152,75.91110420390085,Food
18627,10006,8621,53.71772158694368,46.28227841305632,Housing
145037,7925,137112,5.4641229479374225,94.53587705206257,Healthcare
74406,38737,35669,52.06166169394941,47.93833830605059,Transportation
62412,19465,42947,31.187912580913927,68.81208741908608,Transportation
13585,9227,4358,67.9205005520795,32.0794994479205,Housing
10735,9867,868,91.91429902189101,8.085700978108989,Housing
192425,28984,163441,15.06249187995323,84.93750812004677,Entertainment
152422,43715,108707,28.680243009539307,71.31975699046069,Entertainment
121292,42448,78844,34.996537281931204,65.00346271806879,Healthcare
115101,32917,82184,28.598361439083934,71.40163856091607,Healthcare
39915,35228,4687,88.25754728798697,11.742452712013028,Food
128490,36820,91670,28.655926531247566,71.34407346875243,Healthcare
11300,6722,4578,59.48672566371681,40.51327433628318,Housing
47931,16779,31152,35.006571947174066,64.99342805282595,Food
44466,35398,9068,79.60689065803086,20.393109341969147,Food
21521,14889,6632,69.18358812322847,30.816411876771525,Housing
91937,17118,74819,18.61927189270914,81.38072810729086,Transportation
196625,9174,187451,4.665734265734265,95.33426573426573,Entertainment
22052,12640,9412,57.31906403047342,42.68093596952657,Housing
70062,47537,22525,67.84990437041478,32.15009562958522,Transportation
80566,37118,43448,46.071543827420996,53.92845617257901,Transportation
13132,2547,10585,19.39537008833384,80.60462991166617,Housing
139766,27289,112477,19.524777127484512,80.4752228725155,Healthcare
175320,16130,159190,9.200319415925165,90.79968058407484,Entertainment
21131,19493,1638,92.24835549666366,7.75164450333633,Housing
12662,6514,6148,51.4452693097457,48.5547306902543,Housing
158470,45167,113303,28.50192465450874,71.49807534549126,Entertainment
168303,700,167603,0.415916531493794,99.58408346850621,Entertainment
88165,23377,64788,26.51505699540634,73.48494300459366,Transportation
137571,22441,115130,16.312304192017212,83.68769580798279,Healthcare
33045,9615,23430,29.096686336813438,70.90331366318657,Food
50443,39744,10699,78.78992129730587,21.21007870269413,Transportation
34337,31225,3112,90.93689023502345,9.063109764976556,Food
44146,36203,7943,82.00742989172292,17.992570108277082,Food
78691,32833,45858,41.72395826714618,58.27604173285382,Transportation
82706,43909,38797,53.09046502067565,46.90953497932435,Transportation
159158,46019,113139,28.91403510976514,71.08596489023486,Entertainment
51659,12270,39389,23.75191157397549,76.24808842602451,Transportation
35687,2785,32902,7.803962227141536,92.19603777285846,Food
32207,20539,11668,63.77185083987953,36.22814916012047,Food
41664,27540,14124,66.10023041474655,33.89976958525346,Food
168940,46995,121945,27.817568367467736,72.18243163253226,Entertainment
11361,6583,4778,57.9438429715694,42.0561570284306,Housing
104430,4606,99824,4.410609977975677,95.58939002202432,Healthcare
135549,33895,101654,25.005717489616302,74.9942825103837,Healthcare
161139,35268,125871,21.886694096401243,78.11330590359876,Entertainment
11306,897,10409,7.933840438705113,92.0661595612949,Housing
95173,34346,60827,36.08796612484633,63.91203387515366,Transportation
56039,32031,24008,57.15840753760774,42.84159246239226,Transportation
137147,48231,88916,35.16737515220895,64.83262484779105,Healthcare
18558,14924,3634,80.41814850738226,19.581851492617737,Housing
31147,371,30776,1.1911259511349408,98.80887404886506,Food
129530,49911,79619,38.53238631977148,61.46761368022852,Healthcare
91030,13765,77265,15.121388553224213,84.87861144677579,Transportation
33807,31417,2390,92.93045818913242,7.069541810867571,Food
23166,19145,4021,82.64266597599931,17.35733402400069,Housing
22916,7083,15833,30.908535521033336,69.09146447896666,Housing
19425,1980,17445,10.193050193050194,89.8069498069498,Housing
50401,19239,31162,38.17186166941132,61.82813833058868,Transportation
99937,2696,97241,2.6976995507169517,97.30230044928305,Transportation
111051,2606,108445,2.34666954822559,97.65333045177441,Healthcare
184811,16741,168070,9.05844349091775,90.94155650908226,Entertainment
17654,16866,788,95.53642234054605,4.463577659453948,Housing
93549,29717,63832,31.766240152219694,68.2337598477803,Transportation
25787,4368,21419,16.93876759607554,83.06123240392445,Food
176914,3239,173675,1.830833060130911,98.16916693986909,Entertainment
20651,8230,12421,39.85279163236647,60.14720836763353,Housing
63408,45468,17940,71.70704012112036,28.292959878879635,Transportation
19260,17334,1926,90.0,10.0,Housing
110992,19561,91431,17.6237927057806,82.37620729421941,Healthcare
65800,26336,39464,40.02431610942249,59.9756838905775,Transportation
141610,22578,119032,15.94378928041805,84.05621071958194,Healthcare
14396,13035,1361,90.54598499583217,9.454015004167825,Housing
32611,11077,21534,33.96706632731287,66.03293367268714,Food
168259,25099,143160,14.916884089409779,85.08311591059022,Entertainment
39622,11334,28288,28.605320276614005,71.394679723386,Food
25329,13683,11646,54.02108255359469,45.978917446405305,Food
16680,5759,10921,34.52637889688249,65.47362110311751,Housing
170616,11164,159452,6.543348806676982,93.45665119332301,Entertainment
44939,12682,32257,28.220476646120296,71.77952335387971,Food
94046,10537,83509,11.204091614741722,88.79590838525829,Transportation
51510,23957,27553,46.5094156474471,53.49058435255291,Transportation
53748,13879,39869,25.822356180695095,74.1776438193049,Transportation
96711,16766,79945,17.33618719690625,82.66381280309375,Transportation
13124,1015,12109,7.733922584577872,92.26607741542213,Housing
122641,18318,104323,14.93627742761393,85.06372257238607,Healthcare
127495,40935,86560,32.10714145652771,67.89285854347229,Healthcare
86649,5932,80717,6.846010917610128,93.15398908238987,Transportation
35487,24327,11160,68.55186406289627,31.44813593710373,Food
148980,763,148217,0.5121492817827896,99.4878507182172,Healthcare
44334,33709,10625,76.03419497451166,23.965805025488336,Food
23226,1271,21955,5.4723155084818735,94.52768449151813,Housing
132696,11025,121671,8.308464460119371,91.69153553988063,Healthcare
17813,14671,3142,82.36119687868411,17.638803121315895,Housing
14838,2587,12251,17.43496428090039,82.56503571909961,Housing
160761,11584,149177,7.205727757354084,92.79427224264592,Entertainment
191042,38549,152493,20.178285403209763,79.82171459679024,Entertainment
39319,26026,13293,66.19191739362648,33.80808260637351,Food
197973,30083,167890,15.195506457951335,84.80449354204866,Entertainment
40139,3127,37012,7.790428261790279,92.20957173820972,Food
90613,22495,68118,24.825356185094854,75.17464381490515,Transportation
46690,30971,15719,66.33326194045834,33.66673805954166,Food
82113,28513,53600,34.72409971624469,65.27590028375532,Transportation
46360,43822,2538,94.52545297670406,5.474547023295945,Food
133298,25842,107456,19.386637458926614,80.61336254107339,Healthcare
108383,47774,60609,44.07886845723038,55.92113154276962,Healthcare
87246,18569,68677,21.283497237695713,78.71650276230429,Transportation
39467,27332,12135,69.25279347302809,30.747206526971897,Food
53217,14267,38950,26.809102354510777,73.19089764548923,Transportation
29658,23331,6327,78.66680153752782,21.333198462472183,Food
119484,43815,75669,36.67018178166114,63.329818218338865,Healthcare
139427,6336,133091,4.544313511730152,95.45568648826985,Healthcare
65038,1885,63153,2.8983056059534427,97.10169439404656,Transportation
85051,8744,76307,10.2808902893558,89.7191097106442,Transportation
191733,24198,167535,12.620675627043859,87.37932437295615,Entertainment
35402,7746,27656,21.88011976724479,78.11988023275521,Food
13374,4790,8584,35.81576192612532,64.18423807387468,Housing
28310,16929,11381,59.79865771812081,40.20134228187919,Food
157009,22315,134694,14.212561063378532,85.78743893662147,Entertainment
49919,41395,8524,82.92433742663114,17.07566257336886,Food
167222,25613,141609,15.316764540550883,84.68323545944911,Entertainment
29531,17065,12466,57.786732586095965,42.213267413904035,Food
147880,44732,103148,30.24885041925886,69.75114958074114,Healthcare
74162,39287,34875,52.974569186375774,47.02543081362423,Transportation
85815,16924,68891,19.721493911320863,80.27850608867914,Transportation
29962,9017,20945,30.09478672985782,69.90521327014217,Food
50052,16702,33350,33.36929593223048,66.63070406776951,Transportation
116168,23218,92950,19.98657117278424,80.01342882721576,Healthcare
106570,37981,68589,35.639485783991745,64.36051421600826,Healthcare
8988,4116,4872,45.794392523364486,54.20560747663551,Housing
41989,38553,3436,91.81690442735002,8.18309557264998,Food
145181,42773,102408,29.461844180712355,70.53815581928765,Healthcare
27077,21615,5462,79.82789821619825,20.17210178380175,Food
41822,10740,31082,25.680263975897855,74.31973602410214,Food
62675,16052,46623,25.61148783406462,74.38851216593538,Transportation
174120,49133,124987,28.217895704112106,71.78210429588789,Entertainment
38893,25502,13391,65.56963978093744,34.43036021906256,Food
25002,9225,15777,36.89704823614111,63.1029517638589,Food
77251,20229,57022,26.18606878875354,73.81393121124646,Transportation
32368,25854,6514,79.87518536826495,20.124814631735045,Food
106590,27459,79131,25.76132845482691,74.23867154517309,Healthcare
132270,31704,100566,23.969154003175323,76.03084599682468,Healthcare
156110,42677,113433,27.33777464608289,72.66222535391711,Entertainment
66800,9663,57137,14.465568862275449,85.53443113772455,Transportation
149158,8382,140776,5.619544375762614,94.38045562423738,Healthcare
87922,7035,80887,8.001410340984053,91.99858965901595,Transportation
51778,24014,27764,46.378770906562636,53.62122909343737,Transportation
90139,13854,76285,15.369595846414983,84.63040415358502,Transportation
23114,1517,21597,6.563121917452626,93.43687808254737,Housing
160188,47084,113104,29.39296326815991,70.60703673184008,Entertainment
164796,32632,132164,19.801451491541055,80.19854850845894,Entertainment
124648,45325,79323,36.36239650856813,63.63760349143187,Healthcare
16397,12327,4070,75.17838629017504,24.82161370982497,Housing
133217,5008,128209,3.759279971775374,96.24072002822463,Healthcare
21919,3810,18109,17.382179843970984,82.61782015602903,Housing
40512,10570,29942,26.09103475513428,73.90896524486573,Food
173124,14281,158843,8.249000716249624,91.75099928375037,Entertainment
13560,4289,9271,31.629793510324482,68.37020648967551,Housing
73297,23616,49681,32.21959971076579,67.78040028923421,Transportation
170710,44840,125870,26.26676820338586,73.73323179661413,Entertainment
103239,43175,60064,41.8204360755141,58.1795639244859,Healthcare
51807,5664,46143,10.932885517401123,89.06711448259887,Transportation
9802,8155,1647,83.19730667210773,16.802693327892268,Housing
12276,7997,4279,65.14336917562724,34.85663082437276,Housing
176202,6833,169369,3.8779355512423246,96.12206444875767,Entertainment
87123,20622,66501,23.669983815984295,76.3300161840157,Transportation
9589,8851,738,92.3036813014913,7.696318698508708,Housing
174724,12943,161781,7.407682974290881,92.59231702570912,Entertainment
28787,21650,7137,75.20755896758953,24.792441032410466,Food
16811,6474,10337,38.510499077984655,61.48950092201535,Housing
197716,46729,150987,23.634404904003723,76.36559509599627,Entertainment
28983,12515,16468,43.180485111962184,56.819514888037816,Food
72516,26962,45554,37.18076010811407,62.81923989188593,Transportation
103536,18677,84859,18.039136145881628,81.96086385411837,Healthcare
194943,23035,171908,11.816274500751502,88.1837254992485,Entertainment
26738,9096,17642,34.01899917720099,65.981000822799,Food
46470,12886,33584,27.729718097697436,72.27028190230256,Food
74313,14080,60233,18.946886816573144,81.05311318342686,Transportation
82874,35969,46905,43.40203200038613,56.59796799961387,Transportation
176836,27725,149111,15.678368657965573,84.32163134203444,Entertainment
166209,35178,131031,21.164918867209355,78.83508113279063,Entertainment
30496,28481,2015,93.39257607555089,6.607423924449109,Food
25919,11445,14474,44.15679617269185,55.84320382730815,Food
45362,19053,26309,42.00211630880473,57.99788369119527,Food
177186,6105,171081,3.4455318140259386,96.55446818597406,Entertainment
79496,17675,61821,22.23382308543826,77.76617691456174,Transportation
44038,27052,16986,61.42876606567056,38.57123393432944,Food
49761,20947,28814,42.09521512831334,57.904784871686665,Food
18627,8792,9835,47.20030063885757,52.79969936114243,Housing
27581,7257,20324,26.3115913128603,73.6884086871397,Food
78901,14126,64775,17.903448625492707,82.0965513745073,Transportation
189764,20551,169213,10.829767500685062,89.17023249931493,Entertainment
138382,20014,118368,14.462863667239958,85.53713633276004,Healthcare
82346,13895,68451,16.873922230588008,83.12607776941199,Transportation
152754,31941,120813,20.91009073412153,79.08990926587846,Entertainment
11568,9847,1721,85.12275242047026,14.877247579529737,Housing
118169,26863,91306,22.732696392454873,77.26730360754513,Healthcare
31929,5368,26561,16.812302295718627,83.18769770428138,Food
24999,5944,19055,23.776951078043123,76.22304892195689,Housing
13185,5776,7409,43.80735684489951,56.1926431551005,Housing
118062,45101,72961,38.201114668563974,61.798885331436026,Healthcare
136720,47445,89275,34.70231129315389,65.29768870684612,Healthcare
46098,10374,35724,22.504230118443317,77.49576988155668,Food
16461,2014,14447,12.234979648867018,87.76502035113299,Housing
21065,14114,6951,67.00213624495609,32.99786375504391,Housing
66079,23383,42696,35.386431392726884,64.61356860727311,Transportation
70947,598,70349,0.8428827152663255,99.15711728473367,Transportation
132369,22995,109374,17.371892210411804,82.6281077895882,Healthcare
179799,4681,175118,2.6034627556326786,97.39653724436732,Entertainment
27918,22115,5803,79.21412708646751,20.785872913532486,Food
39901,22884,17017,57.35194606651463,42.64805393348537,Food
23200,4697,18503,20.245689655172413,79.75431034482759,Housing
182960,49192,133768,26.88675120244862,73.11324879755138,Entertainment
117350,30692,86658,26.154239454622925,73.84576054537708,Healthcare
149902,13580,136322,9.059252044669183,90.94074795533082,Healthcare
20260,9130,11130,45.06416584402764,54.935834155972366,Housing
49943,19281,30662,38.6060108523717,61.39398914762829,Food
44739,10703,34036,23.923198998636536,76.07680100136346,Food
146242,20599,125643,14.08555681678314,85.91444318321686,Healthcare
172736,34461,138275,19.950097258243794,80.04990274175621,Entertainment
12583,5946,6637,47.25423190018279,52.74576809981721,Housing
98885,6050,92835,6.1182181321737374,93.88178186782626,Transportation
178402,10249,168153,5.7448907523458255,94.25510924765418,Entertainment
187500,36641,150859,19.541866666666667,80.45813333333334,Entertainment
14082,634,13448,4.502201391847748,95.49779860815225,Housing
24048,17506,6542,72.79607451763141,27.203925482368597,Housing
38969,25538,13431,65.53414252354436,34.465857476455646,Food
24220,15934,8286,65.78860445912468,34.21139554087531,Housing
150793,39695,111098,26.324166241138514,73.67583375886149,Entertainment
109336,42819,66517,39.162764322821396,60.837235677178604,Healthcare
60007,42701,17306,71.1600313296782,28.8399686703218,Transportation
65927,48268,17659,73.21431280052178,26.785687199478208,Transportation
45585,34765,10820,76.26412196994625,23.735878030053744,Food
136808,34072,102736,24.904976317174434,75.09502368282557,Healthcare
170070,24400,145670,14.347033574410537,85.65296642558945,Entertainment
17083,5574,11509,32.62892934496283,67.37107065503717,Housing
151980,21305,130675,14.018291880510594,85.98170811948941,Entertainment
8302,638,7664,7.684895205974464,92.31510479402554,Housing
38668,2776,35892,7.179062790938244,92.82093720906175,Food
173405,7120,166285,4.105994636832848,95.89400536316715,Entertainment
138916,11588,127328,8.341731693973337,91.65826830602667,Healthcare
134618,13587,121031,10.093003907352657,89.90699609264735,Healthcare
19130,7651,11479,39.994772608468374,60.005227391531626,Housing
26185,25322,863,96.70421997326713,3.295780026732862,Food
154993,23354,131639,15.067777254456653,84.93222274554336,Entertainment
113124,3811,109313,3.3688695590679254,96.63113044093208,Healthcare
147456,17952,129504,12.174479166666668,87.82552083333334,Healthcare
35892,34629,1263,96.48110999665663,3.518890003343363,Food
149758,25957,123801,17.33262997636186,82.66737002363813,Healthcare
75558,7737,67821,10.239815770666242,89.76018422933376,Transportation
181953,5620,176333,3.0887097217413286,96.91129027825866,Entertainment
11701,2780,8921,23.75865310657209,76.2413468934279,Housing
24462,8080,16382,33.03082331779903,66.96917668220095,Housing
38148,11397,26751,29.875747090279965,70.12425290972004,Food
112205,7394,104811,6.589724165589769,93.41027583441023,Healthcare
90078,14379,75699,15.962832212082862,84.03716778791713,Transportation
166149,21009,145140,12.644674358557682,87.35532564144232,Entertainment
13997,6354,7643,45.39544188040294,54.60455811959706,Housing
124919,7207,117712,5.7693385313683265,94.23066146863167,Healthcare
176105,13509,162596,7.670991737883649,92.32900826211635,Entertainment
65927,31218,34709,47.35237459614422,52.64762540385578,Transportation
73764,40048,33716,54.292066590748874,45.707933409251126,Transportation
75369,11650,63719,15.457283498520614,84.54271650147939,Transportation
10451,628,9823,6.008994354607214,93.99100564539279,Housing
136914,31848,105066,23.26131732328323,76.73868267671678,Healthcare
45120,29505,15615,65.39228723404256,34.60771276595745,Food
45597,23345,22252,51.198543763844114,48.801456236155886,Food
30418,22388,8030,73.60115720954697,26.39884279045302,Food
21527,2454,19073,11.399637664328518,88.60036233567148,Housing
120928,24398,96530,20.175641704154536,79.82435829584547,Healthcare
159755,25688,134067,16.079621921066632,83.92037807893337,Entertainment
179270,49264,130006,27.480336921961285,72.5196630780387,Entertainment
75497,30936,44561,40.97646264089963,59.02353735910037,Transportation
19338,412,18926,2.1305202192574204,97.86947978074258,Housing
45751,32890,12861,71.88913903521235,28.110860964787655,Food
115116,9843,105273,8.550505576983216,91.44949442301679,Healthcare
198709,43614,155095,21.94867872114499,78.05132127885501,Entertainment
19483,17630,1853,90.48914438228199,9.51085561771801,Housing
26210,5153,21057,19.66043494849294,80.33956505150705,Food
56896,23958,32938,42.10840832395951,57.8915916760405,Transportation
27972,2017,25955,7.210782210782211,92.78921778921779,Food
135327,5079,130248,3.7531313041743335,96.24686869582567,Healthcare
9556,7570,1986,79.21724570950188,20.78275429049812,Housing
8145,5010,3135,61.51012891344383,38.48987108655617,Housing
102341,26179,76162,25.58016826100976,74.41983173899024,Healthcare
130105,44052,86053,33.858806348718346,66.14119365128165,Healthcare
64295,3621,60674,5.631853176763356,94.36814682323664,Transportation
44938,12632,32306,28.109840224309046,71.89015977569096,Food
12458,5307,7151,42.5991330871729,57.4008669128271,Housing
136552,28088,108464,20.569453395043645,79.43054660495635,Healthcare
25337,10165,15172,40.11919327465762,59.88080672534238,Food
58211,2759,55452,4.739654017281957,95.26034598271804,Transportation
37183,33066,4117,88.92773579323885,11.072264206761155,Food
188293,5250,183043,2.7882077400646863,97.21179225993531,Entertainment
43828,14419,29409,32.89905996166834,67.10094003833166,Food
23848,2352,21496,9.862462260986247,90.13753773901375,Housing
23740,3173,20567,13.365627632687445,86.63437236731255,Housing
46812,39779,7033,84.9760745108092,15.023925489190807,Food
159389,41756,117633,26.197541862989294,73.8024581370107,Entertainment
132940,12818,120122,9.641943734015346,90.35805626598466,Healthcare
88704,17107,71597,19.285488816738816,80.71451118326118,Transportation
115798,32806,82992,28.33036840014508,71.66963159985492,Healthcare
65121,23147,41974,35.54460158781346,64.45539841218655,Transportation
96515,33979,62536,35.20592653991608,64.79407346008392,Transportation
152382,16489,135893,10.820831856780986,89.17916814321902,Entertainment
41231,4792,36439,11.622323009386141,88.37767699061386,Food
120176,39174,81002,32.59719078684596,67.40280921315403,Healthcare
11911,9905,2006,83.1584249853077,16.8415750146923,Housing
37862,33434,4428,88.30489673023084,11.695103269769163,Food
24282,23624,658,97.29017379128572,2.709826208714274,Housing
38845,4175,34670,10.7478439953662,89.2521560046338,Food
34159,20651,13508,60.4555168476829,39.544483152317106,Food
49849,9221,40628,18.497863547914704,81.5021364520853,Food
131818,49598,82220,37.626120863614986,62.373879136385014,Healthcare
138974,4395,134579,3.16246204325989,96.8375379567401,Healthcare
26463,21905,4558,82.77595132826966,17.22404867173034,Food
16016,2384,13632,14.885114885114886,85.11488511488511,Housing
71976,14706,57270,20.43181060353451,79.5681893964655,Transportation
153761,36884,116877,23.98787729008006,76.01212270991994,Entertainment
38205,7099,31106,18.58133752126685,81.41866247873315,Food
123383,14235,109148,11.537245811821725,88.46275418817827,Healthcare
49151,18748,30403,38.1436796809831,61.85632031901691,Food
34266,5454,28812,15.91665207494309,84.08334792505691,Food
76247,12807,63440,16.796726428580797,83.2032735714192,Transportation
12644,8503,4141,67.24928819993673,32.75071180006327,Housing
146310,7274,139036,4.971635568313855,95.02836443168614,Healthcare
23515,4009,19506,17.048692324048478,82.95130767595153,Housing
21537,13269,8268,61.61025212425129,38.38974787574871,Housing
178950,43847,135103,24.502374965074043,75.49762503492595,Entertainment
108622,10547,98075,9.709819373607557,90.29018062639244,Healthcare
8025,7192,833,89.61993769470405,10.38006230529595,Housing
191771,22300,169471,11.628452685755407,88.3715473142446,Entertainment
144428,32021,112407,22.170908688066028,77.82909131193398,Healthcare
38123,6794,31329,17.821262754767464,82.17873724523254,Food
62664,25318,37346,40.40278309715307,59.59721690284693,Transportation
13390,6635,6755,49.55190440627334,50.44809559372666,Housing
23708,11271,12437,47.54091445925426,52.45908554074574,Housing
44349,35289,9060,79.57112899952648,20.428871000473517,Food
127216,36657,90559,28.814771726826816,71.18522827317318,Healthcare
119172,20593,98579,17.280065787265464,82.71993421273453,Healthcare
195792,47594,148198,24.308449783443656,75.69155021655635,Entertainment
138879,6955,131924,5.007956566507535,94.99204343349247,Healthcare
116127,39520,76607,34.031706665977765,65.96829333402223,Healthcare
103492,46126,57366,44.56962857032428,55.43037142967573,Healthcare
103200,38038,65162,36.85852713178295,63.14147286821705,Healthcare
49399,17706,31693,35.84283082653495,64.15716917346505,Food
71687,11662,60025,16.267942583732058,83.73205741626795,Transportation
110754,5984,104770,5.402965129927587,94.59703487007242,Healthcare
62056,38157,23899,61.48801082892871,38.51198917107129,Transportation
13776,3676,10100,26.684088269454122,73.31591173054588,Housing
136374,46052,90322,33.768900230249166,66.23109976975084,Healthcare
179815,18075,161740,10.051997886716904,89.9480021132831,Entertainment
178364,12057,166307,6.759772151330987,93.24022784866901,Entertainment
155718,12282,143436,7.887334797518592,92.11266520248141,Entertainment
11380,8711,2669,76.54657293497364,23.45342706502636,Housing
192617,8793,183824,4.565017625650903,95.4349823743491,Entertainment
24013,22499,1514,93.69508183067505,6.304918169324949,Housing
161353,5530,155823,3.4272681635916284,96.57273183640838,Entertainment
120389,17715,102674,14.714799524873534,85.28520047512646,Healthcare
70570,41679,28891,59.06050729771858,40.93949270228142,Transportation
14059,8884,5175,63.19083860872039,36.80916139127961,Housing
46745,33122,13623,70.85677612578885,29.143223874211145,Food
79402,35029,44373,44.11601722878517,55.88398277121483,Transportation
61198,13050,48148,21.324226281904636,78.67577371809537,Transportation
174510,42095,132415,24.121826829408057,75.87817317059195,Entertainment
167098,14096,153002,8.43576823181606,91.56423176818393,Entertainment
120210,20977,99233,17.450295316529406,82.5497046834706,Healthcare
24281,15305,8976,63.03282401878012,36.96717598121989,Housing
177113,4321,172792,2.4396853985873426,97.56031460141266,Entertainment
101077,7235,93842,7.157909316659576,92.84209068334043,Healthcare
12719,12027,692,94.559320701313,5.440679298687004,Housing
14941,9550,5391,63.91807777257211,36.08192222742788,Housing
98320,17145,81175,17.437957689178194,82.56204231082181,Transportation
77752,24278,53474,31.22492025928593,68.77507974071406,Transportation
45117,18667,26450,41.37464813706585,58.62535186293415,Food
14254,760,13494,5.3318366774238815,94.66816332257612,Housing
159908,39374,120534,24.622908172199015,75.377091827801,Entertainment
38273,29523,8750,77.13793013351449,22.862069866485513,Food
72996,26784,46212,36.692421502548086,63.307578497451914,Transportation
146816,17946,128870,12.223463382737576,87.77653661726242,Healthcare
22512,13923,8589,61.84701492537313,38.15298507462687,Housing
85887,23764,62123,27.66891380534889,72.3310861946511,Transportation
58681,1485,57196,2.5306317206591573,97.46936827934084,Transportation
144346,27894,116452,19.32440109182104,80.67559890817896,Healthcare
40180,25553,14627,63.59631657541065,36.40368342458935,Food
37852,19539,18313,51.619465285850154,48.380534714149846,Food
119756,2093,117663,1.7477203647416413,98.25227963525836,Healthcare
116509,45592,70917,39.131740895553136,60.868259104446864,Healthcare
85913,19971,65942,23.245608929964035,76.75439107003596,Transportation
159498,29040,130458,18.20712485423015,81.79287514576986,Entertainment
17764,9959,7805,56.06282368835848,43.93717631164152,Housing
44178,23718,20460,53.68735569740595,46.31264430259405,Food
28086,19888,8198,70.81108025350709,29.188919746492914,Food
173482,48355,125127,27.873208747881623,72.12679125211837,Entertainment
8955,6295,2660,70.29592406476829,29.704075935231717,Housing
124816,45612,79204,36.543391872836814,63.456608127163186,Healthcare
19556,11563,7993,59.12763346287584,40.87236653712416,Housing
190417,7894,182523,4.1456382570883905,95.8543617429116,Entertainment
18412,15686,2726,85.19443840973278,14.805561590267216,Housing
68067,45371,22696,66.65638268176943,33.34361731823057,Transportation
30520,23769,6751,77.88007863695937,22.11992136304063,Food
138414,30279,108135,21.875677315878452,78.12432268412155,Healthcare
152403,36324,116079,23.83417649258873,76.16582350741126,Entertainment
139370,20843,118527,14.955155341895674,85.04484465810432,Healthcare
21675,18888,2787,87.14186851211073,12.858131487889274,Housing
21324,18108,3216,84.91840180078785,15.081598199212154,Housing
46752,16453,30299,35.19207734428474,64.80792265571526,Food
15041,2060,12981,13.695897879130378,86.30410212086962,Housing
85283,36737,48546,43.07658032667706,56.92341967332294,Transportation
28115,26502,1613,94.2628490129824,5.737150987017606,Food
44230,9673,34557,21.869771648202576,78.13022835179743,Food
118243,4781,113462,4.043368317786253,95.95663168221374,Healthcare
166121,22740,143381,13.688817187471782,86.31118281252822,Entertainment
148352,33741,114611,22.743879421915445,77.25612057808455,Healthcare
127409,44528,82881,34.94886546476309,65.05113453523691,Healthcare
38908,19942,18966,51.254240773105785,48.745759226894215,Food
68297,32244,36053,47.21144413371012,52.788555866289876,Transportation
163488,11848,151640,7.2470150714425525,92.75298492855745,Entertainment
192279,46994,145285,24.44052652655776,75.55947347344224,Entertainment
66219,43220,22999,65.26827647653997,34.73172352346003,Transportation
8717,4434,4283,50.86612366639899,49.13387633360101,Housing
87086,45403,41683,52.13581976437085,47.86418023562915,Transportation
21395,3765,17630,17.59756952559009,82.40243047440991,Housing
118643,41326,77317,34.83222777576427,65.16777222423573,Healthcare
78507,17715,60792,22.564866827161907,77.43513317283809,Transportation
29621,28455,1166,96.06360352452651,3.9363964754734817,Food
110846,36059,74787,32.53071829384913,67.46928170615088,Healthcare
28374,10335,18039,36.42419116092197,63.57580883907803,Food
17944,2610,15334,14.545251894783773,85.45474810521623,Housing
65864,12561,53303,19.071116239523867,80.92888376047614,Transportation
111641,26437,85204,23.68036832346539,76.3196316765346,Healthcare
121636,26957,94679,22.162024400670855,77.83797559932914,Healthcare
144467,48657,95810,33.68035606747562,66.31964393252439,Healthcare
192494,2674,189820,1.389134206780471,98.61086579321953,Entertainment
153045,11480,141565,7.501061779215264,92.49893822078474,Entertainment
115124,12877,102247,11.185330600048642,88.81466939995136,Healthcare
193153,49104,144049,25.42233359046973,74.57766640953027,Entertainment
151294,22443,128851,14.834031752746307,85.16596824725369,Entertainment
46783,41168,5615,87.99777697026697,12.002223029733022,Food
135199,28687,106512,21.21835220674709,78.7816477932529,Healthcare
37317,35187,2130,94.29214567087386,5.707854329126135,Food
96372,42705,53667,44.3126634292118,55.68733657078819,Transportation
134863,30755,104108,22.80462395171396,77.19537604828604,Healthcare
122192,33092,89100,27.081969359696217,72.91803064030378,Healthcare
14917,3144,11773,21.076623986056177,78.92337601394382,Housing
14573,984,13589,6.752212996637617,93.24778700336238,Housing
18167,10554,7613,58.09434689271756,41.90565310728244,Housing
173325,47198,126127,27.230924563680947,72.76907543631906,Entertainment
28141,7996,20145,28.41405778046267,71.58594221953733,Food
192917,9967,182950,5.166470554694506,94.8335294453055,Entertainment
144838,6565,138273,4.532650271337632,95.46734972866237,Healthcare
173488,10404,163084,5.9969565618371306,94.00304343816288,Entertainment
34590,14116,20474,40.80948250939578,59.19051749060422,Food
34187,24183,10004,70.7374148067979,29.262585193202096,Food
60132,788,59344,1.310450342579658,98.68954965742034,Transportation
82215,27398,54817,33.32481907194551,66.67518092805449,Transportation
30477,13853,16624,45.45394887948289,54.54605112051711,Food
129050,9815,119235,7.605579232855482,92.39442076714451,Healthcare
135025,23996,111029,17.771523791890388,82.22847620810961,Healthcare
37459,28666,8793,76.52633546010304,23.473664539896955,Food
13463,4912,8551,36.48518160885389,63.5148183911461,Housing
151907,25534,126373,16.80896864528955,83.19103135471045,Entertainment
33081,21902,11179,66.20718841631148,33.79281158368852,Food
48381,35525,12856,73.42758520906968,26.572414790930328,Food
67301,17182,50119,25.53008127665265,74.46991872334735,Transportation
174244,42177,132067,24.205711530956588,75.79428846904341,Entertainment
21635,9168,12467,42.37577998613358,57.62422001386642,Housing
159361,32692,126669,20.514429502826914,79.48557049717309,Entertainment
152554,15489,137065,10.153126106165686,89.84687389383431,Entertainment
21392,20392,1000,95.32535527299926,4.674644727000747,Housing
26479,6396,20083,24.15499074738472,75.84500925261528,Food
151359,25614,125745,16.922680514538282,83.07731948546171,Entertainment
34245,2509,31736,7.326617024383121,92.67338297561687,Food
33663,1987,31676,5.9026230579568075,94.0973769420432,Food
15804,6565,9239,41.54011642622121,58.45988357377879,Housing
24701,2396,22305,9.700012145257277,90.29998785474272,Housing
150638,24616,126022,16.341162256535537,83.65883774346446,Entertainment
39017,25022,13995,64.13101981187688,35.86898018812313,Food
113325,21143,92182,18.656960070593424,81.34303992940657,Healthcare
48024,39148,8876,81.5175745460603,18.482425453939697,Food
51755,26745,25010,51.676166553956136,48.323833446043864,Transportation
157260,45168,112092,28.7218618847768,71.2781381152232,Entertainment
70720,24665,46055,34.87697963800905,65.12302036199095,Transportation
93240,25032,68208,26.846846846846844,73.15315315315316,Transportation
142312,3980,138332,2.7966721007364104,97.2033278992636,Healthcare
20676,10816,9860,52.31185916037918,47.68814083962082,Housing
98280,24386,73894,24.812779812779812,75.18722018722018,Transportation
165016,25568,139448,15.494255102535512,84.50574489746448,Entertainment
187633,46235,141398,24.6411878507512,75.3588121492488,Entertainment
9673,6708,2965,69.34766876873772,30.652331231262274,Housing
165008,30951,134057,18.75727237467274,81.24272762532726,Entertainment
47544,46577,967,97.9660945650345,2.0339054349655057,Food
19555,13081,6474,66.89337765277422,33.10662234722577,Housing
134011,25717,108294,19.190215728559597,80.80978427144039,Healthcare
22295,10682,11613,47.91208791208791,52.087912087912095,Housing
33369,15577,17792,46.6810512751356,53.31894872486439,Food
160758,41258,119500,25.66466365593003,74.33533634406997,Entertainment
22716,15795,6921,69.5324881141046,30.467511885895405,Housing
137688,26943,110745,19.56815408750218,80.43184591249782,Healthcare
129490,43832,85658,33.849718124951735,66.15028187504826,Healthcare
121349,34296,87053,28.262284814872807,71.7377151851272,Healthcare
26174,8624,17550,32.94872774509055,67.05127225490945,Food
162607,32743,129864,20.136279495962658,79.86372050403733,Entertainment
37874,22990,14884,60.7012726408618,39.2987273591382,Food
177730,37944,139786,21.349237607607044,78.65076239239296,Entertainment
133263,947,132316,0.7106248546108072,99.28937514538919,Healthcare
30510,5074,25436,16.630612913798753,83.36938708620124,Food
187205,42240,144965,22.563499906519592,77.4365000934804,Entertainment
127279,8272,119007,6.499108258235845,93.50089174176416,Healthcare
36155,29412,6743,81.34974415710137,18.65025584289863,Food
170114,30566,139548,17.967950903511763,82.03204909648824,Entertainment
111219,6055,105164,5.444213668527859,94.55578633147213,Healthcare
14256,9398,4858,65.92312008978676,34.07687991021324,Housing
53677,45785,7892,85.29724090392533,14.702759096074669,Transportation
128544,24789,103755,19.284447348767735,80.71555265123226,Healthcare
17832,12504,5328,70.12113055181696,29.878869448183043,Housing
8475,5416,3059,63.90560471976401,36.094395280235986,Housing
76144,25705,50439,33.75840512712755,66.24159487287245,Transportation
154354,7832,146522,5.074050559104396,94.92594944089561,Entertainment
25315,11737,13578,46.363815919415366,53.636184080584634,Food
81213,42684,38529,52.55808799083891,47.44191200916109,Transportation
191496,24930,166566,13.018548690312068,86.98145130968793,Entertainment
86158,5914,80244,6.864133336428423,93.13586666357158,Transportation
17686,14109,3577,79.77496324776659,20.225036752233404,Housing
136573,2368,134205,1.73387126298756,98.26612873701244,Healthcare
70733,20774,49959,29.369601176254367,70.63039882374564,Transportation
8846,6316,2530,71.39950260004522,28.600497399954783,Housing
61318,21534,39784,35.11856224925797,64.88143775074204,Transportation
172870,34421,138449,19.911494186382832,80.08850581361718,Entertainment
181857,49949,131908,27.466085990640998,72.533914009359,Entertainment
61472,28460,33012,46.29750130140552,53.70249869859448,Transportation
163571,29605,133966,18.099174058971336,81.90082594102867,Entertainment
32679,31521,1158,96.45643991554209,3.5435600844579085,Food
8193,2007,6186,24.49652142072501,75.503478579275,Housing
85008,10559,74449,12.421183888575193,87.5788161114248,Transportation
10336,9879,457,95.57856037151703,4.421439628482972,Housing
96413,43876,52537,45.508385798595626,54.49161420140437,Transportation
116569,30436,86133,26.109857680858546,73.89014231914145,Healthcare
9519,5777,3742,60.68914801974997,39.31085198025003,Housing
92049,12577,79472,13.663374941607188,86.33662505839281,Transportation
47419,34314,13105,72.36339863767688,27.63660136232312,Food
38866,495,38371,1.2736067514022538,98.72639324859774,Food
9678,3242,6436,33.498656747261826,66.50134325273817,Housing
47314,39560,7754,83.61161601217398,16.388383987826014,Food
60721,38641,22080,63.63696250061758,36.36303749938242,Transportation
101886,1049,100837,1.0295820819347112,98.9704179180653,Healthcare
114480,25465,89015,22.24406009783368,77.75593990216632,Healthcare
95785,40769,55016,42.56303178994623,57.43696821005376,Transportation
71943,38712,33231,53.80926566865435,46.19073433134565,Transportation
106999,10129,96870,9.466443611622537,90.53355638837746,Healthcare
20048,4138,15910,20.640462889066242,79.35953711093376,Housing
96195,5113,91082,5.315245075107853,94.68475492489215,Transportation
90970,36912,54058,40.57601407057272,59.42398592942728,Transportation
108392,19324,89068,17.827883976677246,82.17211602332274,Healthcare
9435,571,8864,6.051934287228405,93.9480657127716,Housing
40865,21576,19289,52.79823810106448,47.201761898935516,Food
41485,22259,19226,53.65553814631795,46.344461853682056,Food
117007,9671,107336,8.265317459639167,91.73468254036084,Healthcare
192321,11301,181020,5.876113372954592,94.12388662704541,Entertainment
29759,17010,12749,57.15917873584462,42.84082126415538,Food
99079,25017,74062,25.249548340213362,74.75045165978663,Transportation
48465,30232,18233,62.37903641803363,37.620963581966365,Food
44481,1609,42872,3.617274791484004,96.38272520851599,Food
27114,1044,26070,3.8504093826067716,96.14959061739323,Food
140364,4920,135444,3.5051722663930924,96.4948277336069,Healthcare
69872,23767,46105,34.015056102587586,65.9849438974124,Transportation
53689,23869,29820,44.457896403360095,55.542103596639905,Transportation
10989,9218,1771,83.88388388388388,16.116116116116117,Housing
83308,10974,72334,13.172804532577903,86.82719546742209,Transportation
62110,45802,16308,73.74335855739817,26.256641442601836,Transportation
53500,31587,21913,59.0411214953271,40.958878504672896,Transportation
153899,17219,136680,11.188506747932085,88.81149325206792,Entertainment
49466,17285,32181,34.94319330449198,65.05680669550803,Food
34879,10377,24502,29.751426359700677,70.24857364029931,Food
176109,5691,170418,3.2315213873226245,96.76847861267738,Entertainment
73985,5167,68818,6.983848077312969,93.01615192268703,Transportation
115306,43561,71745,37.77860649055557,62.22139350944443,Healthcare
156449,39605,116844,25.314958868385222,74.68504113161477,Entertainment
50563,43498,7065,86.02733223898899,13.972667761011015,Transportation
188998,25433,163565,13.456756156149801,86.5432438438502,Entertainment
188007,28029,159978,14.908487449935375,85.09151255006464,Entertainment
98921,46766,52155,47.27610921846726,52.72389078153273,Transportation
10591,7183,3408,67.82173543574733,32.178264564252665,Housing
197131,17504,179627,8.879374629053777,91.12062537094623,Entertainment
32024,29134,2890,90.97551836122908,9.024481638770922,Food
35849,13255,22594,36.97453206505063,63.025467934949376,Food
31381,615,30766,1.959784583027947,98.04021541697206,Food
139111,49043,90068,35.25458087426587,64.74541912573413,Healthcare
43287,12205,31082,28.19553214590986,71.80446785409013,Food
171619,20530,151089,11.962544939662857,88.03745506033714,Entertainment
147654,16740,130914,11.33731561623796,88.66268438376204,Healthcare
60973,48136,12837,78.9464189067292,21.053581093270793,Transportation
192827,41164,151663,21.347632852245795,78.6523671477542,Entertainment
12494,8056,4438,64.47894989595005,35.52105010404995,Housing
32083,4002,28081,12.473895832683976,87.52610416731602,Food
90819,5947,84872,6.548189255552252,93.45181074444776,Transportation
39445,6784,32661,17.19863100519711,82.8013689948029,Food
25157,8926,16231,35.481178200898356,64.51882179910164,Food
16946,12732,4214,75.13277469609348,24.867225303906526,Housing
132100,5644,126456,4.272520817562453,95.72747918243755,Healthcare
51116,4578,46538,8.95609985131857,91.04390014868143,Transportation
87382,24811,62571,28.393719530338057,71.60628046966194,Transportation
8204,581,7623,7.081911262798634,92.91808873720136,Housing
84490,17733,66757,20.988282636998463,79.01171736300154,Transportation
61540,46761,14779,75.98472538186546,24.015274618134548,Transportation
23328,827,22501,3.5450960219478738,96.45490397805213,Housing
32868,28229,4639,85.88596811488378,14.114031885116221,Food
58000,7219,50781,12.446551724137931,87.55344827586207,Transportation
41460,20710,20750,49.95176073323685,50.04823926676315,Food
137998,40724,97274,29.510572616994452,70.48942738300555,Healthcare
97014,15754,81260,16.23889335559816,83.76110664440183,Transportation
70715,40631,30084,57.45739942020788,42.54260057979212,Transportation
121581,10169,111412,8.363971344206742,91.63602865579325,Healthcare
30630,27710,2920,90.46686255305256,9.533137446947437,Food
46165,14414,31751,31.222787826275315,68.77721217372468,Food
123508,38921,84587,31.512938433137933,68.48706156686207,Healthcare
144530,46322,98208,32.05009340621324,67.94990659378676,Healthcare
20115,6294,13821,31.290082028337064,68.70991797166293,Housing
123491,40087,83404,32.4614749252982,67.53852507470181,Healthcare
109322,14432,94890,13.201368434532847,86.79863156546716,Healthcare
44042,29098,14944,66.06875255437991,33.93124744562009,Food
74883,17502,57381,23.372461039221186,76.62753896077882,Transportation
190281,23289,166992,12.239267189051981,87.76073281094801,Entertainment
151557,43918,107639,28.977876310563023,71.02212368943698,Entertainment
46576,43113,3463,92.56484026107866,7.4351597389213335,Food
144154,41277,102877,28.63396090292326,71.36603909707674,Healthcare
29733,1017,28716,3.420441933205529,96.57955806679446,Food
18555,10253,8302,55.257343034222586,44.742656965777414,Housing
9925,2972,6953,29.944584382871536,70.05541561712846,Housing
138256,47889,90367,34.63791806503877,65.36208193496124,Healthcare
199747,13105,186642,6.560799411255237,93.43920058874477,Entertainment
30022,21119,8903,70.34508027446539,29.654919725534608,Food
51056,10046,41010,19.676433719837043,80.32356628016296,Transportation
24300,8770,15530,36.090534979423865,63.90946502057613,Housing
28023,11675,16348,41.66220604503443,58.33779395496557,Food
17374,2667,14707,15.350523771152297,84.6494762288477,Housing
12857,340,12517,2.644473827486972,97.35552617251302,Housing
10967,2786,8181,25.40348317680314,74.59651682319686,Housing
76092,14179,61913,18.634021973400618,81.36597802659938,Transportation
120103,38893,81210,32.38303789247563,67.61696210752437,Healthcare
94649,28549,66100,30.163023381123942,69.83697661887605,Transportation
17013,16838,175,98.97137483101159,1.0286251689884207,Housing
18451,10278,8173,55.70429787003415,44.29570212996586,Housing
131747,19930,111817,15.127479183586722,84.87252081641327,Healthcare
129614,28484,101130,21.97602110883084,78.02397889116916,Healthcare
20391,4172,16219,20.460006865774115,79.53999313422588,Housing
15162,10626,4536,70.08310249307479,29.916897506925206,Housing
42200,39434,2766,93.44549763033176,6.554502369668247,Food
192876,12942,179934,6.710010576743606,93.28998942325639,Entertainment
155838,15032,140806,9.645914346950038,90.35408565304996,Entertainment
13693,767,12926,5.6014021762944575,94.39859782370554,Housing
121355,6344,115011,5.227637921799679,94.77236207820032,Healthcare
18640,6731,11909,36.11051502145923,63.889484978540764,Housing
142408,13338,129070,9.366046851300489,90.6339531486995,Healthcare
149295,21446,127849,14.36484811949496,85.63515188050505,Healthcare
149145,11279,137866,7.562439236984144,92.43756076301585,Healthcare
44831,13403,31428,29.89672324953715,70.10327675046285,Food
40524,4042,36482,9.974336195834567,90.02566380416543,Food
49705,38736,10969,77.93179760587466,22.06820239412534,Food
59437,17669,41768,29.72727425677608,70.27272574322392,Transportation
47399,10694,36705,22.56165741893289,77.4383425810671,Food
13959,126,13833,0.9026434558349452,99.09735654416505,Housing
108053,16995,91058,15.728392548101395,84.2716074518986,Healthcare
146112,24911,121201,17.049249890494963,82.95075010950504,Healthcare
107533,40134,67399,37.32249634995769,62.67750365004231,Healthcare
18893,13403,5490,70.94161858889537,29.058381411104644,Housing
33435,20991,12444,62.78151637505608,37.21848362494392,Food
185830,5919,179911,3.185169240703869,96.81483075929613,Entertainment
64589,49416,15173,76.5083837805199,23.491616219480097,Transportation
9679,3506,6173,36.22275028412026,63.777249715879734,Housing
13542,9092,4450,67.13927041795894,32.86072958204106,Housing
154783,26315,128468,17.00122106432877,82.99877893567123,Entertainment
97633,14193,83440,14.537092991099321,85.46290700890069,Transportation
20941,12607,8334,60.2024736163507,39.7975263836493,Housing
113436,42145,71291,37.15310836066152,62.84689163933849,Healthcare
196660,9338,187322,4.748296552425506,95.2517034475745,Entertainment
169819,39501,130318,23.26064810180251,76.7393518981975,Entertainment
144788,7425,137363,5.128187418846865,94.87181258115314,Healthcare
159685,27247,132438,17.06296771769421,82.9370322823058,Entertainment
154984,39909,115075,25.750400041294586,74.24959995870542,Entertainment
157055,38827,118228,24.721912705740028,75.27808729425998,Entertainment
140079,38585,101494,27.545170939255705,72.4548290607443,Healthcare
10454,9658,796,92.38568968815764,7.614310311842357,Housing
49055,29709,19346,60.56263377841199,39.437366221588015,Food
144889,46489,98400,32.085941651885236,67.91405834811476,Healthcare
9059,6668,2391,73.60635831769511,26.393641682304892,Housing
130959,6265,124694,4.783940011759405,95.2160599882406,Healthcare
24184,1019,23165,4.213529606351306,95.7864703936487,Housing
37983,17308,20675,45.567753995208385,54.432246004791615,Food
195303,20328,174975,10.40844226663185,89.59155773336815,Entertainment
21654,20125,1529,92.93894892398633,7.061051076013669,Housing
51185,22727,28458,44.40168017974016,55.598319820259846,Transportation
113862,11587,102275,10.176353831831515,89.82364616816848,Healthcare
46159,40460,5699,87.65354535410212,12.346454645897875,Food
63286,10973,52313,17.338747906329992,82.66125209367,Transportation
145519,7897,137622,5.426782756890853,94.57321724310914,Healthcare
177316,18268,159048,10.302510771729567,89.69748922827043,Entertainment
195077,48402,146675,24.81174100483399,75.18825899516601,Entertainment
106210,43148,63062,40.62517653704924,59.37482346295076,Healthcare
83371,4295,79076,5.151671444507082,94.84832855549293,Transportation
20828,1401,19427,6.7265219896293456,93.27347801037065,Housing
18749,5827,12922,31.078990879513572,68.92100912048642,Housing
46138,34714,11424,75.23949889462048,24.760501105379515,Food
172642,27127,145515,15.712862455254225,84.28713754474578,Entertainment
193879,5171,188708,2.667127435152853,97.33287256484715,Entertainment
156260,48347,107913,30.940099833610653,69.05990016638935,Entertainment
28244,17032,11212,60.303073219090784,39.69692678090922,Food
37922,1936,35986,5.105215969621855,94.89478403037815,Food
32372,14547,17825,44.93698257753614,55.06301742246386,Food
33168,5190,27978,15.647612156295224,84.35238784370478,Food
195729,30041,165688,15.34826213795605,84.65173786204396,Entertainment
84263,25595,58668,30.375134994006856,69.62486500599314,Transportation
18403,7239,11164,39.335977829701676,60.664022170298324,Housing
150959,40363,110596,26.737723487834447,73.26227651216556,Entertainment
20046,12611,7435,62.9103062955203,37.0896937044797,Housing
138060,908,137152,0.6576850644647254,99.34231493553527,Healthcare
31639,4651,26988,14.700211763962198,85.2997882360378,Food
43605,41932,1673,96.16328402706111,3.836715972938883,Food
66655,26370,40285,39.5619233365839,60.4380766634161,Transportation
35401,10345,25056,29.222338352023954,70.77766164797605,Food
124825,33405,91420,26.761466052473466,73.23853394752653,Healthcare
30920,15886,15034,51.377749029754206,48.622250970245794,Food
98054,7631,90423,7.782446407081813,92.2175535929182,Transportation
11610,9884,1726,85.13350559862187,14.866494401378121,Housing
55900,20502,35398,36.67620751341681,63.32379248658319,Transportation
115291,22151,93140,19.213121579308012,80.78687842069199,Healthcare
166084,34710,131374,20.899063124683895,79.10093687531611,Entertainment
10082,8967,1115,88.94068637175164,11.059313628248363,Housing
39720,29227,10493,73.58257804632427,26.417421953675728,Food
48868,2123,46745,4.344356224932471,95.65564377506753,Food
92719,12500,80219,13.481594926606197,86.5184050733938,Transportation
33606,15761,17845,46.89936320895078,53.10063679104922,Food
158047,4934,153113,3.1218561567128766,96.87814384328712,Entertainment
88375,6766,81609,7.656011315417256,92.34398868458274,Transportation
17094,364,16730,2.1294021294021293,97.87059787059788,Housing
15196,11725,3471,77.15846275335615,22.841537246643853,Housing
72732,22785,49947,31.327338722983004,68.67266127701699,Transportation
41837,13833,28004,33.06403422807563,66.93596577192437,Food
81737,329,81408,0.40251049096492414,99.59748950903507,Transportation
187697,4710,182987,2.509363495420811,97.49063650457919,Entertainment
18396,17482,914,95.03152859317242,4.968471406827571,Housing
105527,31086,74441,29.457863864224322,70.54213613577568,Healthcare
152788,46149,106639,30.204597219676938,69.79540278032306,Entertainment
154798,3307,151491,2.136332510755953,97.86366748924405,Entertainment
178503,46214,132289,25.889760956398494,74.11023904360151,Entertainment
12648,855,11793,6.759962049335863,93.24003795066413,Housing
26002,21628,4374,83.17821706022613,16.821782939773865,Food
46800,37099,9701,79.27136752136752,20.728632478632477,Food
137698,28988,108710,21.051867129515315,78.94813287048468,Healthcare
38101,20104,17997,52.76501929083226,47.23498070916774,Food
15421,5016,10405,32.52707347124051,67.47292652875949,Housing
8189,7101,1088,86.71388447917938,13.286115520820612,Housing
152750,49742,103008,32.56432078559738,67.43567921440263,Entertainment
133880,8367,125513,6.24962653122199,93.75037346877801,Healthcare
17388,14609,2779,84.01771336553945,15.982286634460547,Housing
22056,12236,9820,55.476967718534645,44.52303228146536,Housing
158759,1473,157286,0.9278214148489219,99.07217858515108,Entertainment
155893,3449,152444,2.2124149256220615,97.78758507437793,Entertainment
10116,5779,4337,57.12732305258995,42.87267694741004,Housing
81892,24124,57768,29.45831094612416,70.54168905387583,Transportation
13051,10756,2295,82.4151406022527,17.584859397747298,Housing
111520,31115,80405,27.900824964131992,72.099175035868,Healthcare
186511,2035,184476,1.0910884612703808,98.90891153872961,Entertainment
198588,15784,182804,7.948113682599151,92.05188631740086,Entertainment
108713,8221,100492,7.562113086751355,92.43788691324865,Healthcare
13276,2062,11214,15.531786682735763,84.46821331726424,Housing
95481,8484,86997,8.885537436767525,91.11446256323248,Transportation
26653,21924,4729,82.25715679285634,17.74284320714366,Food
120947,23504,97443,19.433305497449297,80.5666945025507,Healthcare
161064,23089,137975,14.3352952863458,85.6647047136542,Entertainment
104842,31668,73174,30.20545201350604,69.79454798649397,Healthcare
9679,236,9443,2.438268416158694,97.56173158384131,Housing
113393,20051,93342,17.68274937606378,82.31725062393622,Healthcare
138502,3216,135286,2.321988130135305,97.6780118698647,Healthcare
197879,48850,149029,24.686803551665413,75.31319644833458,Entertainment
25306,14347,10959,56.694064648699914,43.305935351300086,Food
96541,17615,78926,18.24613376700055,81.75386623299946,Transportation
25152,24428,724,97.12150127226464,2.878498727735369,Food
121696,9357,112339,7.6888311859058645,92.31116881409413,Healthcare
18433,15525,2908,84.22394618347528,15.77605381652471,Housing
12033,8428,3605,70.04072134962188,29.95927865037813,Housing
41964,14017,27947,33.4024401868268,66.5975598131732,Food
94646,7244,87402,7.653783572470046,92.34621642752995,Transportation
15151,9493,5658,62.65593030163026,37.34406969836975,Housing
65112,32312,32800,49.62526108858582,50.37473891141418,Transportation
80286,24154,56132,30.084946316917023,69.91505368308299,Transportation
75959,10766,65193,14.173435669242618,85.82656433075738,Transportation
58459,17221,41238,29.458252792555466,70.54174720744454,Transportation
187922,15340,172582,8.162961228594842,91.83703877140516,Entertainment
51258,8250,43008,16.09504857778298,83.90495142221702,Transportation
45591,30951,14640,67.88839902612358,32.11160097387643,Food
92624,38492,54132,41.557263776127144,58.442736223872856,Transportation
182023,32202,149821,17.69117089598567,82.30882910401432,Entertainment
106788,38000,68788,35.5845226055362,64.41547739446379,Healthcare
155834,23386,132448,15.0069946224829,84.99300537751711,Entertainment
13738,5668,8070,41.25782501091862,58.74217498908138,Housing
77458,48015,29443,61.988432440806626,38.011567559193374,Transportation
27514,20187,7327,73.36992076760922,26.630079232390784,Food
25955,13794,12161,53.145829319976876,46.85417068002312,Food
31769,9130,22639,28.738707545091124,71.26129245490887,Food
136213,29299,106914,21.50969437572038,78.49030562427963,Healthcare
184906,10215,174691,5.524428628600478,94.47557137139952,Entertainment
127921,22203,105718,17.356806153798047,82.64319384620195,Healthcare
30912,11695,19217,37.83320393374741,62.16679606625258,Food
87680,49385,38295,56.32413321167883,43.675866788321166,Transportation
72376,22611,49765,31.241019122361003,68.758980877639,Transportation
78953,10055,68898,12.735424873025725,87.26457512697428,Transportation
111749,28535,83214,25.53490411547307,74.46509588452693,Healthcare
143703,32080,111623,22.323820657884667,77.67617934211533,Healthcare
72258,4394,67864,6.080987572310333,93.91901242768967,Transportation
17741,5941,11800,33.48740206301787,66.51259793698213,Housing
85852,15678,70174,18.26165960024228,81.73834039975773,Transportation
68681,17323,51358,25.22240503195935,74.77759496804065,Transportation
37411,30429,6982,81.33703990804844,18.662960091951565,Food
34784,13233,21551,38.04335326586937,61.956646734130636,Food
82976,27073,55903,32.62750674893945,67.37249325106055,Transportation
166483,35056,131427,21.056804598667732,78.94319540133226,Entertainment
22387,3927,18460,17.541430294367267,82.45856970563274,Housing
69769,30794,38975,44.137080938525706,55.862919061474294,Transportation
41281,39307,1974,95.21813909546765,4.781860904532351,Food
174643,13467,161176,7.711159336474981,92.28884066352502,Entertainment
155777,43352,112425,27.829525539713824,72.17047446028619,Entertainment
26309,21301,5008,80.96468888973355,19.03531111026645,Food
83643,38311,45332,45.80299606661645,54.19700393338355,Transportation
108560,26058,82502,24.003316138540896,75.9966838614591,Healthcare
91798,19346,72452,21.07453321423125,78.92546678576875,Transportation
142198,18790,123408,13.213969254138597,86.78603074586141,Healthcare
125319,6074,119245,4.846830887574908,95.15316911242509,Healthcare
147349,42885,104464,29.104371254640345,70.89562874535964,Healthcare
40490,14201,26289,35.072857495677944,64.92714250432205,Food
126876,24514,102362,19.321227024811627,80.67877297518837,Healthcare
155273,44134,111139,28.423486375609407,71.57651362439059,Entertainment
167465,21248,146217,12.688024363299794,87.3119756367002,Entertainment
30995,23600,7395,76.14131311501855,23.85868688498145,Food
31298,14895,16403,47.590900377020894,52.409099622979106,Food
89160,30276,58884,33.95693135935397,66.04306864064603,Transportation
108028,22144,85884,20.4983893064761,79.5016106935239,Healthcare
81116,49941,31175,61.567384979535476,38.432615020464524,Transportation
184689,13227,171462,7.161769244513751,92.83823075548625,Entertainment
19777,1628,18149,8.231784396015573,91.76821560398443,Housing
139387,37491,101896,26.897056396938023,73.10294360306197,Healthcare
162322,37091,125231,22.85026059314203,77.14973940685798,Entertainment
62387,34033,28354,54.55142898360236,45.44857101639765,Transportation
174681,18066,156615,10.34228107235475,89.65771892764525,Entertainment
9361,4370,4991,46.68304668304668,53.31695331695332,Housing
122503,24805,97698,20.248483710603004,79.75151628939699,Healthcare
175817,9950,165867,5.659293469914741,94.34070653008526,Entertainment
192095,22505,169590,11.715557406491579,88.28444259350842,Entertainment
36796,4485,32311,12.188824872268725,87.81117512773127,Food
184903,3892,181011,2.1048874274619664,97.89511257253804,Entertainment
43953,38650,5303,87.93483948763452,12.065160512365482,Food
33178,30111,3067,90.7559225993128,9.244077400687202,Food
134745,6443,128302,4.78162455007607,95.21837544992393,Healthcare
17206,9991,7215,58.06695338835291,41.9330466116471,Housing
113430,48807,64623,43.02829939169532,56.97170060830467,Healthcare
44783,2155,42628,4.812093874907889,95.18790612509211,Food
139064,13703,125361,9.853736409135362,90.14626359086463,Healthcare
40550,29963,10587,73.89149198520344,26.10850801479655,Food
73699,32980,40719,44.74958954666956,55.25041045333043,Transportation
144267,38218,106049,26.49115875425426,73.50884124574574,Healthcare
120940,47164,73776,38.99785017363982,61.002149826360174,Healthcare
40033,35294,4739,88.16226613044239,11.837733869557615,Food
81096,21248,59848,26.201045674262602,73.7989543257374,Transportation
67353,7297,60056,10.83396433714905,89.16603566285094,Transportation
44580,34172,10408,76.65320771646478,23.346792283535216,Food
175623,6800,168823,3.871930214151905,96.1280697858481,Entertainment
79878,27981,51897,35.02967024712687,64.97032975287314,Transportation
166458,41443,125015,24.896971007701644,75.10302899229836,Entertainment
163945,35505,128440,21.65665314587209,78.3433468541279,Entertainment
171270,46515,124755,27.158871956559814,72.84112804344018,Entertainment
16385,11999,4386,73.2316142813549,26.768385718645106,Housing
16078,6063,10015,37.70991416842891,62.2900858315711,Housing
142865,36355,106510,25.44710040947748,74.55289959052253,Healthcare
182064,32743,149321,17.984335178838208,82.01566482116179,Entertainment
31002,11113,19889,35.84607444680989,64.15392555319012,Food
104598,37304,67294,35.66416183865848,64.33583816134151,Healthcare
20869,7166,13703,34.33801332119412,65.66198667880589,Housing
109430,48621,60809,44.431143196564015,55.568856803435985,Healthcare
48888,29883,19005,61.12542955326461,38.8745704467354,Food
12251,12180,71,99.4204554730226,0.5795445269773896,Housing
95279,32375,62904,33.97915595251839,66.0208440474816,Transportation
131019,16555,114464,12.63557193994764,87.36442806005236,Healthcare
137740,27399,110341,19.891825177871354,80.10817482212865,Healthcare
14342,1449,12893,10.103193417933342,89.89680658206666,Housing
101925,19479,82446,19.11111111111111,80.88888888888889,Healthcare
134955,5967,128988,4.421473824608203,95.5785261753918,Healthcare
85725,22401,63324,26.131233595800524,73.86876640419948,Transportation
92866,4001,88865,4.308358279671785,95.6916417203282,Transportation
135726,18996,116730,13.995844569205607,86.0041554307944,Healthcare
30796,26691,4105,86.6703467982855,13.329653201714509,Food
30073,9631,20442,32.025404848202704,67.97459515179729,Food
174618,37748,136870,21.617473570880435,78.38252642911957,Entertainment
41699,15123,26576,36.267056763951175,63.732943236048825,Food
47060,25256,21804,53.667658308542286,46.332341691457714,Food
114516,5310,109206,4.636906633134235,95.36309336686577,Healthcare
24371,12316,12055,50.535472487792866,49.46452751220713,Housing
106696,20672,86024,19.374671965209565,80.62532803479043,Healthcare
62878,40731,22147,64.77782372212857,35.222176277871434,Transportation
35080,3809,31271,10.858038768529077,89.14196123147093,Food
33090,5577,27513,16.85403445149592,83.14596554850408,Food
21364,15061,6303,70.4970979217375,29.5029020782625,Housing
51156,10082,41074,19.708343107357887,80.29165689264211,Transportation
45978,21118,24860,45.93066249075645,54.06933750924355,Food
198123,33746,164377,17.03285332848786,82.96714667151214,Entertainment
148813,17884,130929,12.01776726495669,87.98223273504331,Healthcare
67741,33782,33959,49.86935533871658,50.13064466128342,Transportation
8557,882,7675,10.30735070702349,89.69264929297651,Housing
10482,8058,2424,76.8746422438466,23.125357756153406,Housing
34175,3443,30732,10.074615947329919,89.92538405267008,Food
162343,36417,125926,22.432134431419897,77.5678655685801,Entertainment
19894,2356,17538,11.842766663315572,88.15723333668443,Housing
23552,14646,8906,62.18580163043478,37.81419836956522,Housing
76752,38174,38578,49.736814675839064,50.26318532416093,Transportation
43109,17270,25839,40.06124011227354,59.938759887726455,Food
11456,7788,3668,67.98184357541899,32.01815642458101,Housing
180487,13068,167419,7.240410666696216,92.75958933330378,Entertainment
66456,27144,39312,40.845070422535215,59.154929577464785,Transportation
86487,22159,64328,25.621191624174735,74.37880837582527,Transportation
22571,9951,12620,44.08754596606265,55.91245403393735,Housing
178689,48017,130672,26.87182758871559,73.12817241128441,Entertainment
123490,31036,92454,25.132399384565552,74.86760061543445,Healthcare
103682,20522,83160,19.793213865473273,80.20678613452674,Healthcare
199262,35539,163723,17.835312302395838,82.16468769760415,Entertainment
35998,33489,2509,93.0301683426857,6.969831657314295,Food
32037,6487,25550,20.2484627149858,79.75153728501421,Food
29821,11001,18820,36.890110995607124,63.10988900439288,Food
47341,18825,28516,39.76468600156313,60.235313998436865,Food
10100,3748,6352,37.10891089108911,62.89108910891089,Housing
125131,45357,79774,36.2476125020978,63.7523874979022,Healthcare
12986,1481,11505,11.404589557985522,88.59541044201448,Housing
127524,1774,125750,1.3911106928891817,98.60888930711081,Healthcare
134646,42709,91937,31.719471800127742,68.28052819987226,Healthcare
123466,30955,92511,25.07167965269791,74.92832034730209,Healthcare
24967,20172,4795,80.7946489365963,19.205351063403693,Housing
133542,7311,126231,5.474682122478321,94.52531787752167,Healthcare
199835,17545,182290,8.779743288212776,91.22025671178723,Entertainment
93871,30098,63773,32.06315049376271,67.93684950623728,Transportation
23433,22788,645,97.24747151453079,2.75252848546921,Housing
26868,7465,19403,27.783980943873754,72.21601905612624,Food
53952,21468,32484,39.79092526690391,60.20907473309609,Transportation
96023,559,95464,0.5821521927038313,99.41784780729617,Transportation
110904,49552,61352,44.68008367597201,55.319916324027986,Healthcare
102460,28768,73692,28.077298457934802,71.9227015420652,Healthcare
194556,33736,160820,17.339994654495364,82.66000534550464,Entertainment
101618,43016,58602,42.33108307583302,57.66891692416698,Healthcare
68800,46515,22285,67.60901162790698,32.39098837209302,Transportation
155167,7121,148046,4.589249002687427,95.41075099731258,Entertainment
37389,20906,16483,55.914841263473214,44.085158736526786,Food
125921,6829,119092,5.423241556213817,94.57675844378618,Healthcare
20533,7343,13190,35.76194418740564,64.23805581259437,Housing
128401,18761,109640,14.611256921675064,85.38874307832494,Healthcare
71169,32624,38545,45.840183225842715,54.159816774157285,Transportation
98995,10588,88407,10.695489671195515,89.30451032880448,Transportation
42727,38328,4399,89.70440236852576,10.295597631474243,Food
53292,35256,18036,66.15627111011034,33.84372888988966,Transportation
197739,31217,166522,15.786971715240798,84.2130282847592,Entertainment
18055,4440,13615,24.591525893104404,75.4084741068956,Housing
166520,2025,164495,1.2160701417247177,98.78392985827527,Entertainment
146640,42460,104180,28.955264593562468,71.04473540643752,Healthcare
155618,1195,154423,0.7679060262951587,99.23209397370483,Entertainment
146247,36649,109598,25.05965934343952,74.94034065656048,Healthcare
28333,787,27546,2.7776797374086755,97.22232026259132,Food
146667,26173,120494,17.845186715484736,82.15481328451526,Healthcare
167138,32103,135035,19.20748124304467,80.79251875695533,Entertainment
113247,33844,79403,29.88511836958153,70.11488163041847,Healthcare
149432,42000,107432,28.106429680389745,71.89357031961026,Healthcare
193561,27256,166305,14.081349032088076,85.91865096791193,Entertainment
177274,28413,148861,16.02773108295633,83.97226891704366,Entertainment
22138,17294,4844,78.11907128015177,21.880928719848225,Housing
11516,3340,8176,29.003126085446336,70.99687391455366,Housing
110224,48166,62058,43.69828712440122,56.30171287559879,Healthcare
45172,34864,10308,77.18055432568848,22.81944567431152,Food
63026,9280,53746,14.724082124837368,85.27591787516263,Transportation
39032,4827,34205,12.366775978684156,87.63322402131585,Food
36602,35596,1006,97.25151631058412,2.7484836894158793,Food
16646,11664,4982,70.07088790099723,29.929112099002765,Housing
12855,6547,6308,50.92959937767406,49.07040062232594,Housing
77529,1995,75534,2.5732306620748364,97.42676933792517,Transportation
10032,2761,7271,27.521929824561404,72.47807017543859,Housing
81101,16150,64951,19.913441264595996,80.086558735404,Transportation
76798,47573,29225,61.945623583947494,38.0543764160525,Transportation
33738,23110,10628,68.49842907107713,31.501570928922877,Food
11890,8838,3052,74.3313708999159,25.668629100084107,Housing
15817,11683,4134,73.86356451918822,26.136435480811787,Housing
10763,6328,4435,58.79401653813993,41.20598346186007,Housing
41062,28810,12252,70.16219375578395,29.837806244216065,Food
14297,12839,1458,89.80205637546338,10.197943624536617,Housing
104857,27527,77330,26.251943122538314,73.74805687746169,Healthcare
67071,27937,39134,41.652875311237345,58.347124688762655,Transportation
186528,5112,181416,2.7406073082861555,97.25939269171384,Entertainment
157565,41043,116522,26.048297528004316,73.95170247199569,Entertainment
10106,8173,1933,80.87274886206214,19.127251137937858,Housing
18716,17453,1263,93.25176319726437,6.748236802735627,Housing
132244,40557,91687,30.668310093463596,69.3316899065364,Healthcare
172881,5091,167790,2.94480018047096,97.05519981952904,Entertainment
16984,8286,8698,48.787093735280266,51.212906264719734,Housing
172344,27712,144632,16.079468969038665,83.92053103096133,Entertainment
100049,36978,63071,36.95988965406951,63.040110345930486,Healthcare
194119,49334,144785,25.414307718461355,74.58569228153864,Entertainment
121659,42596,79063,35.01261723341471,64.98738276658528,Healthcare
10563,3292,7271,31.16538862065701,68.83461137934299,Housing
109488,47829,61659,43.684239368697945,56.315760631302055,Healthcare
169324,25397,143927,14.999055066027262,85.00094493397275,Entertainment
14155,13839,316,97.76757329565524,2.2324267043447548,Housing
18179,12251,5928,67.39094559656746,32.60905440343253,Housing
102914,25765,77149,25.035466506014732,74.96453349398527,Healthcare
117157,1645,115512,1.4040987734407675,98.59590122655923,Healthcare
75715,39743,35972,52.49025952585353,47.509740474146476,Transportation
153284,4691,148593,3.060332454789802,96.9396675452102,Entertainment
114847,26177,88670,22.792933206788163,77.20706679321184,Healthcare
28536,22340,6196,78.28707597420802,21.71292402579198,Food
39502,2690,36812,6.809781783200851,93.19021821679915,Food
83827,44498,39329,53.083135505266796,46.916864494733204,Transportation
14799,12556,2243,84.84357051152105,15.15642948847895,Housing
40285,33979,6306,84.34653096686111,15.653469033138887,Food
94514,9465,85049,10.014389402628183,89.98561059737182,Transportation
193040,8219,184821,4.257666804807294,95.74233319519271,Entertainment
132912,39986,92926,30.084567232454557,69.91543276754545,Healthcare
119055,40863,78192,34.32279198689681,65.67720801310318,Healthcare
199442,27106,172336,13.590918663069965,86.40908133693004,Entertainment
84414,10435,73979,12.361693557940626,87.63830644205937,Transportation
182407,40262,142145,22.07261782716672,77.92738217283328,Entertainment
178897,37443,141454,20.92992056881893,79.07007943118107,Entertainment
120601,2466,118135,2.0447591645177075,97.9552408354823,Healthcare
117997,3275,114722,2.7754942922277688,97.22450570777224,Healthcare
168331,15365,152966,9.127849296920948,90.87215070307906,Entertainment
104099,7619,96480,7.318994418774436,92.68100558122556,Healthcare
173507,49751,123756,28.67377108704548,71.32622891295452,Entertainment
11373,10738,635,94.41660072100589,5.583399278994109,Housing
53089,45783,7306,86.23820377102601,13.761796228973989,Transportation
23935,13145,10790,54.91957384583246,45.08042615416753,Housing
11224,10445,779,93.05951532430507,6.94048467569494,Housing
86881,12780,74101,14.709775439969613,85.29022456003038,Transportation
137851,16636,121215,12.06810251648519,87.9318974835148,Healthcare
19190,9984,9206,52.027097446586765,47.972902553413235,Housing
169692,32020,137672,18.86948117766306,81.13051882233694,Entertainment
54137,46246,7891,85.42401684614958,14.575983153850416,Transportation
29576,7727,21849,26.12591290235326,73.87408709764675,Food
178274,47553,130721,26.674108394942614,73.32589160505738,Entertainment
28096,16704,11392,59.453302961275625,40.546697038724375,Food
194123,42692,151431,21.99224203211366,78.00775796788633,Entertainment
160307,36784,123523,22.9459724154279,77.05402758457211,Entertainment
53197,42320,10877,79.553358272083,20.446641727916987,Transportation
8342,1447,6895,17.345960201390554,82.65403979860945,Housing
90728,44748,45980,49.321047526673134,50.678952473326866,Transportation
115454,22222,93232,19.247492507838622,80.75250749216139,Healthcare
42481,9120,33361,21.468421176525975,78.53157882347402,Food
74763,784,73979,1.0486470580367293,98.95135294196326,Transportation
172438,23958,148480,13.893689326018627,86.10631067398137,Entertainment
29676,1170,28506,3.9425798625151636,96.05742013748484,Food
43772,29299,14473,66.93548387096774,33.064516129032256,Food
96337,36135,60202,37.50895294642764,62.49104705357236,Transportation
180636,14834,165802,8.212095041962844,91.78790495803716,Entertainment
68523,11656,56867,17.01034689082498,82.98965310917502,Transportation
185524,19116,166408,10.303788189129168,89.69621181087084,Entertainment
58420,47952,10468,82.08147894556659,17.918521054433416,Transportation
50320,24469,25851,48.62678855325914,51.37321144674086,Transportation
102057,19192,82865,18.805177498848682,81.19482250115132,Healthcare
140275,8701,131574,6.202815897344502,93.79718410265549,Healthcare
10891,3756,7135,34.487191258837576,65.51280874116243,Housing
26009,3783,22226,14.544965204352339,85.45503479564765,Food
99221,15595,83626,15.717438848630835,84.28256115136917,Transportation
22135,18587,3548,83.97108651456968,16.028913485430312,Housing
61259,24485,36774,39.96963711454644,60.03036288545357,Transportation
185892,36992,148900,19.899726723043486,80.10027327695651,Entertainment
61229,33538,27691,54.774698263894564,45.225301736105436,Transportation
117224,36769,80455,31.366443731659043,68.63355626834095,Healthcare
126927,28783,98144,22.676814231802535,77.32318576819746,Healthcare
184755,21380,163375,11.572081946361397,88.42791805363859,Entertainment
12727,3965,8762,31.15423901940756,68.84576098059244,Housing
9551,1629,7922,17.05580567479845,82.94419432520155,Housing
34803,24519,10284,70.45082320489612,29.54917679510387,Food
22527,17424,5103,77.34718337994406,22.652816620055933,Housing
27796,12496,15300,44.95610879263203,55.04389120736797,Food
191401,2092,189309,1.0929932445494015,98.9070067554506,Entertainment
29899,29413,486,98.37452757617312,1.6254724238268836,Food
125595,42749,82846,34.03718300887774,65.96281699112225,Healthcare
192772,31885,160887,16.540265183740377,83.45973481625963,Entertainment
115060,48398,66662,42.063271336693894,57.936728663306106,Healthcare
187930,42348,145582,22.533922205076358,77.46607779492363,Entertainment
129377,548,128829,0.4235683313108203,99.57643166868918,Healthcare
16392,13067,3325,79.7157149829185,20.2842850170815,Housing
13675,161,13514,1.1773308957952469,98.82266910420475,Housing
173916,2365,171551,1.3598518825179973,98.64014811748201,Entertainment
106662,43021,63641,40.33395211040483,59.66604788959518,Healthcare
10092,2130,7962,21.105826397146256,78.89417360285374,Housing
22901,5445,17456,23.776254312038773,76.22374568796121,Housing
14905,2834,12071,19.013753773901378,80.98624622609863,Housing
102017,3574,98443,3.503337679014282,96.49666232098572,Healthcare
53645,16142,37503,30.090409171404602,69.9095908285954,Transportation
31136,5573,25563,17.898895169578623,82.10110483042138,Food
65185,669,64516,1.026309733834471,98.97369026616552,Transportation
168002,17044,150958,10.145117320031904,89.8548826799681,Entertainment
12670,2190,10480,17.284925019731652,82.71507498026835,Housing
96979,6884,90095,7.098443993029418,92.90155600697058,Transportation
31130,5850,25280,18.792161901702535,81.20783809829746,Food
21046,2590,18456,12.30637650860021,87.69362349139979,Housing
23899,3748,20151,15.68266454663375,84.31733545336625,Housing
90289,25995,64294,28.79088261028475,71.20911738971525,Transportation
11072,1854,9218,16.74494219653179,83.25505780346822,Housing
49063,9104,39959,18.5557344638526,81.4442655361474,Food
116351,41643,74708,35.790839786508066,64.20916021349193,Healthcare
110968,16455,94513,14.828599235815732,85.17140076418427,Healthcare
23997,14215,9782,59.23657123807142,40.76342876192857,Housing
34206,26627,7579,77.84306846752031,22.156931532479682,Food
54240,44896,9344,82.77286135693215,17.227138643067846,Transportation
53971,3407,50564,6.312649385781254,93.68735061421874,Transportation
55791,10170,45621,18.228746572027745,81.77125342797225,Transportation
9742,1925,7817,19.759802915212482,80.24019708478752,Housing
55123,9852,45271,17.872757288246284,82.12724271175371,Transportation
133747,730,133017,0.5458066349151757,99.45419336508482,Healthcare
32109,9141,22968,28.46865364850976,71.53134635149023,Food
190353,23694,166659,12.44740035618036,87.55259964381963,Entertainment
138192,17434,120758,12.615780942456873,87.38421905754313,Healthcare
13592,98,13494,0.7210123602118893,99.27898763978811,Housing
158658,21951,136707,13.83541958174186,86.16458041825814,Entertainment
9988,3802,6186,38.06567881457749,61.934321185422505,Housing
131646,19278,112368,14.643817510596598,85.3561824894034,Healthcare
23906,17079,6827,71.44231573663515,28.557684263364848,Housing
20173,4673,15500,23.16462598522778,76.83537401477221,Housing
191099,4923,186176,2.576151628213648,97.42384837178635,Entertainment
48132,17264,30868,35.86802958530707,64.13197041469293,Food
14410,53,14357,0.3678001387925052,99.6321998612075,Housing
71613,39617,31996,55.32096127798025,44.67903872201974,Transportation
186181,41908,144273,22.509278605228246,77.49072139477175,Entertainment
29653,23176,6477,78.1573533875156,21.842646612484405,Food
98878,40719,58159,41.18105139667064,58.81894860332936,Transportation
88315,35453,52862,40.14380343090075,59.856196569099254,Transportation
78025,29414,48611,37.69817366228773,62.30182633771227,Transportation
112205,11952,100253,10.6519317320975,89.3480682679025,Healthcare
34547,5335,29212,15.442730193649231,84.55726980635076,Food
12875,1256,11619,9.755339805825242,90.24466019417476,Housing
72943,42986,29957,58.930946081186676,41.06905391881332,Transportation
185855,42730,143125,22.991041403244463,77.00895859675553,Entertainment
17208,16371,837,95.13598326359832,4.864016736401674,Housing
142604,13647,128957,9.569857788000338,90.43014221199967,Healthcare
20866,1088,19778,5.214224096616505,94.7857759033835,Housing
143884,6820,137064,4.739929387562203,95.2600706124378,Healthcare
94144,22936,71208,24.36267845003399,75.637321549966,Transportation
136804,47895,88909,35.0099412297886,64.9900587702114,Healthcare
73971,8872,65099,11.993889497235404,88.0061105027646,Transportation
41631,2429,39202,5.8345944128173715,94.16540558718263,Food
26907,7399,19508,27.49842048537555,72.50157951462445,Food
51103,597,50506,1.1682288711034579,98.83177112889653,Transportation
153539,23404,130135,15.243032714815127,84.75696728518487,Entertainment
144836,19207,125629,13.261205777569113,86.7387942224309,Healthcare
105150,41992,63158,39.93533048026629,60.06466951973371,Healthcare
10151,9429,722,92.8874002561324,7.1125997438676,Housing
16633,11372,5261,68.37010761738712,31.62989238261288,Housing
66998,32599,34399,48.65667631869608,51.34332368130392,Transportation
169214,10401,158813,6.146654532130911,93.85334546786909,Entertainment
28937,9307,19630,32.16297473822442,67.83702526177558,Food
12109,7179,4930,59.28648112973821,40.71351887026179,Housing
98341,37415,60926,38.046186229548205,61.953813770451795,Transportation
44159,30916,13243,70.01064335696007,29.989356643039923,Food
65917,15248,50669,23.13212069724047,76.86787930275953,Transportation
183685,21972,161713,11.96178239921605,88.03821760078395,Entertainment
33270,2831,30439,8.50916741809438,91.49083258190562,Food
32283,15635,16648,48.431062788464516,51.568937211535484,Food
26952,10165,16787,37.71519738794895,62.28480261205105,Food
124006,44793,79213,36.12163927551892,63.87836072448108,Healthcare
153713,28531,125182,18.561214731349985,81.43878526865002,Entertainment
125836,29743,96093,23.636320289901143,76.36367971009886,Healthcare
197918,14088,183830,7.118099414909204,92.88190058509079,Entertainment
170902,16277,154625,9.524171747551229,90.47582825244878,Entertainment
114902,23279,91623,20.259873631442446,79.74012636855755,Healthcare
159865,32490,127375,20.323397866950238,79.67660213304976,Entertainment
115590,36375,79215,31.46898520633273,68.53101479366728,Healthcare
8545,4346,4199,50.8601521357519,49.1398478642481,Housing
193258,32089,161169,16.604228544225855,83.39577145577415,Entertainment
185187,31170,154017,16.83163504997651,83.16836495002349,Entertainment
107441,19911,87530,18.532031533585876,81.46796846641412,Healthcare
86164,33971,52193,39.42597836683534,60.57402163316466,Transportation
164630,49056,115574,29.79772823908158,70.20227176091842,Entertainment
68385,17855,50530,26.109526943043065,73.89047305695694,Transportation
17503,16905,598,96.58344283837057,3.416557161629435,Housing
121347,10619,110728,8.750937394414365,91.24906260558564,Healthcare
24093,19176,4917,79.59158261735773,20.40841738264226,Housing
37517,8558,28959,22.810992350134608,77.18900764986539,Food
43313,24127,19186,55.703830258813746,44.29616974118625,Food
20775,16244,4531,78.19013237063778,21.809867629362216,Housing
44364,3968,40396,8.944188982057524,91.05581101794247,Food
16752,174,16578,1.0386819484240688,98.96131805157593,Housing
19120,18213,907,95.25627615062761,4.743723849372385,Housing
119869,11877,107992,9.908316578932002,90.091683421068,Healthcare
196669,47738,148931,24.27327133406892,75.72672866593109,Entertainment
17155,10426,6729,60.77528417371029,39.22471582628971,Housing
33434,9111,24323,27.250702877310523,72.74929712268948,Food
166589,23168,143421,13.90728079284947,86.09271920715054,Entertainment
15866,15449,417,97.37173830833228,2.628261691667717,Housing
93799,1652,92147,1.761212806106675,98.23878719389333,Transportation
16155,3583,12572,22.17889198390591,77.82110801609409,Housing
98792,3065,95727,3.102477933435906,96.8975220665641,Transportation
194569,49891,144678,25.641803164944054,74.35819683505595,Entertainment
25596,7875,17721,30.766526019690577,69.23347398030943,Food
30559,26406,4153,86.4098956117674,13.590104388232598,Food
55388,31759,23629,57.33913483064924,42.660865169350764,Transportation
58066,29873,28193,51.44662969724108,48.55337030275893,Transportation
83537,5607,77930,6.711995882064235,93.28800411793577,Transportation
80784,17325,63459,21.44607843137255,78.55392156862744,Transportation
50766,45439,5327,89.50675649056456,10.493243509435448,Transportation
153676,12907,140769,8.398839116062366,91.60116088393764,Entertainment
69660,31403,38257,45.08039046798737,54.919609532012636,Transportation
98095,38034,60061,38.7726183801417,61.2273816198583,Transportation
181424,33944,147480,18.709762765675986,81.29023723432401,Entertainment
19138,18196,942,95.07785557529522,4.922144424704776,Housing
186673,3573,183100,1.9140422021395702,98.08595779786043,Entertainment
58641,29263,29378,49.90194573762385,50.09805426237616,Transportation
72690,27475,45215,37.79749621681112,62.20250378318889,Transportation
147148,47671,99477,32.396634680729605,67.6033653192704,Healthcare
37299,34779,2520,93.24378669669429,6.756213303305719,Food
138395,37282,101113,26.938834495465873,73.06116550453412,Healthcare
170711,19952,150759,11.687588966147464,88.31241103385253,Entertainment
35307,29283,6024,82.93822754694537,17.061772453054637,Food
18195,2096,16099,11.519648255015113,88.48035174498489,Housing
49423,47761,1662,96.63719320963924,3.362806790360763,Food
72287,27328,44959,37.80486117835849,62.195138821641514,Transportation
30678,21035,9643,68.56705130712562,31.432948692874373,Food
45324,16428,28896,36.24569764363251,63.75430235636749,Food
20743,9324,11419,44.9501036494239,55.0498963505761,Housing
14102,9061,5041,64.25329740462345,35.74670259537655,Housing
112211,36972,75239,32.94864139879334,67.05135860120666,Healthcare
138050,22242,115808,16.111553784860558,83.88844621513944,Healthcare
70370,12881,57489,18.30467528776467,81.69532471223533,Transportation
65203,8060,57143,12.361394414367437,87.63860558563256,Transportation
66143,47074,19069,71.1700406694586,28.829959330541406,Transportation
86235,30763,55472,35.673450455151624,64.32654954484838,Transportation
159590,18077,141513,11.327150823986464,88.67284917601353,Entertainment
43550,39220,4330,90.05740528128587,9.942594718714123,Food
124252,25058,99194,20.16707980555645,79.83292019444355,Healthcare
16224,6198,10026,38.202662721893496,61.79733727810651,Housing
88641,44135,44506,49.79072889520651,50.209271104793494,Transportation
118954,35396,83558,29.756040149973938,70.24395985002606,Healthcare
33418,13362,20056,39.984439523610035,60.01556047638997,Food
164087,36171,127916,22.043793841072116,77.95620615892788,Entertainment
25688,8501,17187,33.093273123637495,66.9067268763625,Food
188687,37323,151364,19.780377026504212,80.21962297349579,Entertainment
17342,7064,10278,40.73347941413908,59.26652058586092,Housing
14184,3099,11085,21.848561759729275,78.15143824027074,Housing
168812,5721,163091,3.388977086936948,96.61102291306305,Entertainment
11389,9299,2090,81.64895952234612,18.351040477653875,Housing
143099,45511,97588,31.803856071670662,68.19614392832933,Healthcare
69966,44997,24969,64.31266615213104,35.68733384786896,Transportation
71210,39284,31926,55.16640921218931,44.8335907878107,Transportation
98979,28743,70236,29.039493225835784,70.96050677416422,Transportation
86371,5062,81309,5.860763450695257,94.13923654930474,Transportation
36560,3395,33165,9.286105032822757,90.71389496717724,Food
125767,3657,122110,2.9077579969308323,97.09224200306916,Healthcare
89698,17634,72064,19.659301210729335,80.34069878927066,Transportation
131134,34069,97065,25.98029496545518,74.01970503454481,Healthcare
66480,9180,57300,13.808664259927797,86.1913357400722,Transportation
167660,48770,118890,29.08863175474174,70.91136824525826,Entertainment
78394,22076,56318,28.160318391713652,71.83968160828634,Transportation
29066,14090,14976,48.475882474368674,51.52411752563132,Food
122277,12693,109584,10.380529453617605,89.6194705463824,Healthcare
115468,32019,83449,27.72976062632071,72.27023937367929,Healthcare
116485,3087,113398,2.6501266257458043,97.34987337425419,Healthcare
158309,39242,119067,24.78823061228357,75.21176938771643,Entertainment
193999,17238,176761,8.885612812437177,91.11438718756281,Entertainment
162443,26290,136153,16.184138436251487,83.81586156374851,Entertainment
22870,12713,10157,55.58810668998688,44.41189331001312,Housing
38700,21438,17262,55.395348837209305,44.604651162790695,Food
28008,969,27039,3.459725792630677,96.54027420736932,Food
48098,36975,11123,76.87429830762194,23.125701692378062,Food
192802,21199,171603,10.995217891930581,89.0047821080694,Entertainment
43896,143,43753,0.3257700018224895,99.67422999817751,Food
17439,13281,4158,76.1568897299157,23.843110270084296,Housing
156567,17426,139141,11.130059335619896,88.86994066438011,Entertainment
83958,13908,70050,16.56542556992782,83.43457443007219,Transportation
176976,2670,174306,1.5086791429346351,98.49132085706536,Entertainment
21986,12638,9348,57.48203402165014,42.51796597834986,Housing
21596,1700,19896,7.871828116317836,92.12817188368217,Housing
106338,33948,72390,31.92461772837556,68.07538227162443,Healthcare
183651,30954,152697,16.854795236617278,83.14520476338272,Entertainment
32211,24037,8174,74.62357579708795,25.37642420291205,Food
174727,14008,160719,8.017078070361192,91.9829219296388,Entertainment
77940,1845,76095,2.367205542725173,97.63279445727483,Transportation
60482,33734,26748,55.775271981746634,44.22472801825336,Transportation
185887,9901,175986,5.326354182917579,94.67364581708242,Entertainment
65894,45857,20037,69.59207211582238,30.40792788417762,Transportation
103692,7470,96222,7.204027311653744,92.79597268834625,Healthcare
93014,35365,57649,38.02115810523147,61.978841894768536,Transportation
9342,2832,6510,30.31470777135517,69.68529222864484,Housing
10033,6467,3566,64.45729093989834,35.542709060101664,Housing
131689,27962,103727,21.23336041734693,78.76663958265307,Healthcare
75020,19488,55532,25.977072780591843,74.02292721940816,Transportation
20982,7929,13053,37.78953388618816,62.21046611381183,Housing
32136,320,31816,0.9957679860592481,99.00423201394075,Food
194714,49546,145168,25.445525231878552,74.55447476812145,Entertainment
29134,17043,12091,58.49866135786367,41.50133864213634,Food
67571,48223,19348,71.36641458613903,28.633585413860974,Transportation
109192,151,109041,0.13828851930544364,99.86171148069457,Healthcare
20452,16212,4240,79.26853119499316,20.731468805006845,Housing
113348,31276,82072,27.59289974238628,72.40710025761372,Healthcare
15206,9005,6201,59.220044719189794,40.779955280810206,Housing
21965,18146,3819,82.61324834964717,17.38675165035283,Housing
28084,21740,6344,77.41062526705598,22.589374732944027,Food
120595,6406,114189,5.311994692980638,94.68800530701937,Healthcare
151984,24890,127094,16.37672386567007,83.62327613432993,Entertainment
19516,11493,8023,58.89014142242262,41.10985857757738,Housing
162694,9241,153453,5.679988198704316,94.32001180129569,Entertainment
11262,1338,9924,11.88066062866276,88.11933937133723,Housing
42552,21493,21059,50.50996427899981,49.49003572100018,Food
67649,20108,47541,29.72401661517539,70.27598338482461,Transportation
13878,12784,1094,92.11701974347889,7.882980256521114,Housing
20951,12312,8639,58.76569137511336,41.23430862488664,Housing
128173,32283,95890,25.187051875199924,74.81294812480007,Healthcare
164243,39978,124265,24.34076338108778,75.65923661891222,Entertainment
19111,10789,8322,56.45439799068599,43.545602009314,Housing
167871,47229,120642,28.134102971924875,71.86589702807512,Entertainment
178757,17068,161689,9.548157554669187,90.45184244533081,Entertainment
137858,6608,131250,4.7933380725093935,95.20666192749061,Healthcare
18758,16311,2447,86.95489924298965,13.045100757010342,Housing
118434,14568,103866,12.300521809615482,87.69947819038451,Healthcare
113787,29283,84504,25.734925782382874,74.26507421761713,Healthcare
155841,15154,140687,9.724013577941621,90.27598642205838,Entertainment
96105,40934,55171,42.59299724259924,57.40700275740076,Transportation
54657,10302,44355,18.848454909709645,81.15154509029036,Transportation
61315,652,60663,1.0633613308325858,98.93663866916741,Transportation
10875,5592,5283,51.42068965517241,48.57931034482759,Housing
44643,14821,29822,33.19893376341196,66.80106623658804,Food
17715,16163,1552,91.23906294101045,8.760937058989557,Housing
75147,42687,32460,56.804662860792845,43.195337139207155,Transportation
15742,5442,10300,34.56994028712997,65.43005971287002,Housing
9492,660,8832,6.95322376738306,93.04677623261695,Housing
35152,17985,17167,51.16351843422849,48.83648156577151,Food
174313,23055,151258,13.226208028087406,86.7737919719126,Entertainment
135182,34312,100870,25.382077495524552,74.61792250447544,Healthcare
76708,33868,42840,44.1518485685978,55.8481514314022,Transportation
28226,11810,16416,41.840855948416355,58.159144051583645,Food
32120,20450,11670,63.66749688667497,36.33250311332503,Food
49666,5213,44453,10.496114041799219,89.50388595820078,Food
72031,21329,50702,29.610861989976538,70.38913801002347,Transportation
158099,36180,121919,22.884395220716133,77.11560477928387,Entertainment
8671,163,8508,1.8798293161111752,98.12017068388883,Housing
70055,17165,52890,24.502176861037757,75.49782313896223,Transportation
55436,8493,46943,15.320369435024173,84.67963056497582,Transportation
113974,17769,96205,15.590397810026849,84.40960218997316,Healthcare
79310,6382,72928,8.04690455175892,91.95309544824109,Transportation
26757,1117,25640,4.174608513659977,95.82539148634002,Food
84468,25605,58863,30.31325472368234,69.68674527631767,Transportation
39528,34057,5471,86.15917830398705,13.840821696012954,Food
80152,40006,40146,49.912665934724025,50.08733406527598,Transportation
21584,12144,9440,56.26389918458117,43.73610081541883,Housing
30481,8033,22448,26.35412224008399,73.64587775991602,Food
59970,35969,24001,59.978322494580624,40.021677505419376,Transportation
127795,42923,84872,33.58738604796745,66.41261395203256,Healthcare
131510,386,131124,0.29351380123184545,99.70648619876815,Healthcare
138624,46062,92562,33.228012465373965,66.77198753462605,Healthcare
169702,5769,163933,3.399488515161872,96.60051148483812,Entertainment
18636,5726,12910,30.725477570294053,69.27452242970594,Housing
43982,901,43081,2.0485653221772546,97.95143467782275,Food
151251,4758,146493,3.1457643255251204,96.85423567447488,Entertainment
25146,13929,11217,55.39250775471248,44.607492245287524,Food
117960,28522,89438,24.179382841641235,75.82061715835876,Healthcare
118031,3909,114122,3.311841804271759,96.68815819572824,Healthcare
9424,2949,6475,31.292444821731745,68.70755517826825,Housing
56462,38934,17528,68.95611207537813,31.04388792462187,Transportation
19637,12647,6990,64.40393135407649,35.59606864592351,Housing
90892,18015,72877,19.820226202526076,80.17977379747393,Transportation
109112,40888,68224,37.47342180511768,62.52657819488232,Healthcare
135248,10386,124862,7.679226310185733,92.32077368981426,Healthcare
163386,5950,157436,3.641682885926579,96.35831711407342,Entertainment
18785,12328,6457,65.62682991748736,34.373170082512644,Housing
103882,15668,88214,15.082497449028706,84.91750255097129,Healthcare
124112,48030,76082,38.69891710712904,61.30108289287095,Healthcare
35943,17458,18485,48.57134908048855,51.428650919511455,Food
54360,30669,23691,56.41832229580574,43.58167770419426,Transportation
47916,15916,32000,33.21646214208197,66.78353785791802,Food
26080,13983,12097,53.61579754601227,46.384202453987726,Food
122468,4870,117598,3.9765489760590524,96.02345102394095,Healthcare
32330,15332,16998,47.4234457160532,52.5765542839468,Food
17312,8906,8406,51.44408502772643,48.55591497227357,Housing
160339,14323,146016,8.932948315755992,91.067051684244,Entertainment
44724,16932,27792,37.858867722028435,62.14113227797156,Food
75672,25385,50287,33.5460936674067,66.45390633259329,Transportation
20682,3278,17404,15.849530993134126,84.15046900686588,Housing
20394,19262,1132,94.4493478474061,5.5506521525939005,Housing
68345,34241,34104,50.10022679054795,49.89977320945205,Transportation
98507,20968,77539,21.285796948440215,78.71420305155978,Transportation
12334,4290,8044,34.78190368088212,65.21809631911789,Housing
115052,4314,110738,3.7496088725098216,96.25039112749018,Healthcare
91421,48698,42723,53.26784874372409,46.73215125627591,Transportation
10120,2343,7777,23.152173913043477,76.84782608695652,Housing
22824,21165,1659,92.73133543638275,7.2686645636172456,Housing
62389,11319,51070,18.142621295420668,81.85737870457933,Transportation
28360,3176,25184,11.198871650211565,88.80112834978844,Food
104850,5639,99211,5.378159275154983,94.62184072484501,Healthcare
99820,18880,80940,18.914045281506713,81.0859547184933,Transportation
48031,4298,43733,8.948387499739752,91.05161250026025,Food
20485,1283,19202,6.263119355626068,93.73688064437393,Housing
40733,19506,21227,47.88746225419193,52.11253774580806,Food
25230,20668,4562,81.91835116924297,18.081648830757036,Food
58016,3130,54886,5.395063430777716,94.60493656922229,Transportation
122146,7903,114243,6.47012591488874,93.52987408511126,Healthcare
16467,2289,14178,13.900528329386045,86.09947167061395,Housing
104317,48082,56235,46.09219973733907,53.907800262660935,Healthcare
47674,9603,38071,20.143054914628518,79.85694508537148,Food
52912,8991,43921,16.99236468097974,83.00763531902025,Transportation
8202,4218,3984,51.42648134601316,48.57351865398683,Housing
19531,6588,12943,33.730991756694486,66.26900824330552,Housing
191998,20615,171383,10.737091011364702,89.2629089886353,Entertainment
20424,18852,1572,92.30317273795534,7.696827262044653,Housing
12470,7175,5295,57.53809141940658,42.46190858059342,Housing
48329,7910,40419,16.366984626207866,83.63301537379213,Food
190154,14862,175292,7.815770375590311,92.18422962440968,Entertainment
77941,49024,28917,62.89885939364391,37.10114060635609,Transportation
59639,4931,54708,8.268079612334212,91.7319203876658,Transportation
173332,39238,134094,22.637481826783283,77.36251817321673,Entertainment
24998,13869,11129,55.48043843507481,44.51956156492519,Housing
84593,10683,73910,12.628704502736632,87.37129549726336,Transportation
195704,12552,183152,6.413767730858848,93.58623226914116,Entertainment
47642,7366,40276,15.461147726795685,84.53885227320431,Food
47734,27043,20691,56.65353835840281,43.34646164159718,Food
104383,16449,87934,15.75831313528065,84.24168686471936,Healthcare
146640,48714,97926,33.22013093289689,66.77986906710312,Healthcare
62048,22113,39935,35.63853790613719,64.36146209386283,Transportation
25616,947,24669,3.6969081823860086,96.30309181761399,Food
27655,11984,15671,43.33393599710721,56.66606400289279,Food
21629,2430,19199,11.234916084886033,88.76508391511396,Housing
91001,36135,54866,39.70835485324337,60.291645146756636,Transportation
47928,1094,46834,2.2825905524954098,97.7174094475046,Food
86303,22228,64075,25.755767470423972,74.24423252957602,Transportation
152676,31280,121396,20.487830438313814,79.51216956168619,Entertainment
154577,47740,106837,30.88428420787051,69.11571579212948,Entertainment
140832,18975,121857,13.47350034083163,86.52649965916837,Healthcare
65776,11039,54737,16.782717100462175,83.21728289953782,Transportation
127154,29605,97549,23.28279094641144,76.71720905358856,Healthcare
117235,30654,86581,26.147481554143386,73.8525184458566,Healthcare
17557,9435,8122,53.7392493022726,46.2607506977274,Housing
100534,47018,53516,46.7682575049237,53.2317424950763,Healthcare
26717,310,26407,1.1603099150353708,98.83969008496463,Food
48667,25662,23005,52.72977582345326,47.27022417654674,Food
72552,48068,24484,66.25317014003748,33.74682985996251,Transportation
165197,18089,147108,10.949956718342342,89.05004328165765,Entertainment
198975,25733,173242,12.93278050006282,87.06721949993718,Entertainment
86618,9597,77021,11.079683206723775,88.92031679327623,Transportation
16707,13913,2794,83.27647094032442,16.723529059675585,Housing
22098,5177,16921,23.42745949859716,76.57254050140284,Housing
100006,37544,62462,37.54174749515029,62.45825250484971,Healthcare
27033,1252,25781,4.631376465801058,95.36862353419893,Food
81959,1695,80264,2.068107224343879,97.93189277565611,Transportation
57311,35167,22144,61.3616932177069,38.6383067822931,Transportation
108540,1263,107277,1.1636263128800441,98.83637368711996,Healthcare
120554,39489,81065,32.75627519617765,67.24372480382236,Healthcare
88217,19642,68575,22.265549723976104,77.73445027602389,Transportation
28863,14506,14357,50.25811592696532,49.74188407303468,Food
19087,6972,12115,36.52747943626552,63.47252056373448,Housing
150038,38758,111280,25.832122528959328,74.16787747104067,Entertainment
71160,3409,67751,4.790612703766161,95.20938729623384,Transportation
193186,11258,181928,5.827544439038026,94.17245556096198,Entertainment
199290,11145,188145,5.592352852626825,94.40764714737317,Entertainment
99593,5956,93637,5.9803399837337965,94.0196600162662,Transportation
130395,15402,114993,11.811802599792937,88.18819740020706,Healthcare
191253,9835,181418,5.1424029949857,94.8575970050143,Entertainment
15519,13669,1850,88.079128809846,11.920871190154005,Housing
110197,26279,83918,23.84729166855722,76.15270833144278,Healthcare
30580,20612,9968,67.40353172007848,32.59646827992152,Food
170783,27028,143755,15.825931152398073,84.17406884760193,Entertainment
121686,38502,83184,31.640451654257678,68.35954834574231,Healthcare
30471,14953,15518,49.072888976403796,50.927111023596204,Food
24157,10173,13984,42.11201722068137,57.88798277931863,Housing
34600,24658,9942,71.26589595375722,28.734104046242777,Food
76845,23447,53398,30.51206975079706,69.48793024920295,Transportation
197862,21242,176620,10.735765331392587,89.26423466860741,Entertainment
8055,4821,3234,59.85102420856611,40.14897579143389,Housing
170450,41205,129245,24.174244646523906,75.82575535347608,Entertainment
94651,23290,71361,24.60618482636211,75.39381517363789,Transportation
172722,48070,124652,27.830849573302764,72.16915042669724,Entertainment
30193,6622,23571,21.93223594872984,78.06776405127016,Food
117106,30279,86827,25.856062029272625,74.14393797072738,Healthcare
43647,11824,31823,27.09006346369739,72.90993653630261,Food
83160,17459,65701,20.994468494468492,79.00553150553151,Transportation
179355,7169,172186,3.9971007220317247,96.00289927796828,Entertainment
67065,30563,36502,45.572206068739284,54.427793931260716,Transportation
22755,19414,3341,85.3175126345858,14.682487365414195,Housing
29870,17945,11925,60.07700033478407,39.92299966521593,Food
172004,27571,144433,16.029278388874676,83.97072161112533,Entertainment
27824,22112,5712,79.47096032202415,20.52903967797585,Food
43062,2881,40181,6.6903534438716274,93.30964655612838,Food
18693,1177,17516,6.2964746161664795,93.70352538383352,Housing
184295,40677,143618,22.071678558832307,77.9283214411677,Entertainment
191107,40117,150990,20.99190505842277,79.00809494157724,Entertainment
91662,24502,67160,26.730815386965155,73.26918461303484,Transportation
137133,45037,92096,32.841839673893226,67.15816032610678,Healthcare
45119,22356,22763,49.54897050023272,50.45102949976729,Food
82306,17360,64946,21.092022452798094,78.9079775472019,Transportation
183515,41800,141715,22.77742963790426,77.22257036209574,Entertainment
74757,17861,56896,23.89207699613414,76.10792300386586,Transportation
59644,3823,55821,6.409697538729797,93.5903024612702,Transportation
189726,49212,140514,25.938458619272005,74.061541380728,Entertainment
19329,2159,17170,11.169744942832015,88.83025505716799,Housing
48987,32439,16548,66.21960928409578,33.78039071590422,Food
127585,44783,82802,35.100521221146685,64.89947877885331,Healthcare
173909,39311,134598,22.604350551150315,77.3956494488497,Entertainment
118616,37886,80730,31.940041815606662,68.05995818439334,Healthcare
65322,12646,52676,19.35948072624843,80.64051927375156,Transportation
63770,29318,34452,45.97459620511212,54.025403794887886,Transportation
113673,17932,95741,15.775074116104967,84.22492588389503,Healthcare
127913,17166,110747,13.420058946315075,86.57994105368493,Healthcare
137781,19547,118234,14.18700691677372,85.81299308322627,Healthcare
11304,3763,7541,33.289101203113944,66.71089879688606,Housing
74075,17824,56251,24.062099223759702,75.9379007762403,Transportation
83735,16691,67044,19.933122350271688,80.06687764972831,Transportation
128177,3343,124834,2.6081122198210287,97.39188778017898,Healthcare
194098,23439,170659,12.075858586899402,87.9241414131006,Entertainment
22226,11154,11072,50.18446864033115,49.81553135966886,Housing
171384,13042,158342,7.609811884423283,92.39018811557672,Entertainment
109035,8526,100509,7.819507497592516,92.18049250240749,Healthcare
90181,18402,71779,20.40562868009891,79.59437131990109,Transportation
95658,13882,81776,14.512116080202386,85.48788391979761,Transportation
12735,11296,1439,88.70043188064389,11.299568119356106,Housing
42642,16848,25794,39.51034191642043,60.48965808357957,Food
197522,49294,148228,24.956207409807515,75.04379259019248,Entertainment
42858,19627,23231,45.795417424984834,54.204582575015166,Food
29146,2775,26371,9.521032045563715,90.47896795443629,Food
33983,19953,14030,58.71465144336875,41.285348556631256,Food
152272,1607,150665,1.055348324051697,98.94465167594831,Entertainment
33773,1211,32562,3.585704556894561,96.41429544310543,Food
8645,7544,1101,87.26431463273569,12.735685367264315,Housing
198687,22765,175922,11.457719931349308,88.5422800686507,Entertainment
107464,42381,65083,39.437392987419045,60.56260701258096,Healthcare
36358,15804,20554,43.46773749931239,56.5322625006876,Food
28162,4321,23841,15.343370499254313,84.65662950074568,Food
42966,34754,8212,80.88721314527766,19.112786854722337,Food
54358,21263,33095,39.11659737297178,60.88340262702822,Transportation
44620,33710,10910,75.54908112953832,24.450918870461678,Food
61935,42537,19398,68.6800678130298,31.319932186970213,Transportation
34714,8488,26226,24.451230051276145,75.54876994872386,Food
190858,36499,154359,19.123641660291945,80.87635833970805,Entertainment
9081,512,8569,5.638145578680763,94.36185442131924,Housing
15812,12692,3120,80.2681507715659,19.7318492284341,Housing
177607,39916,137691,22.47433941229794,77.52566058770206,Entertainment
31882,3636,28246,11.404554293958974,88.59544570604103,Food
24028,19657,4371,81.80872315631763,18.19127684368237,Housing
24835,19477,5358,78.42560901952889,21.574390980471108,Housing
29382,19558,9824,66.56456333809815,33.435436661901846,Food
41926,34929,6997,83.31107188856556,16.688928111434432,Food
27463,9460,18003,34.4463459927903,65.5536540072097,Food
23708,17043,6665,71.88712670828411,28.11287329171588,Housing
32038,28129,3909,87.7988638491791,12.2011361508209,Food
154235,26720,127515,17.324213051512302,82.6757869484877,Entertainment
14988,2026,12962,13.517480651187617,86.48251934881237,Housing
176768,2040,174728,1.1540550325850834,98.84594496741491,Entertainment
63323,1469,61854,2.3198521864093617,97.68014781359064,Transportation
148928,14263,134665,9.577111087236785,90.42288891276321,Healthcare
125686,43481,82205,34.594942953073534,65.40505704692646,Healthcare
46058,28992,17066,62.946719353858185,37.05328064614182,Food
39679,12021,27658,30.295622369515364,69.70437763048464,Food
38172,27790,10382,72.80205386146915,27.19794613853086,Food
17866,4531,13335,25.361020933616924,74.63897906638307,Housing
192114,49994,142120,26.023090456707997,73.976909543292,Entertainment
9140,8458,682,92.5382932166302,7.461706783369804,Housing
49369,29327,20042,59.40367437055642,40.596325629443584,Food
87277,34523,52754,39.55566758710771,60.44433241289229,Transportation
196391,46052,150339,23.449139726362205,76.5508602736378,Entertainment
10524,9277,1247,88.15089319650323,11.849106803496769,Housing
109916,11158,98758,10.151388332908768,89.84861166709123,Healthcare
65836,26548,39288,40.324442554225655,59.67555744577435,Transportation
80021,42678,37343,53.33349995626148,46.666500043738516,Transportation
13395,2258,11137,16.857036207540126,83.14296379245988,Housing
12082,4183,7899,34.62175136566793,65.37824863433205,Housing
77008,35283,41725,45.81731768127987,54.18268231872013,Transportation
66092,2,66090,0.003026084851419234,99.99697391514857,Transportation
142104,48408,93696,34.065191690592805,65.9348083094072,Healthcare
172066,10844,161222,6.302232864133531,93.69776713586647,Entertainment
23920,13752,10168,57.491638795986624,42.508361204013376,Housing
168048,41516,126532,24.704846234409217,75.29515376559078,Entertainment
159820,48233,111587,30.17957702415217,69.82042297584783,Entertainment
190671,2067,188604,1.0840662712211087,98.9159337287789,Entertainment
170462,45222,125240,26.529079794910302,73.4709202050897,Entertainment
92148,38658,53490,41.95207709337153,58.04792290662847,Transportation
13084,277,12807,2.1170895750535004,97.8829104249465,Housing
93152,17040,76112,18.29268292682927,81.70731707317073,Transportation
159432,36918,122514,23.15595363540569,76.8440463645943,Entertainment
103578,8380,95198,8.090521153140628,91.90947884685937,Healthcare
22589,20932,1657,92.66457125149408,7.335428748505909,Housing
19421,12265,7156,63.1532876782864,36.84671232171361,Housing
198565,43833,154732,22.074887316495857,77.92511268350414,Entertainment
40451,3675,36776,9.085065882178437,90.91493411782156,Food
159711,41581,118130,26.035150991478357,73.96484900852164,Entertainment
122026,27503,94523,22.538639306377327,77.46136069362267,Healthcare
81009,46631,34378,57.562739942475524,42.437260057524476,Transportation
29525,28309,1216,95.88145639288739,4.118543607112617,Food
144135,37823,106312,26.241370936968817,73.7586290630312,Healthcare
138350,34735,103615,25.1066136610047,74.8933863389953,Healthcare
25894,1390,24504,5.368038927936974,94.63196107206304,Food
82960,13306,69654,16.039054966248795,83.96094503375122,Transportation
141128,3685,137443,2.6111048126523437,97.38889518734766,Healthcare
189117,17580,171537,9.295832738463492,90.70416726153651,Entertainment
157016,6856,150160,4.366433993987874,95.63356600601213,Entertainment
94654,41996,52658,44.367908382107466,55.632091617892534,Transportation
9093,4500,4593,49.488617617947874,50.511382382052126,Housing
149528,40655,108873,27.18888769996255,72.81111230003745,Healthcare
42346,36343,6003,85.82392669909791,14.176073300902093,Food
107573,17408,90165,16.182499326039064,83.81750067396095,Healthcare
82873,34815,48058,42.01006359127822,57.989936408721775,Transportation
58975,47145,11830,79.9406528189911,20.059347181008903,Transportation
129743,7758,121985,5.979513345614022,94.02048665438598,Healthcare
197729,14878,182851,7.524440016386063,92.47555998361393,Entertainment
71183,39373,31810,55.31236390711265,44.687636092887345,Transportation
22596,804,21792,3.5581518852894316,96.44184811471057,Housing
19101,7950,11151,41.620857546725304,58.3791424532747,Housing
19171,12582,6589,65.63037921861145,34.369620781388555,Housing
84675,18105,66570,21.38175376439327,78.61824623560673,Transportation
42297,35089,7208,82.95860226493605,17.041397735063953,Food
180079,30011,150068,16.665463491023385,83.33453650897663,Entertainment
13097,8640,4457,65.969305947927,34.030694052072995,Housing
162447,6304,156143,3.8806503044069762,96.11934969559303,Entertainment
121785,29672,92113,24.364248470665515,75.63575152933448,Healthcare
55913,21514,34399,38.477634897072235,61.522365102927765,Transportation
89710,46232,43478,51.53494593690782,48.46505406309218,Transportation
8917,6982,1935,78.2998766401256,21.700123359874397,Housing
124409,24241,100168,19.484924724095524,80.51507527590448,Healthcare
134550,24914,109636,18.516536603493126,81.48346339650688,Healthcare
83415,21040,62375,25.22328118443925,74.77671881556076,Transportation
194362,1622,192740,0.8345252672847574,99.16547473271524,Entertainment
148994,28539,120455,19.15446259580923,80.84553740419076,Healthcare
45516,13731,31785,30.16741365673609,69.8325863432639,Food
117601,2291,115310,1.9481126861166147,98.05188731388338,Healthcare
97986,17140,80846,17.49229481762701,82.50770518237299,Transportation
150616,45612,105004,30.283635204759126,69.71636479524088,Entertainment
8785,6139,2646,69.8804780876494,30.1195219123506,Housing
65090,4581,60509,7.037947457366724,92.96205254263327,Transportation
62564,46060,16504,73.62061249280737,26.379387507192636,Transportation
46673,5812,40861,12.4525957191524,87.5474042808476,Food
8780,6303,2477,71.78815489749431,28.211845102505695,Housing
29568,3815,25753,12.902462121212121,87.09753787878788,Food
129970,11561,118409,8.895129645302763,91.10487035469724,Healthcare
23485,11714,11771,49.87864594421971,50.12135405578029,Housing
138078,32779,105299,23.739480583438347,76.26051941656165,Healthcare
194259,4470,189789,2.3010516887248467,97.69894831127516,Entertainment
108574,15582,92992,14.351502201263655,85.64849779873634,Healthcare
88016,21740,66276,24.700054535538992,75.299945464461,Transportation
38901,14523,24378,37.333230508213155,62.666769491786845,Food
138041,49300,88741,35.71402699198064,64.28597300801935,Healthcare
19485,5797,13688,29.751090582499355,70.24890941750064,Housing
50428,31416,19012,62.29872293170461,37.70127706829539,Transportation
168749,5230,163519,3.099277625348891,96.90072237465111,Entertainment
15718,13851,1867,88.12189846036391,11.878101539636086,Housing
175278,26761,148517,15.267746094775156,84.73225390522484,Entertainment
56619,44891,11728,79.28610537098854,20.713894629011463,Transportation
48385,42571,5814,87.9838793014364,12.016120698563604,Food
99048,35518,63530,35.85938131007189,64.14061868992812,Transportation
15561,8258,7303,53.06856885804254,46.93143114195746,Housing
171315,23398,147917,13.657881679946298,86.3421183200537,Entertainment
27249,17232,10017,63.23901794561269,36.76098205438731,Food
43242,25380,17862,58.69293742195089,41.30706257804912,Food
45410,11110,34300,24.46597665712398,75.53402334287603,Food
172062,29178,142884,16.957840778324094,83.0421592216759,Entertainment
125108,28793,96315,23.014515458643732,76.98548454135626,Healthcare
59678,10292,49386,17.245886256241832,82.75411374375817,Transportation
144860,40076,104784,27.665332044732843,72.33466795526715,Healthcare
193951,12835,181116,6.617650849956948,93.38234915004305,Entertainment
18837,3716,15121,19.727132770611032,80.27286722938896,Housing
170873,13414,157459,7.850274765469091,92.1497252345309,Entertainment
43800,15194,28606,34.68949771689498,65.31050228310502,Food
9727,1854,7873,19.060347486378124,80.93965251362188,Housing
10969,3028,7941,27.605068830340052,72.39493116965996,Housing
9925,2056,7869,20.715365239294712,79.28463476070529,Housing
134316,30806,103510,22.93546561839245,77.06453438160756,Healthcare
82585,49228,33357,59.60888781255675,40.39111218744324,Transportation
28969,2716,26253,9.375539369671028,90.62446063032897,Food
191647,21021,170626,10.96860373499194,89.03139626500807,Entertainment
48148,45528,2620,94.55844479521475,5.441555204785246,Food
42751,41979,772,98.19419428785292,1.8058057121470843,Food
127069,1942,125127,1.5283035201347301,98.47169647986527,Healthcare
117951,4507,113444,3.821078244355707,96.1789217556443,Healthcare
101302,43319,57983,42.76223569129928,57.23776430870071,Healthcare
184814,33805,151009,18.291363208414946,81.70863679158505,Entertainment
131482,944,130538,0.7179689995588749,99.28203100044112,Healthcare
67672,17502,50170,25.862986168577844,74.13701383142215,Transportation
187575,869,186706,0.46328135412501664,99.53671864587498,Entertainment
36476,18557,17919,50.874547647768395,49.125452352231605,Food
22288,6540,15748,29.343144292893037,70.65685570710696,Housing
45617,13331,32286,29.22375430212421,70.7762456978758,Food
125010,19310,105700,15.446764258859291,84.55323574114071,Healthcare
11850,689,11161,5.814345991561182,94.18565400843882,Housing
77844,9046,68798,11.620677251939778,88.37932274806022,Transportation
13791,9925,3866,71.96722500181278,28.03277499818722,Housing
85758,41111,44647,47.93838475710721,52.06161524289279,Transportation
149818,41168,108650,27.478674124604517,72.52132587539548,Healthcare
161986,28707,133279,17.721901892756165,82.27809810724384,Entertainment
160923,48154,112769,29.923628070567908,70.07637192943209,Entertainment
45046,26327,18719,58.44470097233939,41.55529902766062,Food
37225,30836,6389,82.83680322364003,17.163196776359975,Food
120324,33894,86430,28.16894385160068,71.83105614839931,Healthcare
153007,7025,145982,4.59129320880744,95.40870679119256,Entertainment
44457,9259,35198,20.82686641023911,79.1731335897609,Food
128392,24187,104205,18.838401146488877,81.16159885351112,Healthcare
47554,24366,23188,51.23859191655802,48.76140808344198,Food
14371,14188,183,98.72660218495581,1.2733978150441863,Housing
58081,23207,34874,39.95626797059279,60.0437320294072,Transportation
87942,17273,70669,19.641354529121465,80.35864547087853,Transportation
158067,12089,145978,7.648022673929409,92.3519773260706,Entertainment
131972,3201,128771,2.42551450307641,97.57448549692359,Healthcare
36348,15504,20844,42.65434136678772,57.34565863321228,Food
20112,7106,13006,35.3321400159109,64.6678599840891,Housing
35292,18542,16750,52.538818995806416,47.461181004193584,Food
14776,10867,3909,73.5449377368706,26.4550622631294,Housing
11648,1537,10111,13.195398351648352,86.80460164835165,Housing
10454,8996,1458,86.05318538358523,13.946814616414768,Housing
19182,2196,16986,11.448232718173287,88.55176728182671,Housing
78470,3845,74625,4.8999617688288515,95.10003823117114,Transportation
21076,16524,4552,78.40197380907193,21.598026190928067,Housing
47058,35892,11166,76.27183475710825,23.728165242891748,Food
130195,34837,95358,26.757555973731712,73.24244402626829,Healthcare
49230,36635,12595,74.41600650010156,25.58399349989844,Food
96613,42321,54292,43.80466396861706,56.195336031382936,Transportation
19948,10207,9741,51.16803689592941,48.83196310407059,Housing
149332,796,148536,0.5330404735756569,99.46695952642435,Healthcare
77207,20256,56951,26.235963060344268,73.76403693965572,Transportation
33636,33065,571,98.30241408015222,1.697585919847782,Food
147218,9088,138130,6.1731581735929035,93.82684182640709,Healthcare
22397,8787,13610,39.23293298209581,60.76706701790419,Housing
19431,8210,11221,42.25207143224744,57.74792856775256,Housing
23422,5258,18164,22.448979591836736,77.55102040816327,Housing
14563,9465,5098,64.99347661882854,35.00652338117146,Housing
164920,33337,131583,20.214043172447248,79.78595682755275,Entertainment
182709,10246,172463,5.607824464038444,94.39217553596156,Entertainment
18808,6043,12765,32.12994470438112,67.87005529561888,Housing
38281,24118,14163,63.0025338940989,36.9974661059011,Food
13319,6609,6710,49.62084240558601,50.37915759441399,Housing
177342,43388,133954,24.465721600072175,75.53427839992783,Entertainment
59305,14610,44695,24.63535958182278,75.36464041817722,Transportation
191535,5906,185629,3.0835095413370923,96.9164904586629,Entertainment
107241,4942,102299,4.608312119431933,95.39168788056807,Healthcare
24237,9203,15034,37.97087098238231,62.02912901761769,Housing
196729,24363,172366,12.384040990397958,87.61595900960204,Entertainment
66959,12634,54325,18.868262668199943,81.13173733180005,Transportation
18817,10921,7896,58.0379444119679,41.9620555880321,Housing
62381,42645,19736,68.36216155560186,31.637838444398135,Transportation
29056,5402,23654,18.591685022026432,81.40831497797357,Food
114640,4674,109966,4.077110956036288,95.9228890439637,Healthcare
9917,4234,5683,42.69436321468186,57.305636785318136,Housing
14269,3818,10451,26.757306048076252,73.24269395192375,Housing
36972,32954,4018,89.13231634750622,10.86768365249378,Food
192239,4158,188081,2.16293259952455,97.83706740047545,Entertainment
11051,4,11047,0.036195819382861275,99.96380418061715,Housing
80337,23112,57225,28.7688113820531,71.2311886179469,Transportation
36539,20918,15621,57.248419496975835,42.751580503024165,Food
163213,21653,141560,13.266712823120708,86.73328717687929,Entertainment
100705,5452,95253,5.413832481008887,94.58616751899112,Healthcare
66662,31555,35107,47.335813506945485,52.66418649305451,Transportation
143169,24086,119083,16.82347435548198,83.17652564451802,Healthcare
11744,10878,866,92.62602179836512,7.373978201634877,Housing
174316,17422,156894,9.994492760274444,90.00550723972556,Entertainment
15415,6771,8644,43.924748621472595,56.07525137852741,Housing
42232,37477,4755,88.74076529645765,11.259234703542338,Food
8514,7294,1220,85.67066008926474,14.329339910735259,Housing
100634,6822,93812,6.779021006816782,93.22097899318322,Healthcare
23522,19440,4082,82.64603350055268,17.353966499447328,Housing
32799,20175,12624,61.51102167749016,38.48897832250983,Food
175667,43794,131873,24.930123472251474,75.06987652774852,Entertainment
199555,22951,176604,11.50108992508331,88.4989100749167,Entertainment
176409,10777,165632,6.109098742127669,93.89090125787233,Entertainment
187919,30847,157072,16.4150511656618,83.5849488343382,Entertainment
179356,7645,171711,4.262472401257834,95.73752759874216,Entertainment
153626,38237,115389,24.889667113639618,75.11033288636038,Entertainment
23346,18978,4368,81.29015677203803,18.709843227961965,Housing
49701,14820,34881,29.818313514818616,70.18168648518139,Food
51751,4027,47724,7.781492145079322,92.21850785492067,Transportation
47291,7860,39431,16.62049861495845,83.37950138504155,Food
144323,36000,108323,24.94404911206114,75.05595088793886,Healthcare
79049,19669,59380,24.88203519336108,75.11796480663891,Transportation
183972,42351,141621,23.020350922966536,76.97964907703346,Entertainment
106963,38197,68766,35.71047932462627,64.28952067537372,Healthcare
95663,5154,90509,5.3876629417852255,94.61233705821478,Transportation
82780,29958,52822,36.189900942256585,63.81009905774342,Transportation
185925,30211,155714,16.24902514454753,83.75097485545247,Entertainment
47485,18103,29382,38.123617984626726,61.876382015373274,Food
12612,9710,2902,76.99016809387884,23.009831906121153,Housing
170100,4274,165826,2.512639623750735,97.48736037624927,Entertainment
166763,3465,163298,2.0777990321594118,97.9222009678406,Entertainment
11687,10343,1344,88.50004278257893,11.499957217421066,Housing
49834,33342,16492,66.90612834610909,33.093871653890915,Food
128780,29968,98812,23.270694207175026,76.72930579282497,Healthcare
158103,46637,111466,29.49785899065799,70.50214100934201,Entertainment
194304,46770,147534,24.070528656126484,75.92947134387352,Entertainment
120283,47396,72887,39.40373951431208,60.596260485687914,Healthcare
24391,18939,5452,77.64749292771924,22.35250707228076,Housing
115226,16693,98533,14.487181712460728,85.51281828753928,Healthcare
64441,7960,56481,12.352384351577411,87.64761564842259,Transportation
29627,19289,10338,65.10615317109394,34.893846828906064,Food
44573,4136,40437,9.27916002961434,90.72083997038565,Food
44050,17772,26278,40.34506242905789,59.65493757094211,Food
34655,2841,31814,8.197951233588228,91.80204876641177,Food
42887,6130,36757,14.293375614988225,85.70662438501178,Food
12018,11302,716,94.04226992844067,5.957730071559328,Housing
28667,4277,24390,14.919593958209788,85.08040604179021,Food
109617,10440,99177,9.52407017159747,90.47592982840253,Healthcare
162873,47719,115154,29.29828762287181,70.70171237712819,Entertainment
15400,3170,12230,20.584415584415584,79.41558441558442,Housing
28318,12212,16106,43.12451444311039,56.875485556889615,Food
18775,12265,6510,65.32623169107856,34.67376830892144,Housing
23887,20808,3079,87.1101435927492,12.889856407250806,Housing
69421,23761,45660,34.22739516860892,65.77260483139108,Transportation
180724,20405,160319,11.290697417055842,88.70930258294416,Entertainment
176695,47376,129319,26.812303687144514,73.1876963128555,Entertainment
117444,32250,85194,27.459895780116483,72.54010421988352,Healthcare
21127,14482,6645,68.54735646329343,31.45264353670658,Housing
8417,8306,111,98.68124034691695,1.3187596530830463,Housing
78992,17801,61191,22.53519343731011,77.46480656268989,Transportation
162876,10686,152190,6.560819273557798,93.4391807264422,Entertainment
123872,9721,114151,7.847616894859209,92.15238310514079,Healthcare
62420,33697,28723,53.984299903876966,46.015700096123034,Transportation
10660,10403,257,97.58911819887429,2.4108818011257034,Housing
196486,24295,172191,12.364748633490427,87.63525136650956,Entertainment
198323,16448,181875,8.293541344170873,91.70645865582912,Entertainment
21184,3343,17841,15.780777945619334,84.21922205438067,Housing
61979,24599,37380,39.6892495845367,60.310750415463296,Transportation
185681,48232,137449,25.975732573607424,74.02426742639257,Entertainment
26261,7701,18560,29.324854346749934,70.67514565325007,Food
58656,18582,40074,31.67962356792144,68.32037643207856,Transportation
153831,21404,132427,13.913970526096819,86.08602947390318,Entertainment
86576,24260,62316,28.021622620587692,71.97837737941231,Transportation
28118,4161,23957,14.798349811508643,85.20165018849136,Food
164991,6441,158550,3.9038493008709567,96.09615069912904,Entertainment
140187,35139,105048,25.065804960517024,74.93419503948297,Healthcare
26469,24309,2160,91.83951037062224,8.160489629377762,Food
13530,12936,594,95.60975609756098,4.390243902439024,Housing
20875,1622,19253,7.770059880239522,92.22994011976049,Housing
8282,1898,6384,22.917169765757066,77.08283023424293,Housing
49481,47691,1790,96.38244982922738,3.6175501707726196,Food
165381,18212,147169,11.012147707414998,88.987852292585,Entertainment
199702,21125,178577,10.5782616097986,89.4217383902014,Entertainment
159964,15437,144527,9.650296316671252,90.34970368332876,Entertainment
146799,5374,141425,3.660787880026431,96.33921211997357,Healthcare
165649,40835,124814,24.651522194519735,75.34847780548026,Entertainment
93566,6256,87310,6.686189427783597,93.31381057221641,Transportation
63164,46057,17107,72.91653473497563,27.08346526502438,Transportation
182636,2446,180190,1.3392759368361111,98.66072406316388,Entertainment
14542,6936,7606,47.69632787787099,52.30367212212901,Housing
167442,30716,136726,18.34426249089237,81.65573750910762,Entertainment
17823,9207,8616,51.65797003871402,48.342029961285974,Housing
170527,28317,142210,16.605581520814887,83.39441847918512,Entertainment
59064,834,58230,1.4120276310442907,98.58797236895572,Transportation
159865,31510,128355,19.71038063365965,80.28961936634035,Entertainment
45828,33040,12788,72.09566204067383,27.904337959326174,Food
39386,17061,22325,43.31742243436754,56.682577565632464,Food
167603,605,166998,0.3609720589726914,99.63902794102731,Entertainment
152119,663,151456,0.43584299134230436,99.56415700865769,Entertainment
161409,3484,157925,2.1584917817469904,97.84150821825301,Entertainment
100816,36534,64282,36.23829550864942,63.76170449135058,Healthcare
57524,49777,7747,86.53257770669633,13.467422293303667,Transportation
73239,13795,59444,18.835593058343232,81.16440694165676,Transportation
34952,3174,31778,9.081025406271458,90.91897459372854,Food
38852,5296,33556,13.631215896221557,86.36878410377844,Food
184710,31533,153177,17.07162579178171,82.92837420821829,Entertainment
100307,35843,64464,35.733298772767604,64.26670122723239,Healthcare
31855,30614,1241,96.1042222571025,3.8957777428975042,Food
120955,9638,111317,7.968252655946427,92.03174734405357,Healthcare
71184,40438,30746,56.807709597662395,43.192290402337605,Transportation
31476,28253,3223,89.76045240818401,10.239547591815986,Food
28918,23464,5454,81.13977453489176,18.860225465108236,Food
96798,37792,59006,39.04212896960681,60.957871030393186,Transportation
198952,8752,190200,4.399051027383489,95.60094897261651,Entertainment
45902,40775,5127,88.8305520456625,11.169447954337501,Food
77564,22139,55425,28.5428807178588,71.4571192821412,Transportation
15543,7587,7956,48.81297046902142,51.18702953097858,Housing
139029,24855,114174,17.8775651123147,82.1224348876853,Healthcare
191411,33665,157746,17.58780843316215,82.41219156683786,Entertainment
64482,25411,39071,39.40789677739524,60.592103222604756,Transportation
26908,4837,22071,17.976066597294484,82.02393340270552,Food
47203,16766,30437,35.51892888163888,64.48107111836111,Food
19565,8179,11386,41.80424226935855,58.19575773064145,Housing
19157,5951,13206,31.06436289606932,68.93563710393067,Housing
135018,35577,99441,26.349820023996802,73.6501799760032,Healthcare
26448,19583,6865,74.04340592861463,25.956594071385357,Food
167810,18688,149122,11.136404266730231,88.86359573326978,Entertainment
146997,46947,100050,31.937386477275048,68.06261352272496,Healthcare
49015,30936,18079,63.11537284504743,36.88462715495257,Food
69231,26708,42523,38.578093628576795,61.421906371423205,Transportation
20464,1633,18831,7.979867083659109,92.02013291634088,Housing
11141,7419,3722,66.59186787541513,33.40813212458487,Housing
18161,1908,16253,10.506029403667199,89.4939705963328,Housing
156243,28704,127539,18.3713830379601,81.6286169620399,Entertainment
34583,8418,26165,24.341439435560826,75.65856056443917,Food
30472,17272,13200,56.68154371226044,43.318456287739565,Food
12790,10527,2263,82.30648944487882,17.69351055512119,Housing
15069,9591,5478,63.64722277523393,36.35277722476607,Housing
9591,6183,3408,64.46668751954958,35.53331248045043,Housing
19531,14721,4810,75.37248476780502,24.62751523219497,Housing
45667,1161,44506,2.5423172093634356,97.45768279063657,Food
89896,29960,59936,33.32740055174869,66.67259944825132,Transportation
97149,27452,69697,28.257624885485182,71.74237511451483,Transportation
85799,8524,77275,9.934847725497967,90.06515227450204,Transportation
44386,18122,26264,40.82818906862524,59.17181093137476,Food
26516,15906,10610,59.986423291597525,40.013576708402475,Food
44042,6080,37962,13.805004314063849,86.19499568593615,Food
15043,137,14906,0.9107225952270158,99.08927740477299,Housing
82695,24230,58465,29.30044138097829,70.6995586190217,Transportation
72726,9524,63202,13.095729175260567,86.90427082473944,Transportation
76614,47268,29346,61.69629571618764,38.30370428381236,Transportation
44703,25566,19137,57.19079256425743,42.80920743574257,Food
171519,8669,162850,5.054250549501804,94.9457494504982,Entertainment
170244,29379,140865,17.25699584126313,82.74300415873688,Entertainment
177278,1933,175345,1.0903778246595741,98.90962217534043,Entertainment
64124,28132,35992,43.87124945418252,56.128750545817475,Transportation
57728,7764,49964,13.449279379157428,86.55072062084257,Transportation
21615,12132,9483,56.12768910478834,43.872310895211655,Housing
33950,24518,9432,72.2179675994109,27.782032400589102,Food
34083,13009,21074,38.16858844585277,61.83141155414723,Food
29138,12236,16902,41.99327338870204,58.006726611297964,Food
133078,3952,129126,2.969686950510227,97.03031304948976,Healthcare
67377,37138,30239,55.11969960075397,44.88030039924603,Transportation
135630,45610,90020,33.62825333628253,66.37174666371747,Healthcare
49875,38607,11268,77.40751879699248,22.59248120300752,Food
34096,23047,11049,67.59443923040826,32.40556076959174,Food
184736,1852,182884,1.0025116923609907,98.99748830763902,Entertainment
18178,7851,10327,43.18956980966003,56.810430190339964,Housing
67359,16607,50752,24.65446339761576,75.34553660238424,Transportation
21467,19627,1840,91.4287045232217,8.57129547677831,Housing
14142,12014,2128,84.95262339131665,15.047376608683354,Housing
169196,45413,123783,26.84046904182132,73.15953095817868,Entertainment
42486,20805,21681,48.96907216494845,51.03092783505154,Food
22820,7574,15246,33.190184049079754,66.80981595092025,Housing
69511,12120,57391,17.436089252060825,82.56391074793918,Transportation
189858,28183,161675,14.844252019930684,85.15574798006932,Entertainment
73801,14547,59254,19.71111502554166,80.28888497445834,Transportation
11687,596,11091,5.099683408915889,94.9003165910841,Housing
65053,6044,59009,9.29088589304106,90.70911410695895,Transportation
171237,32615,138622,19.04670135543136,80.95329864456863,Entertainment
136777,10060,126717,7.355037762196861,92.64496223780314,Healthcare
40455,30480,9975,75.34297367445309,24.657026325546905,Food
18561,16901,1660,91.05651635148968,8.943483648510316,Housing
181829,2504,179325,1.3771180614753422,98.62288193852466,Entertainment
58354,15690,42664,26.887616958563253,73.11238304143674,Transportation
53575,20169,33406,37.64629024731684,62.35370975268315,Transportation
170194,21248,148946,12.484576424550808,87.51542357544919,Entertainment
18361,16369,1992,89.15091770600729,10.849082293992703,Housing
177745,18682,159063,10.510562885031929,89.48943711496807,Entertainment
10176,3743,6433,36.78262578616352,63.21737421383647,Housing
21859,17692,4167,80.93691385699255,19.063086143007457,Housing
110132,24091,86041,21.87465949950968,78.12534050049032,Healthcare
66247,25761,40486,38.88628919045391,61.1137108095461,Transportation
67501,48824,18677,72.33078028473652,27.669219715263477,Transportation
104479,48844,55635,46.75006460628451,53.24993539371549,Healthcare
121231,18680,102551,15.408600110532786,84.59139988946721,Healthcare
23374,22126,1248,94.6607341490545,5.3392658509454956,Housing
37198,29511,7687,79.33491047905802,20.665089520941986,Food
20338,17100,3238,84.07906382141803,15.920936178581965,Housing
21767,11308,10459,51.95019984380025,48.04980015619975,Housing
41082,26347,14735,64.13271018937733,35.86728981062265,Food
56334,46638,9696,82.78836936840985,17.211630631590157,Transportation
184141,14234,169907,7.729946073932475,92.27005392606752,Entertainment
17765,1828,15937,10.289895862651282,89.71010413734872,Housing
38655,29825,8830,77.15690078903117,22.843099210968827,Food
12882,6012,6870,46.66977177456917,53.33022822543083,Housing
46945,40228,6717,85.69176696133773,14.308233038662262,Food
122561,2613,119948,2.1319995757214776,97.86800042427852,Healthcare
32243,9257,22986,28.71010762025866,71.28989237974133,Food
180341,19338,161003,10.723019169240494,89.2769808307595,Entertainment
67095,36463,30632,54.34533124673969,45.6546687532603,Transportation
77975,24036,53939,30.82526450785508,69.17473549214492,Transportation
71379,44324,27055,62.09669510640384,37.90330489359616,Transportation
9581,7714,1867,80.51351633441186,19.486483665588143,Housing
82315,48697,33618,59.159326975642344,40.84067302435765,Transportation
152996,39097,113899,25.554262856545268,74.44573714345472,Entertainment
44879,33672,11207,75.02840972392433,24.97159027607567,Food
180857,37630,143227,20.806493528035965,79.19350647196404,Entertainment
17524,6456,11068,36.84090390321844,63.15909609678155,Housing
156244,32628,123616,20.882721896520824,79.11727810347917,Entertainment
151649,15677,135972,10.337687686697572,89.66231231330242,Entertainment
108748,45211,63537,41.5740979144444,58.42590208555559,Healthcare
42865,22614,20251,52.75632800653214,47.24367199346786,Food
183501,19897,163604,10.842992681238794,89.1570073187612,Entertainment
22451,17301,5150,77.06115540510446,22.93884459489555,Housing
41527,12479,29048,30.05032870180846,69.94967129819155,Food
183767,15942,167825,8.675115771602083,91.32488422839792,Entertainment
117882,1379,116503,1.1698138816782884,98.83018611832172,Healthcare
94877,26624,68253,28.06159553948797,71.93840446051203,Transportation
81358,6302,75056,7.746011455542172,92.25398854445783,Transportation
59885,2723,57162,4.547048509643483,95.45295149035653,Transportation
115780,5492,110288,4.743479011919157,95.25652098808084,Healthcare
99306,19977,79329,20.116609268322154,79.88339073167784,Transportation
73575,26902,46673,36.56405028882093,63.43594971117908,Transportation
43636,25628,18008,58.73132276102301,41.26867723897699,Food
108723,22631,86092,20.815282874828693,79.18471712517132,Healthcare
14968,11134,3834,74.38535542490646,25.614644575093532,Housing
20380,19889,491,97.59077526987242,2.409224730127576,Housing
42417,17695,24722,41.7167645047976,58.28323549520239,Food
121247,20561,100686,16.957945351225185,83.04205464877481,Healthcare
171193,47259,123934,27.605684811878987,72.394315188121,Entertainment
92373,48780,43593,52.807638595693554,47.19236140430645,Transportation
98218,44610,53608,45.41937323097599,54.58062676902401,Transportation
13724,5897,7827,42.9685222967065,57.0314777032935,Housing
196251,19861,176390,10.120203209155623,89.87979679084438,Entertainment
146878,14847,132031,10.108389275453098,89.8916107245469,Healthcare
21865,9569,12296,43.76400640292705,56.235993597072955,Housing
55939,12150,43789,21.720087952948745,78.27991204705125,Transportation
17474,7526,9948,43.06970355957422,56.93029644042578,Housing
196736,28931,167805,14.705493656473651,85.29450634352635,Entertainment
47445,42058,5387,88.6458004004637,11.354199599536305,Food
188958,23057,165901,12.202182495581027,87.79781750441897,Entertainment
9696,1946,7750,20.07013201320132,79.92986798679867,Housing
100395,47403,52992,47.21649484536082,52.78350515463918,Healthcare
155703,8347,147356,5.360847254067038,94.63915274593296,Entertainment
14445,14042,403,97.21010730356525,2.7898926964347526,Housing
26553,18504,8049,69.68704101231499,30.312958987685008,Food
141436,9481,131955,6.70338527673294,93.29661472326706,Healthcare
77633,12856,64777,16.559968054822047,83.44003194517795,Transportation
162547,2154,160393,1.325155185884698,98.6748448141153,Entertainment
45007,37167,7840,82.58048747972538,17.419512520274623,Food
117376,37996,79380,32.37118320610687,67.62881679389314,Healthcare
16682,1072,15610,6.426087999040882,93.57391200095911,Housing
60757,7953,52804,13.089849729249304,86.91015027075069,Transportation
91301,49714,41587,54.450663190983676,45.54933680901633,Transportation
25049,19950,5099,79.6438979599984,20.3561020400016,Food
13287,11905,1382,89.59885602468577,10.401143975314216,Housing
54663,37094,17569,67.85942959588753,32.140570404112474,Transportation
128174,9395,118779,7.329879694789895,92.6701203052101,Healthcare
72771,42770,30001,58.77341248574295,41.22658751425705,Transportation
79887,34783,45104,43.54025060397812,56.459749396021884,Transportation
40792,35312,5480,86.5659933320259,13.434006667974113,Food
31672,23067,8605,72.83089163930285,27.169108360697148,Food
12212,7970,4242,65.263675073698,34.736324926302,Housing
11052,6574,4478,59.482446615997105,40.517553384002895,Housing
50738,16619,34119,32.754542946115336,67.24545705388466,Transportation
150132,25692,124440,17.11294061226121,82.88705938773879,Entertainment
15674,1364,14310,8.702309557228531,91.29769044277147,Housing
132693,15768,116925,11.883068436164681,88.11693156383532,Healthcare
8899,21,8878,0.23598157096302955,99.76401842903697,Housing
72073,15479,56594,21.476835985736685,78.52316401426332,Transportation
51832,28511,23321,55.00655965426764,44.99344034573237,Transportation
193057,13317,179740,6.897962777832453,93.10203722216754,Entertainment
100511,11596,88915,11.537045696490932,88.46295430350906,Healthcare
98128,46008,52120,46.88570030979945,53.11429969020055,Transportation
166677,39632,127045,23.77772578100158,76.22227421899842,Entertainment
172926,5615,167311,3.247053653007645,96.75294634699235,Entertainment
182533,47229,135304,25.874225482515488,74.12577451748452,Entertainment
70157,20300,49857,28.935102698233962,71.06489730176604,Transportation
19559,3368,16191,17.21969425839767,82.78030574160233,Housing
11841,10197,1644,86.11603749683304,13.883962503166963,Housing
145335,2526,142809,1.7380534626896482,98.26194653731035,Healthcare
49996,2936,47060,5.872469797583807,94.1275302024162,Food
172057,41028,131029,23.845586055783837,76.15441394421616,Entertainment
125977,13142,112835,10.432062995626186,89.5679370043738,Healthcare
20089,10142,9947,50.48534023595003,49.51465976404998,Housing
60533,13518,47015,22.33162076883683,77.66837923116316,Transportation
173217,2581,170636,1.4900385066130921,98.50996149338691,Entertainment
96234,36855,59379,38.29727539123387,61.70272460876613,Transportation
29587,25006,4581,84.51684861594619,15.483151384053809,Food
138840,10248,128592,7.3811581676750215,92.61884183232499,Healthcare
38037,19933,18104,52.40423797881011,47.59576202118989,Food
11453,6675,4778,58.281672924124685,41.718327075875315,Housing
133224,9854,123370,7.396565183450429,92.60343481654957,Healthcare
161173,18680,142493,11.590030588249894,88.40996941175011,Entertainment
30671,24099,6572,78.5725930031626,21.4274069968374,Food
13016,6881,6135,52.86570374923172,47.13429625076829,Housing
66413,25596,40817,38.54064716245313,61.45935283754687,Transportation
43734,19157,24577,43.80344811816893,56.19655188183107,Food
95713,6273,89440,6.55396863539958,93.44603136460043,Transportation
183349,32209,151140,17.567044270762317,82.43295572923768,Entertainment
24044,5469,18575,22.745799367825654,77.25420063217435,Housing
38304,6207,32097,16.204573934837093,83.7954260651629,Food
45246,23790,21456,52.57923352340539,47.420766476594615,Food
18238,6207,12031,34.0333369887049,65.9666630112951,Housing
121410,20434,100976,16.830574087801665,83.16942591219834,Healthcare
31733,2513,29220,7.919200831941511,92.08079916805849,Food
193810,37117,156693,19.151230586657036,80.84876941334296,Entertainment
149245,21545,127700,14.43599450567858,85.56400549432142,Healthcare
77116,37376,39740,48.467244151667614,51.53275584833238,Transportation
100304,29756,70548,29.665815919604405,70.3341840803956,Healthcare
124941,41882,83059,33.521422111236504,66.4785778887635,Healthcare
11273,4538,6735,40.25547769005588,59.74452230994412,Housing
133594,43923,89671,32.8779735616869,67.1220264383131,Healthcare
21832,11362,10470,52.042872847196776,47.957127152803224,Housing
40524,27405,13119,67.62659164939295,32.37340835060705,Food
112455,48217,64238,42.87670623805078,57.12329376194922,Healthcare
34063,10234,23829,30.04432962451927,69.95567037548072,Food
154353,184,154169,0.11920727164357026,99.88079272835643,Entertainment
167853,24500,143353,14.596104925142834,85.40389507485716,Entertainment
32100,17874,14226,55.68224299065421,44.31775700934579,Food
55535,26469,29066,47.661834878905196,52.338165121094804,Transportation
104302,7207,97095,6.9097428620735935,93.0902571379264,Healthcare
197579,49007,148572,24.80374938632142,75.19625061367859,Entertainment
36123,21322,14801,59.02610525150182,40.97389474849818,Food
167668,16035,151633,9.563542238232698,90.4364577617673,Entertainment
166951,15752,151199,9.43510371306551,90.5648962869345,Entertainment
156126,4370,151756,2.799021303306304,97.2009786966937,Entertainment
85419,46368,39051,54.28300495205984,45.71699504794016,Transportation
20722,12924,7798,62.36849724930026,37.63150275069974,Housing
153666,16308,137358,10.61262738666979,89.3873726133302,Entertainment
87459,38889,48570,44.46540664768634,55.53459335231366,Transportation
82747,2460,80287,2.9729174471582054,97.02708255284179,Transportation
39694,27241,12453,68.62750037789085,31.372499622109135,Food
11716,3414,8302,29.139638101741212,70.86036189825879,Housing
111168,35092,76076,31.56663788140472,68.43336211859527,Healthcare
79803,24795,55008,31.070260516521937,68.92973948347807,Transportation
76014,27928,48086,36.74060041571289,63.2593995842871,Transportation
47105,16195,30910,34.38063899798323,65.61936100201677,Food
48245,8169,40076,16.932324593222095,83.06767540677791,Food
47196,5606,41590,11.878125264852955,88.12187473514705,Food
129012,37275,91737,28.892661147800204,71.1073388521998,Healthcare
17714,1627,16087,9.184825561702608,90.81517443829739,Housing
156473,22380,134093,14.302787062304677,85.69721293769533,Entertainment
115156,13006,102150,11.294244329431379,88.70575567056862,Healthcare
98076,10794,87282,11.005750642358986,88.99424935764101,Transportation
142426,9387,133039,6.590791007259911,93.40920899274009,Healthcare
134315,38976,95339,29.01835238059785,70.98164761940215,Healthcare
22846,281,22565,1.2299746126236542,98.77002538737635,Housing
36564,30497,6067,83.40717645771797,16.592823542282026,Food
85954,49177,36777,57.21316052772413,42.786839472275865,Transportation
171471,6220,165251,3.6274355430364316,96.37256445696357,Entertainment
31752,16881,14871,53.16515495086923,46.83484504913076,Food
18103,16986,1117,93.8297519748108,6.170248025189195,Housing
48818,29813,19005,61.06968741038141,38.93031258961858,Food
98522,46946,51576,47.65027100546071,52.34972899453929,Transportation
91102,17276,73826,18.963359750609207,81.03664024939079,Transportation
64747,37036,27711,57.201105842741754,42.798894157258246,Transportation
182420,16668,165752,9.137156013595,90.862843986405,Entertainment
22373,14565,7808,65.10079113216824,34.89920886783176,Housing
13237,559,12678,4.223011256326963,95.77698874367304,Housing
167662,16782,150880,10.009423721534993,89.990576278465,Entertainment
174950,7693,167257,4.397256358959703,95.6027436410403,Entertainment
137635,10139,127496,7.366585534202782,92.63341446579722,Healthcare
199632,10654,188978,5.33681974833694,94.66318025166306,Entertainment
92466,21113,71353,22.833257629831504,77.16674237016849,Transportation
9753,8100,1653,83.05136880959705,16.948631190402953,Housing
183979,9218,174761,5.010354442626604,94.9896455573734,Entertainment
21411,15233,6178,71.14567278501704,28.85432721498295,Housing
165994,14620,151374,8.807547260744364,91.19245273925564,Entertainment
128879,14306,114573,11.100334422209981,88.89966557779002,Healthcare
172311,39300,133011,22.807597889861935,77.19240211013808,Entertainment
18860,10070,8790,53.39342523860021,46.60657476139979,Housing
150824,26472,124352,17.551583302392192,82.44841669760781,Entertainment
97184,20234,76950,20.82029963780046,79.17970036219954,Transportation
49496,15848,33648,32.01874898981736,67.98125101018265,Food
129765,32470,97295,25.02215543482449,74.97784456517552,Healthcare
182819,6452,176367,3.5291736635688853,96.47082633643112,Entertainment
114636,40379,74257,35.223664468404344,64.77633553159566,Healthcare
42902,6226,36676,14.512143955992729,85.48785604400727,Food
123704,15234,108470,12.31488068292052,87.68511931707948,Healthcare
49817,8378,41439,16.8175522412028,83.1824477587972,Food
162322,38930,123392,23.98319389854733,76.01680610145267,Entertainment
49658,24662,24996,49.66369970598896,50.33630029401104,Food
39997,13878,26119,34.69760232017401,65.30239767982599,Food
10368,5789,4579,55.83526234567901,44.16473765432099,Housing
32988,30966,2022,93.87049836304111,6.129501636958894,Food
90114,32813,57301,36.412766051889825,63.58723394811017,Transportation
164310,24809,139501,15.098898423711276,84.90110157628872,Entertainment
151866,30706,121160,20.21914055812361,79.7808594418764,Entertainment
71703,4382,67321,6.11132030737905,93.88867969262094,Transportation
102978,17226,85752,16.727844782380703,83.27215521761929,Healthcare
141336,8933,132403,6.320399615101602,93.6796003848984,Healthcare
193031,35133,157898,18.200703513943356,81.79929648605663,Entertainment
43646,24405,19241,55.91577693259405,44.08422306740595,Food
164756,472,164284,0.2864842555051106,99.71351574449488,Entertainment
140752,4063,136689,2.886637490053427,97.11336250994658,Healthcare
38351,28930,9421,75.43479961409089,24.5652003859091,Food
22010,11767,10243,53.46206269877328,46.53793730122672,Housing
14819,9328,5491,62.94621769350158,37.05378230649841,Housing
94933,28419,66514,29.93584949385356,70.06415050614643,Transportation
8572,7521,1051,87.73915072328512,12.260849276714886,Housing
17968,16241,1727,90.38846838824577,9.61153161175423,Housing
123454,35079,88375,28.41463217068706,71.58536782931294,Healthcare
155455,13107,142348,8.431378855617382,91.56862114438262,Entertainment
52612,22075,30537,41.95810841633087,58.04189158366913,Transportation
77115,11882,65233,15.408156649160345,84.59184335083965,Transportation
94153,10051,84102,10.675177636400326,89.32482236359968,Transportation
117717,32188,85529,27.343544262935687,72.65645573706432,Healthcare
152784,9605,143179,6.286653052675673,93.71334694732433,Entertainment
17797,14607,3190,82.07563072427936,17.92436927572063,Housing
111413,11755,99658,10.550833385691078,89.44916661430892,Healthcare
8404,8175,229,97.27510709186103,2.7248929081389814,Housing
193882,36451,157431,18.800610680723327,81.19938931927668,Entertainment
104370,8050,96320,7.712944332662643,92.28705566733736,Healthcare
37639,2024,35615,5.3774010999229525,94.62259890007705,Food
91003,43271,47732,47.54898190169555,52.451018098304445,Transportation
61250,21390,39860,34.922448979591834,65.07755102040817,Transportation
40241,26220,14021,65.15742650530554,34.84257349469447,Food
60248,44440,15808,73.76178462355597,26.23821537644403,Transportation
29727,11789,17938,39.65755037507989,60.3424496249201,Food
10120,4020,6100,39.723320158102766,60.27667984189723,Housing
94991,41212,53779,43.385162804897305,56.614837195102695,Transportation
184271,33188,151083,18.010430290170458,81.98956970982955,Entertainment
74175,21957,52218,29.601617795753288,70.39838220424672,Transportation
9990,5299,4691,53.04304304304305,46.95695695695696,Housing
108821,36244,72577,33.30607143841722,66.69392856158278,Healthcare
177974,23117,154857,12.988975917830695,87.01102408216931,Entertainment
51627,25279,26348,48.9646890193116,51.0353109806884,Transportation
194105,5316,188789,2.738723886556245,97.26127611344376,Entertainment
101287,34297,66990,33.86120627523769,66.13879372476231,Healthcare
19918,9135,10783,45.863038457676474,54.136961542323526,Housing
77415,20895,56520,26.990893237744622,73.00910676225537,Transportation
158765,178,158587,0.11211539067174756,99.88788460932825,Entertainment
71327,38665,32662,54.20808389529912,45.79191610470089,Transportation
157594,9495,148099,6.0249755701359184,93.97502442986408,Entertainment
84061,29482,54579,35.07214998631946,64.92785001368054,Transportation
157408,33542,123866,21.308955072169137,78.69104492783086,Entertainment
121120,10363,110757,8.555977542932629,91.44402245706738,Healthcare
198649,31385,167264,15.799223756474989,84.20077624352501,Entertainment
178888,46172,132716,25.810563033853583,74.18943696614642,Entertainment
94513,38029,56484,40.23679282215145,59.76320717784856,Transportation
157563,44544,113019,28.270596523295445,71.72940347670456,Entertainment
15561,2719,12842,17.47317010474905,82.52682989525096,Housing
46396,10725,35671,23.116216915251314,76.88378308474869,Food
184235,26352,157883,14.30347111026678,85.69652888973323,Entertainment
156835,18179,138656,11.591162686900246,88.40883731309975,Entertainment
21774,9752,12022,44.78736107283917,55.21263892716083,Housing
159048,44985,114063,28.283914290025653,71.71608570997434,Entertainment
9931,9204,727,92.67948847044607,7.320511529553922,Housing
141887,20617,121270,14.530577149421722,85.46942285057828,Healthcare
152867,49723,103144,32.52696788711756,67.47303211288244,Entertainment
37602,36018,1584,95.78745811393011,4.21254188606989,Food
24385,374,24011,1.5337297518966577,98.46627024810334,Housing
127580,25274,102306,19.810315096410093,80.1896849035899,Healthcare
176416,15389,161027,8.723131688735714,91.27686831126428,Entertainment
157074,42430,114644,27.012745584883557,72.98725441511644,Entertainment
32934,6727,26207,20.42569988461772,79.57430011538229,Food
63018,24815,38203,39.377638135135996,60.622361864864004,Transportation
120518,31786,88732,26.374483479646194,73.62551652035381,Healthcare
137654,594,137060,0.43151670129455016,99.56848329870544,Healthcare
19411,2911,16500,14.996651383236308,85.00334861676369,Housing
99726,20598,79128,20.65459358642681,79.34540641357319,Transportation
182601,46176,136425,25.287922848177175,74.71207715182283,Entertainment
172837,24837,148000,14.37018693913919,85.62981306086081,Entertainment
156507,28842,127665,18.428568690218327,81.57143130978167,Entertainment
11839,1258,10581,10.625897457555537,89.37410254244446,Housing
32952,6449,26503,19.570890992959455,80.42910900704055,Food
21192,7083,14109,33.422989807474515,66.57701019252548,Housing
26601,13951,12650,52.445396789594376,47.554603210405624,Food
17956,6140,11816,34.194698151035865,65.80530184896413,Housing
93140,21516,71624,23.10070861069358,76.89929138930643,Transportation
94875,44702,50173,47.1167325428195,52.88326745718051,Transportation
92320,21143,71177,22.90186308492201,77.09813691507799,Transportation
42832,6009,36823,14.029230481882704,85.9707695181173,Food
47801,43423,4378,90.84119579088303,9.158804209116964,Food
83441,8630,74811,10.34263731259213,89.65736268740787,Transportation
12761,10859,1902,85.09521197398323,14.904788026016769,Housing
181088,22578,158510,12.467971373034105,87.5320286269659,Entertainment
146469,27897,118572,19.046351105011983,80.95364889498802,Healthcare
56697,27862,28835,49.14192990810801,50.85807009189198,Transportation
189826,36523,153303,19.240251598832614,80.75974840116739,Entertainment
43734,39779,3955,90.95669273334248,9.04330726665752,Food
107589,903,106686,0.8393051334244207,99.16069486657558,Healthcare
196608,13919,182689,7.079569498697917,92.92043050130209,Entertainment
155055,34484,120571,22.239850375673146,77.76014962432684,Entertainment
195310,20762,174548,10.630280067584867,89.36971993241514,Entertainment
174183,11914,162269,6.839932714444004,93.160067285556,Entertainment
9759,9181,578,94.07726201455067,5.922737985449329,Housing
33990,19360,14630,56.957928802588995,43.042071197411005,Food
34171,32247,1924,94.36949460068479,5.630505399315209,Food
99869,46197,53672,46.25759745266299,53.74240254733701,Transportation
25989,1502,24487,5.779368194236023,94.22063180576397,Food
13801,2806,10995,20.331860010144194,79.66813998985582,Housing
124681,17077,107604,13.696553604799448,86.30344639520055,Healthcare
24422,3342,21080,13.684382933420686,86.3156170665793,Housing
89831,4331,85500,4.821275506228362,95.17872449377164,Transportation
79059,39551,39508,50.027194879773326,49.97280512022667,Transportation
23950,12502,11448,52.20041753653445,47.79958246346555,Housing
28130,25797,2333,91.70636331318876,8.293636686811233,Food
15079,7987,7092,52.967703428609326,47.032296571390674,Housing
148927,28415,120512,19.079817628771142,80.92018237122886,Healthcare
61163,22322,38841,36.49592073639292,63.50407926360708,Transportation
28159,20008,8151,71.05365957597925,28.94634042402074,Food
190921,7973,182948,4.17607282593324,95.82392717406675,Entertainment
63747,20921,42826,32.818799316046245,67.18120068395376,Transportation
28151,26181,1970,93.00202479485631,6.997975205143689,Food
39272,16075,23197,40.93247097168466,59.067529028315334,Food
172309,24215,148094,14.053241560220304,85.9467584397797,Entertainment
193502,10108,183394,5.223718617895423,94.77628138210457,Entertainment
175160,36368,138792,20.76273121717287,79.23726878282713,Entertainment
65612,48135,17477,73.36310431018717,26.63689568981284,Transportation
142724,46764,95960,32.765337294358346,67.23466270564165,Healthcare
75654,15141,60513,20.01348243318265,79.98651756681735,Transportation
36127,7566,28561,20.94278517452321,79.05721482547679,Food
146214,12875,133339,8.805586332362154,91.19441366763785,Healthcare
77361,37805,39556,48.868292809038145,51.13170719096185,Transportation
103652,10431,93221,10.063481650136998,89.93651834986301,Healthcare
89914,8498,81416,9.451253419934604,90.5487465800654,Transportation
52935,16406,36529,30.992726929252857,69.00727307074715,Transportation
119015,7816,111199,6.567239423602067,93.43276057639794,Healthcare
13984,5142,8842,36.77059496567506,63.22940503432495,Housing
104251,15372,88879,14.745182300409587,85.25481769959042,Healthcare
117413,22402,95011,19.079658981543783,80.92034101845623,Healthcare
64430,18758,45672,29.113766878783174,70.88623312121682,Transportation
14943,11954,2989,79.99732316134644,20.00267683865355,Housing
37949,13026,24923,34.325015151914414,65.6749848480856,Food
19835,13168,6667,66.38769851273003,33.61230148726998,Housing
167636,45564,122072,27.18031926316543,72.81968073683457,Entertainment
40340,3491,36849,8.653941497273179,91.34605850272682,Food
49437,1378,48059,2.7873859659769,97.2126140340231,Food
79324,34964,44360,44.077454490444254,55.922545509555746,Transportation
93307,25675,67632,27.516692209587706,72.4833077904123,Transportation
110266,49107,61159,44.535033464531224,55.464966535468776,Healthcare
181822,9729,172093,5.3508376324097195,94.64916236759028,Entertainment
28408,6731,21677,23.69402985074627,76.30597014925374,Food
136536,46344,90192,33.94269643171032,66.05730356828968,Healthcare
131382,35380,96002,26.92910748808817,73.07089251191184,Healthcare
134841,42255,92586,31.3369079137651,68.6630920862349,Healthcare
165000,6376,158624,3.8642424242424243,96.13575757575758,Entertainment
33741,3815,29926,11.306718828724698,88.6932811712753,Food
9381,1098,8283,11.704509114166934,88.29549088583308,Housing
149350,7814,141536,5.232005356545028,94.76799464345497,Healthcare
45317,11460,33857,25.28852307081228,74.71147692918773,Food
15737,13636,2101,86.64929783313211,13.350702166867892,Housing
158620,24255,134365,15.291262135922329,84.70873786407766,Entertainment
123931,23752,100179,19.165503384948078,80.83449661505192,Healthcare
180395,14396,165999,7.980265528423737,92.01973447157627,Entertainment
163301,19064,144237,11.674147739450461,88.32585226054954,Entertainment
150501,26675,123826,17.72413472335732,82.27586527664268,Entertainment
54536,47367,7169,86.85455478949685,13.145445210503153,Transportation
199613,24355,175258,12.201109146197894,87.7988908538021,Entertainment
34629,11492,23137,33.186057928325965,66.81394207167402,Food
113666,36898,76768,32.4617739693488,67.5382260306512,Healthcare
57549,49712,7837,86.38203965316514,13.61796034683487,Transportation
151988,37597,114391,24.73682132799958,75.26317867200042,Entertainment
36950,8519,28431,23.05548037889039,76.9445196211096,Food
88441,1502,86939,1.6983073461403648,98.30169265385965,Transportation
153647,21471,132176,13.974239653231107,86.02576034676889,Entertainment
38764,20608,18156,53.16272830461253,46.83727169538747,Food
105376,23487,81889,22.288756453082296,77.71124354691771,Healthcare
22114,4358,17756,19.706972958306952,80.29302704169304,Housing
182472,48671,133801,26.67313341224955,73.32686658775044,Entertainment
103960,47289,56671,45.48768757214313,54.51231242785687,Healthcare
150372,27383,122989,18.21017210650919,81.78982789349081,Entertainment
98543,5913,92630,6.000426209877921,93.99957379012208,Transportation
61865,34764,27101,56.19332417360382,43.80667582639619,Transportation
74324,27610,46714,37.14816210107099,62.851837898929006,Transportation
160146,29717,130429,18.55619247436714,81.44380752563286,Entertainment
67495,20437,47058,30.27927994666272,69.72072005333729,Transportation
113648,38176,75472,33.59144023651978,66.40855976348023,Healthcare
19116,258,18858,1.349654739485248,98.65034526051475,Housing
26525,20150,6375,75.96606974552309,24.03393025447691,Food
57359,22588,34771,39.38004497986366,60.61995502013633,Transportation
35162,211,34951,0.6000796314202832,99.39992036857971,Food
18973,6859,12114,36.15137300374216,63.84862699625784,Housing
31274,1299,29975,4.153610027498881,95.84638997250113,Food
36349,9782,26567,26.91133181105395,73.08866818894604,Food
121312,37707,83605,31.082662885782113,68.91733711421789,Healthcare
141224,21711,119513,15.373449272078402,84.6265507279216,Healthcare
152597,17167,135430,11.249893510357346,88.75010648964266,Entertainment
128107,27222,100885,21.24942430936639,78.75057569063361,Healthcare
33877,2887,30990,8.522006080821797,91.4779939191782,Food
159959,8697,151262,5.437018235922955,94.56298176407705,Entertainment
89221,17158,72063,19.230898555272862,80.76910144472714,Transportation
101914,37065,64849,36.36889926801029,63.63110073198972,Healthcare
106609,33115,73494,31.062105450759315,68.93789454924068,Healthcare
84493,2413,82080,2.855857881718012,97.14414211828199,Transportation
26726,11380,15346,42.580258923894334,57.419741076105666,Food
111104,15174,95930,13.657474078341014,86.34252592165899,Healthcare
193924,12219,181705,6.300922010684598,93.6990779893154,Entertainment
172098,8167,163931,4.745551952957036,95.25444804704296,Entertainment
24959,23413,1546,93.80584158019151,6.1941584198084865,Housing
77625,25964,51661,33.44798711755234,66.55201288244767,Transportation
96883,38137,58746,39.36397510399141,60.63602489600859,Transportation
91171,10686,80485,11.720832282194996,88.27916771780501,Transportation
52420,48080,4340,91.72071728347959,8.279282716520411,Transportation
69465,42036,27429,60.51392787734831,39.48607212265169,Transportation
167154,47299,119855,28.296660564509374,71.70333943549062,Entertainment
56459,35524,20935,62.91999504064897,37.08000495935103,Transportation
22478,4628,17850,20.589020375478245,79.41097962452174,Housing
128366,13189,115177,10.274527522864311,89.7254724771357,Healthcare
86264,17140,69124,19.86923861634054,80.13076138365946,Transportation
84232,23212,61020,27.55722290815842,72.44277709184158,Transportation
15992,15646,346,97.83641820910455,2.1635817908954476,Housing
42001,20028,21973,47.6845789385967,52.3154210614033,Food
95517,30898,64619,32.348168388873184,67.65183161112681,Transportation
97016,30699,66317,31.643234105714523,68.35676589428547,Transportation
9585,3943,5642,41.13719353155973,58.862806468440276,Housing
73779,22821,50958,30.931565892733705,69.0684341072663,Transportation
63436,4114,59322,6.485276499148748,93.51472350085125,Transportation
41285,14389,26896,34.8528521254693,65.1471478745307,Food
20991,2808,18183,13.377161640703159,86.62283835929684,Housing
42577,29001,13576,68.11424008267375,31.885759917326258,Food
16921,4378,12543,25.873175344246796,74.12682465575321,Housing
51861,6158,45703,11.874047935828465,88.12595206417153,Transportation
118301,9566,108735,8.086153117894185,91.91384688210582,Healthcare
53574,2978,50596,5.558666517340502,94.4413334826595,Transportation
140309,9488,130821,6.762217676699285,93.2377823233007,Healthcare
18964,16087,2877,84.82914996836111,15.170850031638894,Housing
113263,3871,109392,3.417709225431077,96.58229077456892,Healthcare
45342,18350,26992,40.47020422566274,59.52979577433726,Food
8458,207,8251,2.4473870891463703,97.55261291085363,Housing
17446,922,16524,5.284879055370858,94.71512094462913,Housing
50056,23161,26895,46.270177401310534,53.729822598689466,Transportation
96615,38383,58232,39.727785540547536,60.272214459452464,Transportation
40898,15474,25424,37.83559098244413,62.16440901755587,Food
11750,11349,401,96.58723404255319,3.4127659574468083,Housing
141536,33447,108089,23.631443590323308,76.36855640967669,Healthcare
28341,7876,20465,27.790127377297907,72.2098726227021,Food
187856,1460,186396,0.7771910399454901,99.22280896005451,Entertainment
166709,41945,124764,25.160609205261864,74.83939079473814,Entertainment
139847,18130,121717,12.964167983582058,87.03583201641794,Healthcare
27015,20173,6842,74.6733296316861,25.3266703683139,Food
98124,41362,56762,42.15278627043333,57.84721372956667,Transportation
152590,37078,115512,24.29910216921161,75.70089783078838,Entertainment
26785,19894,6891,74.27291394437185,25.727086055628153,Food
64916,909,64007,1.4002711196007147,98.59972888039928,Transportation
12854,3177,9677,24.716041699081998,75.283958300918,Housing
14910,8561,6349,57.41784037558686,42.582159624413144,Housing
31749,6103,25646,19.222652681974235,80.77734731802576,Food
52577,25467,27110,48.4375297183179,51.5624702816821,Transportation
40561,16709,23852,41.19474371933631,58.805256280663684,Food
10385,4268,6117,41.09773712084738,58.90226287915262,Housing
33182,20213,12969,60.91555662708698,39.08444337291302,Food
30637,11593,19044,37.839866827692006,62.160133172307994,Food
8816,192,8624,2.1778584392014517,97.82214156079854,Housing
66710,15722,50988,23.567681007345225,76.43231899265479,Transportation
107387,6862,100525,6.389972715505602,93.61002728449441,Healthcare
170389,33434,136955,19.622158707428298,80.3778412925717,Entertainment
24086,20607,3479,85.55592460350411,14.44407539649589,Housing
180012,15586,164426,8.658311668111015,91.34168833188897,Entertainment
144441,16891,127550,11.694048088839041,88.30595191116096,Healthcare
126486,32267,94219,25.51033315940104,74.48966684059896,Healthcare
12232,11122,1110,90.92544146500981,9.07455853499019,Housing
187651,15828,171823,8.434807168626866,91.56519283137314,Entertainment
41668,5840,35828,14.015551502351926,85.98444849764807,Food
84458,42531,41927,50.35757417888181,49.64242582111819,Transportation
82564,46159,36405,55.90693280364324,44.09306719635676,Transportation
9151,7619,1532,83.25866025570976,16.741339744290244,Housing
60417,3412,57005,5.6474171176986605,94.35258288230133,Transportation
86622,34269,52353,39.56154325690933,60.438456743090676,Transportation
13588,11312,2276,83.24992640565205,16.750073594347953,Housing
110751,29583,81168,26.711271230056617,73.28872876994339,Healthcare
85772,46942,38830,54.72881593060672,45.27118406939328,Transportation
45712,20039,25673,43.837504375218764,56.162495624781236,Food
38270,406,37864,1.0608831983276719,98.93911680167233,Food
119709,46221,73488,38.61113199508809,61.38886800491191,Healthcare
160962,17705,143257,10.999490562990022,89.00050943700998,Entertainment
154404,3546,150858,2.296572627652133,97.70342737234786,Entertainment
52514,2801,49713,5.333815744372929,94.66618425562707,Transportation
188109,5111,182998,2.717041715175776,97.28295828482423,Entertainment
46030,18445,27585,40.071692374538344,59.92830762546165,Food
187330,47287,140043,25.242619975444402,74.7573800245556,Entertainment
25499,2809,22690,11.016118279148202,88.9838817208518,Food
19705,10640,9065,53.99644760213144,46.00355239786856,Housing
45309,38968,6341,86.0049879714847,13.995012028515305,Food
151131,14071,137060,9.31046575487491,90.68953424512509,Entertainment
196027,1112,194915,0.5672687946048248,99.43273120539517,Entertainment
122541,35481,87060,28.95439077533234,71.04560922466766,Healthcare
65211,49510,15701,75.92277376516232,24.07722623483768,Transportation
184255,37449,146806,20.32455021573363,79.67544978426638,Entertainment
81542,8009,73533,9.821932255770033,90.17806774422998,Transportation
164334,30535,133799,18.581060523081042,81.41893947691896,Entertainment
30595,7531,23064,24.615133191697993,75.38486680830201,Food
20819,4208,16611,20.212306066573802,79.7876939334262,Housing
12492,5823,6669,46.61383285302594,53.38616714697406,Housing
83013,35393,47620,42.63549082673798,57.36450917326202,Transportation
14893,1693,13200,11.367756664204661,88.63224333579534,Housing
47057,29007,18050,61.64226363771596,38.35773636228404,Food
159997,1178,158819,0.7362638049463428,99.26373619505365,Entertainment
154800,25091,129709,16.208656330749356,83.79134366925065,Entertainment
19477,12903,6574,66.24736869127689,33.75263130872311,Housing
10827,5232,5595,48.323635356054304,51.676364643945696,Housing
55258,46501,8757,84.15252090195085,15.847479098049153,Transportation
119073,43290,75783,36.355848933007486,63.644151066992514,Healthcare
156284,41622,114662,26.632284814824292,73.36771518517571,Entertainment
46471,19049,27422,40.99115577456909,59.00884422543091,Food
43490,29964,13526,68.89859737870775,31.10140262129225,Food
37279,8417,28862,22.578395343222727,77.42160465677728,Food
176419,23118,153301,13.104030744987785,86.89596925501222,Entertainment
192950,34129,158821,17.688002073075925,82.31199792692408,Entertainment
40407,35699,4708,88.34855346845843,11.651446531541565,Food
24713,3640,21073,14.729089952656496,85.2709100473435,Housing
36561,24207,12354,66.20989579059653,33.79010420940347,Food
153575,36497,117078,23.764935699169786,76.23506430083022,Entertainment
18145,6488,11657,35.75640672361532,64.24359327638469,Housing
170937,39612,131325,23.17344986749504,76.82655013250496,Entertainment
19181,16766,2415,87.40941556748865,12.59058443251134,Housing
12831,2768,10063,21.572753487647102,78.4272465123529,Housing
98374,13026,85348,13.241303596478746,86.75869640352126,Transportation
84312,33039,51273,39.1865926558497,60.81340734415029,Transportation
161720,5397,156323,3.337249567153104,96.6627504328469,Entertainment
191202,29373,161829,15.362287005366051,84.63771299463396,Entertainment
14642,3825,10817,26.123480398852617,73.87651960114738,Housing
117716,23235,94481,19.738183424513238,80.26181657548676,Healthcare
33436,25081,8355,75.01196315348726,24.988036846512742,Food
169333,20115,149218,11.878960391654314,88.12103960834568,Entertainment
31521,654,30867,2.074807271342914,97.92519272865708,Food
151608,21458,130150,14.153606669832728,85.84639333016727,Entertainment
49569,21826,27743,44.0315519780508,55.9684480219492,Food
19164,4390,14774,22.90753496138593,77.09246503861407,Housing
12208,11751,457,96.25655307994757,3.743446920052425,Housing
12164,2346,9818,19.286418941137782,80.71358105886222,Housing
179405,45472,133933,25.346004849363172,74.65399515063683,Entertainment
139959,29389,110570,20.998292357047422,79.00170764295258,Healthcare
38991,16626,22365,42.6406093713934,57.3593906286066,Food
77786,15702,62084,20.186151749672177,79.81384825032782,Transportation
22638,15954,6684,70.47442353564803,29.52557646435198,Housing
76963,28084,48879,36.490261554253344,63.509738445746656,Transportation
35299,34335,964,97.26904444885123,2.7309555511487575,Food
21773,20224,1549,92.8856841041657,7.114315895834291,Housing
54478,6533,47945,11.991996769338082,88.00800323066191,Transportation
93664,15367,78297,16.406516911513496,83.59348308848651,Transportation
96434,24968,71466,25.89128315739262,74.10871684260738,Transportation
11797,1792,10005,15.190302619309994,84.80969738069001,Housing
28957,16555,12402,57.17097765652519,42.82902234347481,Food
128619,11859,116760,9.220255172252934,90.77974482774707,Healthcare
116821,6012,110809,5.146334991140292,94.8536650088597,Healthcare
28346,18870,9476,66.57023918718691,33.4297608128131,Food
149773,246,149527,0.16424856282507527,99.83575143717492,Healthcare
83366,23704,59662,28.433654007629013,71.566345992371,Transportation
11552,18,11534,0.15581717451523547,99.84418282548476,Housing
169277,36881,132396,21.78736626948729,78.21263373051272,Entertainment
15010,11207,3803,74.66355762824783,25.336442371752167,Housing
110682,6984,103698,6.309969100666775,93.69003089933322,Healthcare
133954,36053,97901,26.91446317392538,73.08553682607463,Healthcare
75690,6083,69607,8.036728762055754,91.96327123794424,Transportation
158701,10531,148170,6.635748987088928,93.36425101291107,Entertainment
78440,15524,62916,19.79092299847017,80.20907700152982,Transportation
193049,38700,154349,20.046723888753633,79.95327611124637,Entertainment
139452,18922,120530,13.56882654963715,86.43117345036285,Healthcare
79251,2808,76443,3.543172956808116,96.45682704319188,Transportation
18535,9510,9025,51.30833558133261,48.691664418667386,Housing
21296,18525,2771,86.9881667918858,13.011833208114199,Housing
66801,46110,20691,69.02591278573674,30.974087214263257,Transportation
97691,33714,63977,34.51085565712297,65.48914434287703,Transportation
22552,2914,19638,12.921248669741042,87.07875133025895,Housing
111342,25654,85688,23.040721380970343,76.95927861902966,Healthcare
101601,6866,94735,6.757807501894667,93.24219249810534,Healthcare
30586,3159,27427,10.328254757078401,89.6717452429216,Food
13978,5607,8371,40.113034768922596,59.886965231077404,Housing
85011,35851,49160,42.17218948136123,57.82781051863877,Transportation
193756,38760,154996,20.00454179483474,79.99545820516526,Entertainment
102367,27467,74900,26.831889183037504,73.1681108169625,Healthcare
128671,35221,93450,27.372912311243404,72.6270876887566,Healthcare
11417,1645,9772,14.408338442673207,85.59166155732679,Housing
49278,35489,13789,72.01793903973376,27.982060960266246,Food
19767,13006,6761,65.79652956948449,34.2034704305155,Housing
152057,31719,120338,20.859940680139687,79.14005931986031,Entertainment
19083,13149,5934,68.9042603364251,31.09573966357491,Housing
23369,21959,1410,93.96636569814711,6.0336343018528815,Housing
190463,6298,184165,3.3066789875198856,96.69332101248011,Entertainment
13644,10518,3126,77.08883025505718,22.911169744942832,Housing
132603,21584,111019,16.277158133677215,83.72284186632278,Healthcare
18595,15941,2654,85.72734606076902,14.272653939230976,Housing
78073,48774,29299,62.47230156392095,37.527698436079056,Transportation
152847,33697,119150,22.04622923577172,77.95377076422828,Entertainment
29766,20354,9412,68.38003090774708,31.61996909225291,Food
118243,13788,104455,11.660732559221266,88.33926744077874,Healthcare
164763,18116,146647,10.99518702621341,89.0048129737866,Entertainment
147250,17326,129924,11.766383701188456,88.23361629881154,Healthcare
182928,42912,140016,23.458409866176858,76.54159013382315,Entertainment
45996,30825,15171,67.01669710409601,32.983302895903996,Food
62398,40879,21519,65.51331773454278,34.486682265457226,Transportation
102543,17062,85481,16.638873448211967,83.36112655178803,Healthcare
166434,33282,133152,19.99711597389956,80.00288402610045,Entertainment
104301,3338,100963,3.2003528249968842,96.79964717500312,Healthcare
171625,15493,156132,9.027239621267299,90.9727603787327,Entertainment
38410,3791,34619,9.869825566258788,90.13017443374122,Food
139926,18281,121645,13.064762803195975,86.93523719680402,Healthcare
193775,10680,183095,5.511546897174558,94.48845310282545,Entertainment
31125,23731,7394,76.2441767068273,23.75582329317269,Food
41891,30254,11637,72.22076340980162,27.77923659019837,Food
23417,14188,9229,60.58846137421532,39.41153862578469,Housing
89658,44674,44984,49.827120836958215,50.172879163041785,Transportation
28559,9772,18787,34.21688434468994,65.78311565531007,Food
55592,27757,27835,49.92984602101021,50.07015397898979,Transportation
16173,4495,11678,27.793235639646323,72.20676436035369,Housing
177758,35650,142108,20.05535615837262,79.94464384162738,Entertainment
116739,2631,114108,2.253745534911212,97.74625446508878,Healthcare
46377,13382,32995,28.854820277292625,71.14517972270737,Food
42725,29086,13639,68.07723815096548,31.922761849034526,Food
46074,38285,7789,83.09458696878934,16.90541303121066,Food
131645,33521,98124,25.463177484902577,74.53682251509743,Healthcare
89140,1726,87414,1.9362800089746466,98.06371999102535,Transportation
193168,26578,166590,13.759007703139236,86.24099229686077,Entertainment
160016,16628,143388,10.391460853914609,89.60853914608539,Entertainment
138494,18288,120206,13.20490418357474,86.79509581642526,Healthcare
133914,9102,124812,6.79689950266589,93.2031004973341,Healthcare
119077,46902,72175,39.38795905170604,60.612040948293966,Healthcare
166856,16411,150445,9.835426954979145,90.16457304502086,Entertainment
150528,2922,147606,1.9411670918367347,98.05883290816327,Entertainment
72695,35774,36921,49.211087420042645,50.788912579957355,Transportation
68855,31815,37040,46.2057947861448,53.79420521385521,Transportation
37371,16309,21062,43.64079098766423,56.35920901233577,Food
141877,28552,113325,20.12447401622532,79.87552598377468,Healthcare
40973,28310,12663,69.0942816000781,30.9057183999219,Food
84269,41802,42467,49.605430229384474,50.394569770615526,Transportation
187378,11134,176244,5.941999594402758,94.05800040559724,Entertainment
25846,1164,24682,4.503598235703784,95.49640176429621,Food
140726,45434,95292,32.285434105993204,67.7145658940068,Healthcare
91433,25108,66325,27.46054487985738,72.53945512014262,Transportation
105923,3071,102852,2.899275889089244,97.10072411091075,Healthcare
56684,11244,45440,19.836285371533414,80.1637146284666,Transportation
79715,34386,45329,43.136172614940726,56.863827385059274,Transportation
73978,49832,24146,67.36056665495147,32.63943334504853,Transportation
45747,22886,22861,50.027324196122144,49.97267580387785,Food
71178,26754,44424,37.58745679844896,62.41254320155104,Transportation
16133,574,15559,3.5579247505113742,96.44207524948862,Housing
41830,39132,2698,93.55008367200574,6.449916327994262,Food
21711,10123,11588,46.626134217677674,53.373865782322326,Housing
84601,48285,36316,57.073793453978084,42.926206546021916,Transportation
195978,36680,159298,18.7163865331823,81.28361346681771,Entertainment
153976,12919,141057,8.390268613290383,91.60973138670961,Entertainment
167185,24853,142332,14.865568083261058,85.13443191673893,Entertainment
85037,39322,45715,46.24104801439373,53.75895198560626,Transportation
55498,13751,41747,24.777469458358862,75.22253054164113,Transportation
190390,49814,140576,26.164189295656286,73.83581070434371,Entertainment
9560,1266,8294,13.242677824267782,86.75732217573223,Housing
79382,25287,54095,31.854828550553023,68.14517144944698,Transportation
30799,9627,21172,31.257508360661063,68.74249163933894,Food
53386,36538,16848,68.44116435020418,31.558835649795824,Transportation
195951,16225,179726,8.280131257304122,91.71986874269588,Entertainment
36573,739,35834,2.020616301643289,97.97938369835671,Food
113698,46374,67324,40.78699713275519,59.2130028672448,Healthcare
97043,49116,47927,50.612615026328534,49.387384973671466,Transportation
36927,31501,5426,85.30614455547432,14.693855444525687,Food
145461,37121,108340,25.51955506974378,74.48044493025621,Healthcare
100825,13880,86945,13.766426977436153,86.23357302256385,Healthcare
34366,11422,22944,33.23633824128499,66.763661758715,Food
155901,40733,115168,26.12747833561042,73.87252166438958,Entertainment
39140,38230,910,97.67501277465507,2.3249872253449153,Food
22060,15156,6904,68.7035358114234,31.29646418857661,Housing
87856,43106,44750,49.064378073210705,50.93562192678929,Transportation
42559,178,42381,0.4182429098428065,99.5817570901572,Food
152503,16665,135838,10.92765388221871,89.0723461177813,Entertainment
154261,37596,116665,24.371681760133797,75.6283182398662,Entertainment
25376,262,25114,1.0324716267339218,98.96752837326608,Food
108177,33529,74648,30.99457370790464,69.00542629209536,Healthcare
45940,10492,35448,22.83848498040923,77.16151501959077,Food
110420,16676,93744,15.102336533236732,84.89766346676326,Healthcare
97681,6411,91270,6.563200622434251,93.43679937756575,Transportation
158040,47427,110613,30.00949126803341,69.9905087319666,Entertainment
22949,1750,21199,7.625604601507691,92.37439539849231,Housing
180882,18409,162473,10.177353191583464,89.82264680841654,Entertainment
46892,20619,26273,43.971253092211896,56.028746907788104,Food
149386,26193,123193,17.53377157163322,82.46622842836679,Healthcare
24531,22804,1727,92.95992825404589,7.040071745954099,Housing
84215,26016,58199,30.89235884343644,69.10764115656356,Transportation
16601,894,15707,5.385217757966387,94.61478224203361,Housing
27972,9719,18253,34.74545974545975,65.25454025454025,Food
32735,3906,28829,11.932182679089658,88.06781732091034,Food
178289,8956,169333,5.023304858964939,94.97669514103507,Entertainment
10103,365,9738,3.6127882807087,96.3872117192913,Housing
108734,7257,101477,6.674085382676992,93.32591461732301,Healthcare
12432,10247,2185,82.42438867438867,17.575611325611327,Housing
18380,2224,16156,12.100108813928182,87.89989118607183,Housing
80789,26623,54166,32.953743702731806,67.04625629726819,Transportation
156508,32586,123922,20.820660924681167,79.17933907531884,Entertainment
35913,22368,13545,62.283852643889404,37.7161473561106,Food
84294,46045,38249,54.62429117137637,45.37570882862363,Transportation
14446,13156,1290,91.07019244081407,8.929807559185935,Housing
46060,34328,11732,74.52887537993921,25.47112462006079,Food
62364,19613,42751,31.449233532165994,68.55076646783401,Transportation
103448,10662,92786,10.306627484339959,89.69337251566004,Healthcare
20652,6122,14530,29.64361805152043,70.35638194847957,Housing
29907,7263,22644,24.28528438158291,75.71471561841709,Food
29186,25933,3253,88.8542451860481,11.145754813951894,Food
72077,44816,27261,62.17794858276565,37.82205141723435,Transportation
36198,11998,24200,33.145477650698936,66.85452234930108,Food
78547,12888,65659,16.40801049053433,83.59198950946566,Transportation
71218,12489,58729,17.536297003566514,82.46370299643348,Transportation
61162,35457,25705,57.97227036395147,42.02772963604853,Transportation
50369,8424,41945,16.724572653814846,83.27542734618515,Transportation
30425,25953,4472,85.30156121610518,14.698438783894824,Food
121381,24796,96585,20.428238356909237,79.57176164309077,Healthcare
149087,18907,130180,12.68185690234561,87.31814309765439,Healthcare
24377,7128,17249,29.240677687984572,70.75932231201543,Housing
44405,6256,38149,14.08850354689787,85.91149645310213,Food
22427,7697,14730,34.32023899763678,65.67976100236322,Housing
26546,9327,17219,35.135236947186016,64.86476305281398,Food
20219,235,19984,1.162273109451506,98.8377268905485,Housing
13054,3868,9186,29.63076451662326,70.36923548337674,Housing
169411,29997,139414,17.706642425816504,82.29335757418349,Entertainment
115716,47252,68464,40.8344567734799,59.1655432265201,Healthcare
91793,14674,77119,15.985968428965172,84.01403157103483,Transportation
87012,43005,44007,49.42421734933113,50.57578265066888,Transportation
71275,34416,36859,48.286215363030514,51.713784636969486,Transportation
145824,27086,118738,18.574445907395216,81.42555409260478,Healthcare
13242,8549,4693,64.55973417912702,35.44026582087298,Housing
12997,7032,5965,54.10479341386474,45.89520658613526,Housing
130014,6579,123435,5.060224283538696,94.9397757164613,Healthcare
161845,8594,153251,5.310018845191387,94.6899811548086,Entertainment
33902,2618,31284,7.722258273848151,92.27774172615185,Food
11313,11033,280,97.52497127198798,2.4750287280120213,Housing
13004,9326,3678,71.71639495539834,28.28360504460166,Housing
96220,14692,81528,15.26917480773228,84.73082519226772,Transportation
145267,30008,115259,20.65713479317395,79.34286520682605,Healthcare
100642,21730,78912,21.591383319091435,78.40861668090857,Healthcare
16566,11889,4677,71.76747555233611,28.23252444766389,Housing
48816,33998,14818,69.64519829564078,30.354801704359225,Food
36990,13780,23210,37.25331170586645,62.74668829413355,Food
15818,4728,11090,29.889998735617652,70.11000126438235,Housing
32798,8346,24452,25.446673577657176,74.55332642234282,Food
72415,13844,58571,19.11758613546917,80.88241386453083,Transportation
171678,28223,143455,16.43949719824322,83.56050280175677,Entertainment
19595,12871,6724,65.68512375606022,34.31487624393978,Housing
11072,3124,7948,28.215317919075144,71.78468208092485,Housing
10643,8017,2626,75.32650568448746,24.673494315512542,Housing
32170,13288,18882,41.30556419023935,58.69443580976065,Food
97457,7233,90224,7.421734713771201,92.5782652862288,Transportation
158917,375,158542,0.23597223707973344,99.76402776292026,Entertainment
187761,13646,174115,7.267749958724122,92.73225004127588,Entertainment
90367,37606,52761,41.61474874677703,58.38525125322297,Transportation
15147,4451,10696,29.38535683633723,70.61464316366278,Housing
11554,10606,948,91.79504933356414,8.204950666435867,Housing
46021,18033,27988,39.18428543491015,60.81571456508985,Food
110708,22576,88132,20.39238356758319,79.6076164324168,Healthcare
157736,16202,141534,10.27159304153776,89.72840695846223,Entertainment
92488,18051,74437,19.517126546146528,80.48287345385347,Transportation
53240,38699,14541,72.6878287002254,27.312171299774608,Transportation
189220,12941,176279,6.839129056125145,93.16087094387485,Entertainment
23679,1761,21918,7.436969466615989,92.56303053338402,Housing
47433,15116,32317,31.86810870069361,68.13189129930639,Food
172484,26558,145926,15.397370190858284,84.60262980914172,Entertainment
24977,1774,23203,7.102534331585058,92.89746566841495,Housing
17346,587,16759,3.3840654906030205,96.61593450939698,Housing
43819,16251,27568,37.086651908989246,62.91334809101075,Food
47364,42939,4425,90.65746136306055,9.342538636939448,Food
129007,41271,87736,31.991287294487897,68.00871270551211,Healthcare
33244,31601,1643,95.05775478281795,4.942245217182048,Food
10282,1856,8426,18.050962847695,81.94903715230501,Housing
11983,1778,10205,14.837686722857383,85.16231327714262,Housing
130637,2389,128248,1.828731523228488,98.17126847677152,Healthcare
15352,13516,1836,88.04064616988015,11.959353830119854,Housing
88745,20454,68291,23.048059045580032,76.95194095441997,Transportation
23670,1998,21672,8.44106463878327,91.55893536121673,Housing
105379,13500,91879,12.810901602786135,87.18909839721387,Healthcare
196904,33491,163413,17.00879616462845,82.99120383537155,Entertainment
20508,634,19874,3.0914764969767896,96.90852350302322,Housing
108205,37890,70315,35.016866133727646,64.98313386627235,Healthcare
13136,5760,7376,43.8489646772229,56.1510353227771,Housing
35001,9503,25498,27.15065283849033,72.84934716150967,Food
108757,46326,62431,42.595878885956765,57.404121114043235,Healthcare
48724,719,48005,1.4756588129053445,98.52434118709465,Food
87580,22958,64622,26.213747430920304,73.7862525690797,Transportation
104960,17443,87517,16.618711890243905,83.3812881097561,Healthcare
9283,923,8360,9.942906388021115,90.05709361197889,Housing
17203,15795,1408,91.815381038191,8.184618961808987,Housing
26165,25668,497,98.10051595643034,1.899484043569654,Food
17435,4616,12819,26.47548035560654,73.52451964439346,Housing
98003,19317,78686,19.71062110343561,80.28937889656439,Transportation
173454,30498,142956,17.582759694212875,82.41724030578712,Entertainment
69094,21605,47489,31.268995860711495,68.73100413928852,Transportation
179768,46057,133711,25.62024386987673,74.37975613012327,Entertainment
28588,16535,12053,57.83895340702393,42.16104659297608,Food
45003,39451,5552,87.66304468590982,12.336955314090172,Food
164709,23438,141271,14.229944933185193,85.7700550668148,Entertainment
165991,35255,130736,21.23910332487906,78.76089667512093,Entertainment
169668,26401,143267,15.560388523469365,84.43961147653064,Entertainment
119180,39968,79212,33.535828159087096,66.4641718409129,Healthcare
31086,12390,18696,39.85717043041884,60.14282956958116,Food
79442,47819,31623,60.193600362528635,39.806399637471365,Transportation
44292,42942,1350,96.9520455161203,3.0479544838797072,Food
44631,13380,31251,29.97916246555085,70.02083753444916,Food
122842,4866,117976,3.961185913612608,96.03881408638739,Healthcare
32694,9454,23240,28.91662078668869,71.08337921331132,Food
157085,12455,144630,7.928828341343859,92.07117165865614,Entertainment
63455,3932,59523,6.196517216925381,93.80348278307463,Transportation
43724,8947,34777,20.462446253773674,79.53755374622634,Food
146620,15513,131107,10.58041194925658,89.41958805074341,Healthcare
48370,11689,36681,24.165805251188754,75.83419474881124,Food
88032,20478,67554,23.261995637949838,76.73800436205016,Transportation
16964,6493,10471,38.275170950247585,61.724829049752415,Housing
102841,14051,88790,13.662838751081768,86.33716124891824,Healthcare
136896,4963,131933,3.625379850397382,96.37462014960262,Healthcare
156474,47322,109152,30.242724030829404,69.75727596917059,Entertainment
169590,47382,122208,27.939147355386517,72.06085264461348,Entertainment
66408,21518,44890,32.40272256354656,67.59727743645344,Transportation
78800,35318,43482,44.819796954314725,55.18020304568528,Transportation
119728,34579,85149,28.881297607911264,71.11870239208874,Healthcare
24193,19233,4960,79.49820195924441,20.501798040755588,Housing
118228,24760,93468,20.9425855127381,79.0574144872619,Healthcare
50133,47752,2381,95.25063331538108,4.749366684618914,Transportation
22191,728,21463,3.2806092560046864,96.71939074399532,Housing
197925,42348,155577,21.39598332701781,78.6040166729822,Entertainment
23586,2557,21029,10.84117696938862,89.15882303061137,Housing
62176,12696,49480,20.419454451878536,79.58054554812146,Transportation
144139,49780,94359,34.536107507336666,65.46389249266333,Healthcare
32494,4103,28391,12.626946513202435,87.37305348679756,Food
99693,29714,69979,29.805502893884224,70.19449710611578,Transportation
94505,10514,83991,11.125337283741601,88.8746627162584,Transportation
54461,48084,6377,88.29070343915829,11.709296560841704,Transportation
38800,26312,12488,67.81443298969072,32.18556701030928,Food
199251,5458,193793,2.739258523169269,97.26074147683073,Entertainment
47351,39725,7626,83.89474351122468,16.105256488775314,Food
37735,3722,34013,9.863521929243408,90.13647807075658,Food
53776,2421,51355,4.502008330853913,95.49799166914609,Transportation
93020,16043,76977,17.246828639002366,82.75317136099764,Transportation
114240,21435,92805,18.76313025210084,81.23686974789915,Healthcare
9948,7094,2854,71.31081624447125,28.689183755528752,Housing
13745,9708,4037,70.62931975263731,29.370680247362678,Housing
178468,34961,143507,19.589506242015375,80.41049375798463,Entertainment
166497,41716,124781,25.055106098007773,74.94489390199223,Entertainment
164017,38233,125784,23.310388557283694,76.6896114427163,Entertainment
41456,9968,31488,24.044770358934777,75.95522964106523,Food
70638,45227,25411,64.026444689827,35.973555310173,Transportation
132540,34609,97931,26.11211709672552,73.88788290327449,Healthcare
180849,37874,142975,20.942333106624865,79.05766689337513,Entertainment
140618,6929,133689,4.927534170589825,95.07246582941018,Healthcare
17667,12149,5518,68.76662704477275,31.233372955227264,Housing
23373,6555,16818,28.04518033628546,71.95481966371455,Housing
39381,11360,28021,28.84639800919225,71.15360199080774,Food
9673,8306,1367,85.86787966504704,14.13212033495296,Housing
99070,23202,75868,23.41980417886343,76.58019582113657,Transportation
137368,22658,114710,16.49438005940248,83.50561994059753,Healthcare
18209,17715,494,97.287055851502,2.7129441484979955,Housing
16004,9752,6252,60.934766308422894,39.065233691577106,Housing
41375,3775,37600,9.123867069486405,90.87613293051359,Food
43750,5583,38167,12.761142857142858,87.23885714285714,Food
40283,10195,30088,25.3084427674205,74.6915572325795,Food
178696,48086,130610,26.90938801092358,73.09061198907642,Entertainment
121564,15203,106361,12.506169589681154,87.49383041031884,Healthcare
145318,42881,102437,29.508388499704097,70.4916115002959,Healthcare
163496,2064,161432,1.262416205901062,98.73758379409894,Entertainment
129159,20293,108866,15.71164223941034,84.28835776058966,Healthcare
173103,48894,124209,28.245610994610143,71.75438900538985,Entertainment
23078,5105,17973,22.120634370396047,77.87936562960395,Housing
185320,16025,169295,8.647204834880206,91.35279516511979,Entertainment
31853,1449,30404,4.549022070134681,95.45097792986532,Food
36954,23535,13419,63.68728689722357,36.31271310277642,Food
134764,24009,110755,17.815588732896025,82.18441126710397,Healthcare
159809,49136,110673,30.746703877754065,69.25329612224593,Entertainment
29072,8808,20264,30.297193175564118,69.70280682443588,Food
76881,2580,74301,3.3558356420962268,96.64416435790378,Transportation
11913,1066,10847,8.948207840174598,91.0517921598254,Housing
45837,24831,21006,54.17239348124877,45.82760651875123,Food
31223,9873,21350,31.620920475290653,68.37907952470935,Food
54103,36310,17793,67.112729423507,32.88727057649298,Transportation
181450,23797,157653,13.114907688068339,86.88509231193167,Entertainment
19970,629,19341,3.1497245868803203,96.85027541311968,Housing
183716,43401,140315,23.623963073439437,76.37603692656056,Entertainment
17127,16385,742,95.66765925147428,4.33234074852572,Housing
28962,18888,10074,65.2164905738554,34.783509426144605,Food
21407,7805,13602,36.46003643667959,63.53996356332041,Housing
73127,21300,51827,29.127408481135557,70.87259151886444,Transportation
140113,21555,118558,15.384011476451152,84.61598852354885,Healthcare
16535,4666,11869,28.2189295433928,71.7810704566072,Housing
120655,1408,119247,1.1669636567071402,98.83303634329286,Healthcare
75231,27018,48213,35.91338676875224,64.08661323124775,Transportation
23721,19238,4483,81.1011340162725,18.898865983727497,Housing
129514,43039,86475,33.23115647729203,66.76884352270797,Healthcare
151855,31558,120297,20.78166672154358,79.21833327845643,Entertainment
136369,44109,92260,32.34532775044182,67.65467224955817,Healthcare
158002,15303,142699,9.685320438981785,90.31467956101822,Entertainment
164981,7017,157964,4.253217037113364,95.74678296288664,Entertainment
12611,11279,1332,89.4377924034573,10.5622075965427,Housing
121953,24816,97137,20.348822907185554,79.65117709281444,Healthcare
106859,8950,97909,8.375522885297448,91.62447711470256,Healthcare
168066,48846,119220,29.0635821641498,70.9364178358502,Entertainment
14643,11139,3504,76.07047736119648,23.929522638803526,Housing
12263,8801,3462,71.76873521976678,28.23126478023322,Housing
114036,16108,97928,14.125363920165562,85.87463607983445,Healthcare
199457,8043,191414,4.032448096582221,95.96755190341779,Entertainment
55106,35690,19416,64.76608717743984,35.23391282256016,Transportation
134655,39239,95416,29.140395826371098,70.8596041736289,Healthcare
30617,15958,14659,52.121370480452036,47.878629519547964,Food
112645,35772,76873,31.756402858537886,68.24359714146212,Healthcare
48629,33691,14938,69.28170433280553,30.71829566719447,Food
94683,8998,85685,9.503289925329785,90.49671007467022,Transportation
43149,9417,33732,21.824375999443788,78.17562400055621,Food
131741,45197,86544,34.307466923736726,65.69253307626327,Healthcare
145651,38046,107605,26.121344858600352,73.87865514139965,Healthcare
93859,45028,48831,47.97408879276362,52.02591120723638,Transportation
25799,7601,18198,29.462382262878407,70.5376177371216,Food
40858,28716,12142,70.28244162709873,29.71755837290127,Food
32527,5559,26968,17.090417191871367,82.90958280812863,Food
83162,48760,34402,58.632548519756625,41.367451480243375,Transportation
18230,15707,2523,86.16017553483269,13.839824465167307,Housing
129522,20529,108993,15.84981701950248,84.15018298049752,Healthcare
22286,2632,19654,11.810104998653863,88.18989500134614,Housing
20889,3471,17418,16.61640097659055,83.38359902340945,Housing
41483,27105,14378,65.34001880288311,34.65998119711689,Food
27940,10095,17845,36.1309949892627,63.86900501073729,Food
31042,12673,18369,40.825333419238454,59.174666580761546,Food
8632,3083,5549,35.7159406858202,64.2840593141798,Housing
101741,30121,71620,29.60556707718619,70.3944329228138,Healthcare
38008,18157,19851,47.7715217848874,52.2284782151126,Food
131985,22212,109773,16.829185134674397,83.17081486532561,Healthcare
114405,4486,109919,3.921157292076395,96.07884270792361,Healthcare
16202,13373,2829,82.53919269226022,17.460807307739785,Housing
20541,8712,11829,42.412735504600555,57.587264495399445,Housing
33348,5592,27756,16.768621806405182,83.23137819359482,Food
20197,4648,15549,23.01331880972422,76.98668119027579,Housing
44123,23956,20167,54.29367903361059,45.70632096638941,Food
105559,16375,89184,15.512651692418459,84.48734830758154,Healthcare
22537,5891,16646,26.139237698007722,73.86076230199228,Housing
169009,21883,147126,12.947831180588015,87.05216881941197,Entertainment
86585,23017,63568,26.58312640757637,73.41687359242363,Transportation
198529,11023,187506,5.552337441885065,94.44766255811493,Entertainment
64247,12846,51401,19.994707924105406,80.0052920758946,Transportation
41957,37521,4436,89.4272707772243,10.572729222775699,Food
192003,21651,170352,11.276386306463962,88.72361369353604,Entertainment
37393,32299,5094,86.37712940924771,13.622870590752278,Food
14304,7345,6959,51.34927293064877,48.65072706935123,Housing
57911,2693,55218,4.650239160090484,95.34976083990952,Transportation
39197,15958,23239,40.71229941066918,59.28770058933082,Food
36435,4655,31780,12.776176753121998,87.22382324687801,Food
181178,40122,141056,22.145072801333495,77.8549271986665,Entertainment
108557,46563,61994,42.892673894820234,57.107326105179766,Healthcare
70662,41169,29493,58.2618663496646,41.7381336503354,Transportation
24920,1625,23295,6.520866773675762,93.47913322632424,Housing
13476,9428,4048,69.96141288216087,30.03858711783912,Housing
71353,36439,34914,51.06863061118664,48.931369388813366,Transportation
88363,28371,59992,32.10732999105961,67.8926700089404,Transportation
49841,41913,7928,84.09341706627073,15.90658293372926,Food
167062,22293,144769,13.34414768169901,86.65585231830099,Entertainment
188627,23707,164920,12.568190131847508,87.43180986815248,Entertainment
108513,36725,71788,33.84387124123377,66.15612875876623,Healthcare
195390,29715,165675,15.208045447566407,84.7919545524336,Entertainment
34122,1539,32583,4.510286618603834,95.48971338139617,Food
21279,6511,14768,30.598242398608953,69.40175760139104,Housing
75735,35897,39838,47.398164653066615,52.60183534693339,Transportation
88547,15150,73397,17.109557636057687,82.89044236394231,Transportation
41018,507,40511,1.236042712955288,98.76395728704472,Food
80217,7232,72985,9.015545333283468,90.98445466671653,Transportation
99883,15928,83955,15.946657589379573,84.05334241062043,Transportation
160919,42418,118501,26.359845636624634,73.64015436337536,Entertainment
173759,23091,150668,13.28909581661957,86.71090418338044,Entertainment
103513,6066,97447,5.8601335098007015,94.1398664901993,Healthcare
58856,38636,20220,65.6449639798831,34.3550360201169,Transportation
78811,20092,58719,25.49390313534913,74.50609686465087,Transportation
34700,10762,23938,31.014409221902017,68.98559077809799,Food
151334,3669,147665,2.4244386588605336,97.57556134113948,Entertainment
45800,38727,7073,84.55676855895197,15.443231441048036,Food
42483,9318,33165,21.933479274062567,78.06652072593744,Food
9207,1960,7247,21.288150320408388,78.71184967959162,Housing
164727,27015,137712,16.399861589174815,83.60013841082518,Entertainment
47338,24426,22912,51.59913811314377,48.40086188685623,Food
33803,29680,4123,87.8028577345206,12.197142265479394,Food
11645,6314,5331,54.220695577501075,45.77930442249893,Housing
54277,12306,41971,22.672586915267978,77.32741308473202,Transportation
16577,8070,8507,48.68190866863727,51.31809133136274,Housing
88970,48348,40622,54.3419130043835,45.6580869956165,Transportation
192355,256,192099,0.13308726053390868,99.8669127394661,Entertainment
39895,21452,18443,53.77114926682541,46.22885073317458,Food
103775,21801,81974,21.007949891592386,78.99205010840761,Healthcare
136052,15909,120143,11.693323141151913,88.30667685884809,Healthcare
12566,11382,1184,90.57774948273118,9.422250517268822,Housing
97086,18768,78318,19.33131450466597,80.66868549533403,Transportation
13109,6644,6465,50.68273705088108,49.31726294911893,Housing
84053,3148,80905,3.7452559694478484,96.25474403055215,Transportation
55345,4507,50838,8.143463727527328,91.85653627247267,Transportation
19657,5988,13669,30.46243068626952,69.53756931373047,Housing
160986,39599,121387,24.59779111227063,75.40220888772937,Entertainment
20226,13440,6786,66.44912488875705,33.55087511124296,Housing
21716,6981,14735,32.14680419966845,67.85319580033156,Housing
178501,9815,168686,5.498568635469829,94.50143136453018,Entertainment
178141,17230,160911,9.672113662772748,90.32788633722724,Entertainment
74875,19731,55144,26.351919866444074,73.64808013355592,Transportation
189181,41604,147577,21.99163763802919,78.00836236197081,Entertainment
196455,42530,153925,21.648723626275736,78.35127637372426,Entertainment
178937,20287,158650,11.337509849835417,88.66249015016459,Entertainment
102016,10236,91780,10.033720200752823,89.96627979924718,Healthcare
188181,4499,183682,2.390783341570084,97.60921665842992,Entertainment
98693,49004,49689,49.65296424265146,50.34703575734854,Transportation
124688,33220,91468,26.642499679199283,73.35750032080071,Healthcare
108121,7820,100301,7.2326375079771745,92.76736249202283,Healthcare
35274,18293,16981,51.85972671089188,48.14027328910812,Food
106005,38289,67716,36.11999433988963,63.88000566011037,Healthcare
85202,36069,49133,42.33351329780991,57.66648670219009,Transportation
131441,35183,96258,26.76714267237772,73.23285732762228,Healthcare
12996,11826,1170,90.99722991689751,9.002770083102494,Housing
195960,26862,169098,13.70789957134109,86.29210042865891,Entertainment
18704,10343,8361,55.29833190761334,44.701668092386655,Housing
99865,38091,61774,38.14249236469233,61.85750763530766,Transportation
190223,47553,142670,24.998554328340948,75.00144567165906,Entertainment
197562,42691,154871,21.60891264514431,78.3910873548557,Entertainment
130223,49587,80636,38.07852683473734,61.92147316526266,Healthcare
136469,26092,110377,19.11936044083272,80.88063955916729,Healthcare
56450,1725,54725,3.0558015943312666,96.94419840566873,Transportation
44324,38737,5587,87.39509069578558,12.60490930421442,Food
10708,1991,8717,18.593574897273065,81.40642510272693,Housing
80653,30344,50309,37.62290305382317,62.377096946176835,Transportation
12594,9141,3453,72.58218199142449,27.417818008575512,Housing
14295,4815,9480,33.68310598111228,66.31689401888772,Housing
124431,41752,82679,33.55433935273364,66.44566064726635,Healthcare
29655,22634,7021,76.32439723486765,23.675602765132357,Food
29888,3854,26034,12.894807280513918,87.10519271948608,Food
125773,16363,109410,13.009946490900273,86.99005350909972,Healthcare
64498,1816,62682,2.815591181121895,97.18440881887811,Transportation
14970,6938,8032,46.34602538410154,53.653974615898456,Housing
175601,29394,146207,16.7390846293586,83.2609153706414,Entertainment
14374,6892,7482,47.94768331710032,52.05231668289968,Housing
133070,20151,112919,15.143157736529647,84.85684226347036,Healthcare
69623,30408,39215,43.67522226850322,56.32477773149678,Transportation
34089,8683,25406,25.471559740678813,74.5284402593212,Food
9021,3843,5178,42.60059860325906,57.399401396740934,Housing
97079,31113,65966,32.049155842149176,67.95084415785082,Transportation
175526,16556,158970,9.43222086756378,90.56777913243621,Entertainment
27314,9706,17608,35.53489053232774,64.46510946767225,Food
165334,30129,135205,18.22311200358063,81.77688799641936,Entertainment
97607,17273,80334,17.69647668712285,82.30352331287715,Transportation
62522,24028,38494,38.431272192188345,61.568727807811655,Transportation
115592,6182,109410,5.348120977230258,94.65187902276975,Healthcare
43893,35450,8443,80.76458660834301,19.235413391656984,Food
90612,31589,59023,34.86182845539222,65.13817154460779,Transportation
40848,5649,35199,13.829318448883665,86.17068155111633,Food
131567,41446,90121,31.50182036528917,68.49817963471084,Healthcare
12158,3925,8233,32.28327027471624,67.71672972528377,Housing
44903,27518,17385,61.28321047591475,38.71678952408525,Food
36351,32021,4330,88.08836070534511,11.911639294654892,Food
28162,20539,7623,72.93160997088275,27.06839002911725,Food
163449,15198,148251,9.29831323532111,90.7016867646789,Entertainment
51426,49146,2280,95.56644498891612,4.433555011083888,Transportation
107451,2925,104526,2.722171036100176,97.27782896389982,Healthcare
16228,11579,4649,71.35198422479665,28.64801577520335,Housing
15835,11172,4663,70.55257341332492,29.447426586675086,Housing
192810,21226,171584,11.008765105544319,88.99123489445569,Entertainment
127314,35354,91960,27.769137722481425,72.23086227751858,Healthcare
66652,49044,17608,73.58218808137791,26.417811918622096,Transportation
168507,28395,140112,16.85093200875928,83.14906799124073,Entertainment
82850,39046,43804,47.128545564272784,52.871454435727216,Transportation
61393,12336,49057,20.093496001172774,79.90650399882723,Transportation
15491,13018,2473,84.03589180814667,15.964108191853335,Housing
9970,8389,1581,84.14242728184553,15.857572718154463,Housing
158199,34354,123845,21.71568720409105,78.28431279590895,Entertainment
81708,26016,55692,31.84021148479953,68.15978851520047,Transportation
162383,22449,139934,13.824723031351805,86.17527696864819,Entertainment
42250,33541,8709,79.38698224852071,20.61301775147929,Food
8159,3953,4206,48.44956489765902,51.55043510234098,Housing
40324,12352,27972,30.631881757762123,69.36811824223787,Food
8619,1274,7345,14.781297134238311,85.21870286576168,Housing
12994,4234,8760,32.58426966292135,67.41573033707866,Housing
161946,36992,124954,22.84218196188853,77.15781803811147,Entertainment
68723,42815,25908,62.300830871760546,37.699169128239454,Transportation
178888,49876,129012,27.881132328607844,72.11886767139215,Entertainment
23796,1230,22566,5.168935955622794,94.83106404437721,Housing
39395,835,38560,2.1195583195837036,97.8804416804163,Food
29434,26746,2688,90.86770401576409,9.132295984235919,Food
98381,7848,90533,7.977150059462701,92.0228499405373,Transportation
40848,20760,20088,50.82256169212691,49.17743830787309,Food
112978,37450,75528,33.14804652233178,66.85195347766822,Healthcare
11667,10993,674,94.22302219936573,5.776977800634268,Housing
14519,10983,3536,75.64570562710931,24.354294372890696,Housing
15611,913,14698,5.8484402024213695,94.15155979757863,Housing
156655,25063,131592,15.99885097826434,84.00114902173567,Entertainment
40358,33329,7029,82.58337876009712,17.41662123990287,Food
124912,25752,99160,20.61611374407583,79.38388625592417,Healthcare
87124,19689,67435,22.598824663697716,77.40117533630229,Transportation
19252,2693,16559,13.988157074589653,86.01184292541035,Housing
13429,9076,4353,67.58507707200833,32.414922927991654,Housing
57037,22322,34715,39.135999438960674,60.86400056103932,Transportation
13810,8533,5277,61.78855901520637,38.211440984793626,Housing
35879,2985,32894,8.31962986705315,91.68037013294685,Food
97724,35268,62456,36.08939462158733,63.910605378412676,Transportation
158577,45874,112703,28.92853314162836,71.07146685837165,Entertainment
94253,33146,61107,35.16705038566412,64.83294961433589,Transportation
132178,37177,95001,28.126465826385633,71.87353417361437,Healthcare
100095,41452,58643,41.412657974923825,58.587342025076175,Healthcare
15777,197,15580,1.2486531026177348,98.75134689738226,Housing
156733,3487,153246,2.2248026899249043,97.77519731007509,Entertainment
18433,15038,3395,81.58194542396788,18.418054576032116,Housing
39699,37952,1747,95.59938537494648,4.400614625053527,Food
45047,21181,23866,47.01977934157657,52.98022065842343,Food
77677,23804,53873,30.64484982684707,69.35515017315292,Transportation
17077,11383,5694,66.65690695086958,33.34309304913041,Housing
57383,801,56582,1.3958837983374868,98.60411620166252,Transportation
16162,9762,6400,60.40094047766365,39.59905952233635,Housing
78703,1892,76811,2.403974435536129,97.59602556446387,Transportation
98138,16475,81663,16.78758482952577,83.21241517047423,Transportation
37662,14892,22770,39.541182093356696,60.458817906643304,Food
34549,30595,3954,88.55538510521289,11.444614894787113,Food
190456,10156,180300,5.332465241315579,94.66753475868443,Entertainment
23007,10233,12774,44.477767635936885,55.52223236406311,Housing
128017,18932,109085,14.788660880976746,85.21133911902325,Healthcare
48342,24094,24248,49.840718216044024,50.159281783955976,Food
10193,8415,1778,82.55665652899047,17.443343471009516,Housing
43566,26025,17541,59.73695083321856,40.263049166781435,Food
178793,765,178028,0.42786910002069434,99.5721308999793,Entertainment
13276,8859,4417,66.72943657728231,33.270563422717686,Housing
179373,42276,137097,23.56876452977873,76.43123547022127,Entertainment
101712,25801,75911,25.366721724083686,74.63327827591631,Healthcare
17256,14212,3044,82.35975892443209,17.64024107556792,Housing
38747,15995,22752,41.280615273440525,58.719384726559475,Food
198412,10910,187502,5.498659355280931,94.50134064471906,Entertainment
74060,34525,39535,46.617607345395626,53.382392654604374,Transportation
188599,30431,158168,16.13529233983213,83.86470766016787,Entertainment
27419,4198,23221,15.31055107771983,84.68944892228018,Food
70708,15248,55460,21.564745149063754,78.43525485093625,Transportation
38330,35509,2821,92.64022958518132,7.35977041481868,Food
12426,6919,5507,55.68163528086271,44.31836471913729,Housing
62772,18298,44474,29.149939463455045,70.85006053654496,Transportation
182323,14012,168311,7.685261870416787,92.3147381295832,Entertainment
118549,39879,78670,33.63925465419362,66.36074534580636,Healthcare
19094,650,18444,3.404210746831465,96.59578925316853,Housing
11764,11181,583,95.04420265215913,4.95579734784087,Housing
26461,15682,10779,59.264578058274445,40.735421941725555,Food
8419,2204,6215,26.17888110226868,73.82111889773132,Housing
72892,49098,23794,67.3571859737694,32.64281402623059,Transportation
98438,11294,87144,11.473211564639673,88.52678843536033,Transportation
79300,25179,54121,31.751576292559896,68.2484237074401,Transportation
36566,13560,23006,37.08362960126894,62.91637039873106,Food
183520,24160,159360,13.164777680906713,86.83522231909329,Entertainment
176522,10731,165791,6.079128947100078,93.92087105289993,Entertainment
50714,37361,13353,73.66999250700003,26.33000749299996,Transportation
127957,42443,85514,33.16973670842548,66.83026329157451,Healthcare
48066,2895,45171,6.022968418424666,93.97703158157533,Food
118478,46533,71945,39.27564611151438,60.72435388848562,Healthcare
20857,12155,8702,58.277796423263176,41.722203576736824,Housing
43324,18019,25305,41.59126581109778,58.40873418890222,Food
173109,10419,162690,6.018751191445852,93.98124880855416,Entertainment
77751,8593,69158,11.051947884914663,88.94805211508535,Transportation
81236,19194,62042,23.627455807769955,76.37254419223004,Transportation
24616,6371,18245,25.881540461488463,74.11845953851154,Housing
101903,30823,71080,30.247392127807814,69.75260787219219,Healthcare
196106,23100,173006,11.779343824258309,88.22065617574168,Entertainment
36570,13029,23541,35.627563576702215,64.37243642329778,Food
21969,4033,17936,18.35768583003323,81.64231416996677,Housing
181645,35745,145900,19.678493765311458,80.32150623468854,Entertainment
93408,9422,83986,10.08693045563549,89.9130695443645,Transportation
180528,10139,170389,5.616303288132589,94.38369671186742,Entertainment
179282,14877,164405,8.298100199685411,91.70189980031459,Entertainment
197388,17923,179465,9.08008592214319,90.91991407785682,Entertainment
18996,1134,17862,5.969677826910929,94.03032217308908,Housing
30683,15479,15204,50.44813088681028,49.55186911318971,Food
17916,9984,7932,55.72672471533825,44.27327528466176,Housing
142769,39423,103346,27.61313730571763,72.38686269428237,Healthcare
41575,17719,23856,42.61936259771497,57.38063740228503,Food
121530,5767,115763,4.745330371101786,95.25466962889821,Healthcare
69936,47258,22678,67.57320979180965,32.42679020819035,Transportation
109429,31419,78010,28.711767447385977,71.28823255261403,Healthcare
34298,27125,7173,79.08624409586564,20.91375590413435,Food
18267,1062,17205,5.813762522581705,94.1862374774183,Housing
15848,5208,10640,32.86219081272085,67.13780918727915,Housing
131754,7802,123952,5.921641847685839,94.07835815231415,Healthcare
191026,6092,184934,3.1890946782113434,96.81090532178865,Entertainment
71372,39365,32007,55.15468250854677,44.84531749145323,Transportation
42738,12070,30668,28.241845664280028,71.75815433571996,Food
31369,26639,4730,84.92141923555103,15.07858076444898,Food
15480,10288,5192,66.45994832041343,33.54005167958656,Housing
94224,26119,68105,27.720113771438275,72.27988622856174,Transportation
160141,21170,138971,13.219600227299692,86.7803997727003,Entertainment
17521,8017,9504,45.75652074653273,54.243479253467264,Housing
40458,22449,18009,55.48717188195166,44.51282811804835,Food
9939,3953,5986,39.77261293892746,60.22738706107255,Housing
150239,19920,130319,13.25887419378457,86.74112580621544,Entertainment
177261,32879,144382,18.54835525016783,81.45164474983217,Entertainment
21944,19873,2071,90.5623405030988,9.437659496901203,Housing
45825,7347,38478,16.032733224222586,83.96726677577742,Food
165545,20014,145531,12.089764112476969,87.91023588752303,Entertainment
193499,16543,176956,8.549398188104332,91.45060181189567,Entertainment
41879,39884,1995,95.23627593782086,4.7637240621791355,Food
127483,32994,94489,25.88109787187311,74.11890212812689,Healthcare
105631,3206,102425,3.0350938644905376,96.96490613550947,Healthcare
14171,7097,7074,50.08115164773128,49.91884835226872,Housing
25878,15585,10293,60.22490146070021,39.77509853929979,Food
82873,40201,42672,48.50916462539066,51.49083537460935,Transportation
20413,276,20137,1.3520795571449566,98.64792044285504,Housing
47999,10929,37070,22.76922435884081,77.23077564115918,Food
136701,29203,107498,21.362682057922033,78.63731794207797,Healthcare
168519,26547,141972,15.753119826251046,84.24688017374895,Entertainment
139502,37199,102303,26.665567518745252,73.33443248125475,Healthcare
106908,28114,78794,26.29737718412093,73.70262281587907,Healthcare
167508,16249,151259,9.700432218162716,90.29956778183728,Entertainment
127585,48293,79292,37.8516283262139,62.14837167378611,Healthcare
164728,10488,154240,6.366859307464426,93.63314069253558,Entertainment
58954,8381,50573,14.21616853818231,85.78383146181768,Transportation
78907,35490,43417,44.976998238432586,55.023001761567414,Transportation
154155,35546,118609,23.058609840744705,76.94139015925529,Entertainment
36113,8320,27793,23.038794893805555,76.96120510619444,Food
176241,45452,130789,25.78968571444783,74.21031428555217,Entertainment
24021,6416,17605,26.70996211648141,73.2900378835186,Housing
16662,6361,10301,38.176689473052456,61.82331052694755,Housing
41992,4552,37440,10.840160030481997,89.159839969518,Food
14337,11944,2393,83.3089209737044,16.6910790262956,Housing
78874,7025,71849,8.906610543398331,91.09338945660167,Transportation
117862,46597,71265,39.53521915460454,60.46478084539546,Healthcare
175575,25333,150242,14.428591769898905,85.5714082301011,Entertainment
126640,46170,80470,36.45767530006317,63.54232469993683,Healthcare
13238,10666,2572,80.5710832452032,19.428916754796795,Housing
176197,36440,139757,20.681396391539018,79.31860360846098,Entertainment
161067,15554,145513,9.656850875722526,90.34314912427747,Entertainment
132577,7878,124699,5.942207170172805,94.05779282982719,Healthcare
173341,30025,143316,17.32134924801403,82.67865075198597,Entertainment
37917,15167,22750,40.00052746789039,59.99947253210961,Food
161970,17333,144637,10.701364450206828,89.29863554979318,Entertainment
26213,23349,2864,89.07412352649449,10.925876473505513,Food
198787,15691,183096,7.893373309119811,92.10662669088019,Entertainment
8389,999,7390,11.908451543688162,88.09154845631184,Housing
11266,666,10600,5.911592401917273,94.08840759808272,Housing
159279,33539,125740,21.05676203391533,78.94323796608467,Entertainment
75208,35224,39984,46.835443037974684,53.16455696202531,Transportation
187778,47080,140698,25.07215967791754,74.92784032208246,Entertainment
177739,9879,167860,5.558149871440708,94.4418501285593,Entertainment
188937,27018,161919,14.300004763492593,85.6999952365074,Entertainment
14737,3294,11443,22.351903372463866,77.64809662753613,Housing
31100,21939,9161,70.54340836012861,29.456591639871384,Food
44952,6477,38475,14.408702616123866,85.59129738387612,Food
36911,12963,23948,35.11961203977134,64.88038796022866,Food
16529,9268,7261,56.07114767983544,43.92885232016456,Housing
15989,9692,6297,60.6166739633498,39.383326036650196,Housing
157297,21383,135914,13.59402912960832,86.40597087039168,Entertainment
188131,4693,183438,2.4945383801712637,97.50546161982874,Entertainment
34766,11382,23384,32.7388828165449,67.2611171834551,Food
190541,10666,179875,5.597745367138831,94.40225463286117,Entertainment
98818,37564,61254,38.01331741180757,61.98668258819243,Transportation
9286,7052,2234,75.94227869911695,24.05772130088305,Housing
117571,19798,97773,16.839186534094292,83.1608134659057,Healthcare
40156,33132,7024,82.50821794999503,17.491782050004982,Food
163699,48918,114781,29.882894825258553,70.11710517474144,Entertainment
49474,10367,39107,20.954440716335853,79.04555928366415,Food
53263,46088,7175,86.52911026416086,13.470889735839137,Transportation
167595,11226,156369,6.698290521793609,93.30170947820639,Entertainment
91676,6922,84754,7.550503948688861,92.44949605131114,Transportation
35451,34841,610,98.27931511099828,1.7206848890017206,Food
158037,40364,117673,25.540854356891106,74.4591456431089,Entertainment
116489,395,116094,0.33908781086626205,99.66091218913374,Healthcare
20327,14270,6057,70.20219412603926,29.79780587396074,Housing
98090,10207,87883,10.405749821592416,89.59425017840759,Transportation
13073,5104,7969,39.04230092557179,60.957699074428206,Housing
154191,37822,116369,24.529317534745868,75.47068246525413,Entertainment
123609,27898,95711,22.56955399687725,77.43044600312275,Healthcare
19837,19029,808,95.92680344810202,4.0731965518979685,Housing
98283,26189,72094,26.64652076147452,73.3534792385255,Transportation
32689,10763,21926,32.92544892777387,67.07455107222613,Food
105507,20605,84902,19.529509890339032,80.47049010966097,Healthcare
83755,19502,64253,23.28458002507313,76.71541997492687,Transportation
29993,1961,28032,6.538192244857132,93.46180775514287,Food
136532,27407,109125,20.073682360179298,79.9263176398207,Healthcare
81569,10846,70723,13.296718115950911,86.70328188404909,Transportation
145344,37569,107775,25.848332232496695,74.1516677675033,Healthcare
51560,15167,36393,29.41621411947246,70.58378588052754,Transportation
19205,5906,13299,30.752408227024215,69.2475917729758,Housing
16007,12042,3965,75.22958705566315,24.770412944336854,Housing
160224,10273,149951,6.411648691831435,93.58835130816855,Entertainment
9907,3490,6417,35.2276168365802,64.7723831634198,Housing
18123,16376,1747,90.36031562103405,9.639684378965955,Housing
36874,19094,17780,51.78174323371481,48.21825676628519,Food
13645,13454,191,98.60021986075486,1.3997801392451448,Housing
16311,830,15481,5.088590521733799,94.9114094782662,Housing
34476,26567,7909,77.05940364311405,22.94059635688595,Food
136819,37321,99498,27.277644186845396,72.7223558131546,Healthcare
27780,21304,6476,76.68826493880489,23.311735061195105,Food
157117,12937,144180,8.23399122946594,91.76600877053406,Entertainment
76326,32542,43784,42.635537038492785,57.36446296150722,Transportation
159055,11637,147418,7.316337116091918,92.68366288390808,Entertainment
20512,15064,5448,73.4399375975039,26.560062402496097,Housing
18409,4017,14392,21.820848498017273,78.17915150198273,Housing
17519,13380,4139,76.3742222729608,23.625777727039214,Housing
188228,14937,173291,7.93558875406422,92.06441124593579,Entertainment
82223,18320,63903,22.280870316091605,77.71912968390839,Transportation
11683,7227,4456,61.859111529572886,38.140888470427114,Housing
63477,3439,60038,5.4177103517809595,94.58228964821905,Transportation
189674,3642,186032,1.9201366555247426,98.07986334447526,Entertainment
199664,41209,158455,20.639173812004167,79.36082618799584,Entertainment
12493,674,11819,5.395021211878652,94.60497878812136,Housing
31588,30022,1566,95.04242117259719,4.957578827402812,Food
156545,17332,139213,11.071576862882877,88.92842313711712,Entertainment
35197,7637,27560,21.697871977725374,78.30212802227463,Food
144188,42548,101640,29.508696978944155,70.49130302105584,Healthcare
126884,38373,88511,30.242583777308408,69.75741622269159,Healthcare
153871,34094,119777,22.157521560268016,77.84247843973199,Entertainment
126200,2837,123363,2.2480190174326466,97.75198098256736,Healthcare
178124,23874,154250,13.403022613460285,86.5969773865397,Entertainment
30058,27351,2707,90.99407811564309,9.00592188435691,Food
34847,12720,22127,36.502424885929926,63.49757511407008,Food
84939,36159,48780,42.570550630452445,57.429449369547555,Transportation
149614,5413,144201,3.6179769272929008,96.3820230727071,Healthcare
158729,17335,141394,10.921129724246988,89.078870275753,Entertainment
156077,22032,134045,14.11610935627927,85.88389064372073,Entertainment
185392,34171,151221,18.431755415551912,81.5682445844481,Entertainment
139897,20246,119651,14.472075884400667,85.52792411559933,Healthcare
33925,9940,23985,29.299926308032425,70.70007369196757,Food
101781,26107,75674,25.650170464035526,74.34982953596447,Healthcare
31842,27433,4409,86.15350794548081,13.846492054519189,Food
54657,36901,17756,67.51376767843095,32.486232321569055,Transportation
65702,14859,50843,22.61574990106846,77.38425009893155,Transportation
37186,34305,2881,92.25246060345292,7.747539396547087,Food
15715,8942,6773,56.901049952274896,43.098950047725104,Housing
70613,34898,35715,49.4214946256355,50.57850537436449,Transportation
103455,21004,82451,20.302547001111595,79.69745299888841,Healthcare
23309,3802,19507,16.31129606589729,83.6887039341027,Housing
18093,14422,3671,79.71038523185763,20.289614768142375,Housing
23810,5126,18684,21.528769424611507,78.47123057538849,Housing
18326,11787,6539,64.3184546545891,35.68154534541089,Housing
53147,26401,26746,49.67542852842117,50.32457147157883,Transportation
94628,18161,76467,19.191993913006723,80.80800608699327,Transportation
167375,49862,117513,29.79058999253174,70.20941000746826,Entertainment
44360,9241,35119,20.831830477908024,79.16816952209199,Food
28130,5447,22683,19.363668681123354,80.63633131887664,Food
116021,49941,66080,43.044793614949015,56.955206385050985,Healthcare
104508,527,103981,0.5042676158762965,99.4957323841237,Healthcare
23534,6645,16889,28.235744029914166,71.76425597008583,Housing
133720,42017,91703,31.421627280885435,68.57837271911457,Healthcare
185409,41965,143444,22.633744855967077,77.36625514403292,Entertainment
16547,11515,5032,69.5896537136641,30.410346286335894,Housing
145767,42161,103606,28.923556086082584,71.07644391391742,Healthcare
18102,17053,1049,94.20506021434095,5.794939785659043,Housing
170397,27125,143272,15.918707488981612,84.08129251101839,Entertainment
12543,1007,11536,8.028382364665552,91.97161763533444,Housing
29379,11182,18197,38.061200176997176,61.938799823002824,Food
167170,46632,120538,27.89495722916791,72.10504277083209,Entertainment
16605,2014,14591,12.128876844324,87.871123155676,Housing
10551,6411,4140,60.762013079328966,39.23798692067103,Housing
140804,34275,106529,24.3423482287435,75.6576517712565,Healthcare
15374,14876,498,96.76076492780018,3.2392350721998175,Housing
41667,1081,40586,2.5943792449660403,97.40562075503396,Food
104097,1019,103078,0.9788946847651709,99.02110531523482,Healthcare
24002,13087,10915,54.52462294808767,45.47537705191234,Housing
191759,29954,161805,15.620648835256754,84.37935116474324,Entertainment
12873,1481,11392,11.504699759185893,88.49530024081412,Housing
188248,43202,145046,22.94951340784497,77.05048659215504,Entertainment
147154,7181,139973,4.879921714666268,95.12007828533373,Healthcare
93206,20684,72522,22.19170439671266,77.80829560328735,Transportation
113567,37822,75745,33.30368857150405,66.69631142849596,Healthcare
16367,5285,11082,32.2905847131423,67.7094152868577,Housing
112146,38886,73260,34.67444224493072,65.32555775506928,Healthcare
62335,48845,13490,78.3588674099623,21.6411325900377,Transportation
14430,3466,10964,24.01940401940402,75.98059598059598,Housing
176244,31016,145228,17.598329588525,82.40167041147501,Entertainment
130194,44823,85371,34.4278538181483,65.57214618185169,Healthcare
27372,20696,6676,75.61011252374689,24.389887476253104,Food
198056,1845,196211,0.9315547117986832,99.06844528820132,Entertainment
167534,49214,118320,29.3755297432163,70.6244702567837,Entertainment
22489,16633,5856,73.96060296144782,26.03939703855218,Housing
8552,5383,3169,62.94434050514499,37.055659494855,Housing
37659,29685,7974,78.82577869831913,21.174221301680873,Food
12599,2278,10321,18.0808000634971,81.91919993650289,Housing
32698,14629,18069,44.739739433604505,55.2602605663955,Food
198282,47996,150286,24.205928929504445,75.79407107049556,Entertainment
43766,36386,7380,83.13759539368459,16.862404606315405,Food
78835,24435,54400,30.9951163823175,69.0048836176825,Transportation
89895,49632,40263,55.21107959285834,44.78892040714166,Transportation
48384,27796,20588,57.448743386243386,42.551256613756614,Food
127724,33800,93924,26.463311515455203,73.5366884845448,Healthcare
154000,21034,132966,13.65844155844156,86.34155844155845,Entertainment
22277,3812,18465,17.111819365264623,82.88818063473538,Housing
154683,47621,107062,30.78618852750464,69.21381147249535,Entertainment
22868,9765,13103,42.70159174392163,57.29840825607836,Housing
10618,4678,5940,44.05726125447353,55.94273874552647,Housing
17323,15229,2094,87.91202447613,12.08797552387,Housing
45824,5972,39852,13.032472067039105,86.96752793296089,Food
54713,26201,28512,47.88807047685194,52.111929523148056,Transportation
22208,15042,7166,67.73234870317003,32.26765129682997,Housing
71347,48025,23322,67.31187015571784,32.68812984428217,Transportation
10382,531,9851,5.1146214602196105,94.88537853978039,Housing
8203,160,8043,1.9505059124710473,98.04949408752896,Housing
41803,36160,5643,86.50096882998828,13.499031170011722,Food
93195,43826,49369,47.02612801115939,52.97387198884061,Transportation
166120,30569,135551,18.401757765470744,81.59824223452927,Entertainment
15943,12199,3744,76.51633945932385,23.48366054067616,Housing
22334,6644,15690,29.748365720426257,70.25163427957375,Housing
45851,21922,23929,47.81138906457875,52.18861093542125,Food
114246,6457,107789,5.651839014057385,94.34816098594261,Healthcare
143382,28548,114834,19.910449010336027,80.08955098966398,Healthcare
63359,6668,56691,10.524155999936868,89.47584400006313,Transportation
199051,49249,149802,24.741900317004184,75.25809968299582,Entertainment
69815,14716,55099,21.078564778342763,78.92143522165723,Transportation
20449,7823,12626,38.256149444960634,61.74385055503937,Housing
28876,5497,23379,19.03657016207231,80.96342983792769,Food
122960,4231,118729,3.440956408588159,96.55904359141184,Healthcare
43279,40157,3122,92.78633979528178,7.213660204718224,Food
154788,23202,131586,14.989534072408714,85.01046592759128,Entertainment
187123,22298,164825,11.9162262255308,88.0837737744692,Entertainment
143021,32360,110661,22.62604792303228,77.37395207696773,Healthcare
68303,3232,65071,4.731856580238057,95.26814341976194,Transportation
76484,43481,33003,56.84979865069818,43.15020134930182,Transportation
91709,49956,41753,54.47229824771833,45.52770175228167,Transportation
70602,49232,21370,69.73173564488259,30.26826435511742,Transportation
100435,42998,57437,42.81176880569523,57.18823119430477,Healthcare
55230,23772,31458,43.041825095057035,56.95817490494297,Transportation
27328,8809,18519,32.23433840749414,67.76566159250585,Food
10461,685,9776,6.548131153809387,93.4518688461906,Housing
102461,6820,95641,6.656191136139604,93.3438088638604,Healthcare
118229,49223,69006,41.63360935134358,58.36639064865642,Healthcare
104384,26777,77607,25.65239883507051,74.34760116492949,Healthcare
38194,31647,6547,82.8585641723831,17.141435827616903,Food
71631,40039,31592,55.896190196981756,44.103809803018244,Transportation
140593,45097,95496,32.076276912790824,67.92372308720917,Healthcare
179852,28756,151096,15.988701821497674,84.01129817850233,Entertainment
19618,13519,6099,68.9112039963299,31.0887960036701,Housing
52485,34622,17863,65.96551395636848,34.03448604363151,Transportation
31902,19169,12733,60.08714187198295,39.91285812801706,Food
15927,12641,3286,79.36836817982042,20.631631820179567,Housing
172218,10707,161511,6.217120161655576,93.78287983834443,Entertainment
17516,14559,2957,83.11829184745375,16.881708152546242,Housing
21417,18077,3340,84.40491198580567,15.59508801419433,Housing
98120,43810,54310,44.649408887077044,55.350591112922956,Transportation
17348,5334,12014,30.747060179847825,69.25293982015218,Housing
65537,7410,58127,11.306590170438072,88.69340982956193,Transportation
146098,15802,130296,10.81602759791373,89.18397240208627,Healthcare
27182,11594,15588,42.65322639982341,57.34677360017659,Food
112187,2682,109505,2.3906513232370954,97.6093486767629,Healthcare
95511,22409,73102,23.462219011422768,76.53778098857723,Transportation
42229,14031,28198,33.22598214497147,66.77401785502853,Food
65652,8536,57116,13.001888746725157,86.99811125327484,Transportation
190694,30911,159783,16.209739163266804,83.7902608367332,Entertainment
111096,48047,63049,43.24818175271837,56.751818247281626,Healthcare
151664,39244,112420,25.875619791117206,74.12438020888278,Entertainment
86871,17288,69583,19.900772409664906,80.0992275903351,Transportation
105362,25475,79887,24.178546344982063,75.82145365501793,Healthcare
184170,16829,167341,9.137753162838681,90.86224683716132,Entertainment
60483,46569,13914,76.99518873071773,23.00481126928228,Transportation
171864,5380,166484,3.1303821626402275,96.86961783735978,Entertainment
180691,7393,173298,4.091515349408659,95.90848465059135,Entertainment
191383,35200,156183,18.39243819984011,81.60756180015989,Entertainment
86170,46404,39766,53.85168852268771,46.14831147731229,Transportation
176564,22150,154414,12.545026166149384,87.45497383385062,Entertainment
87494,4259,83235,4.867762360847601,95.1322376391524,Transportation
21239,10874,10365,51.19826733838693,48.801732661613066,Housing
24648,6816,17832,27.65335929892892,72.34664070107108,Housing
40906,24920,15986,60.920158411968906,39.079841588031094,Food
191210,42987,148223,22.48156477171696,77.51843522828304,Entertainment
30096,13809,16287,45.883173843700156,54.11682615629984,Food
28946,21619,7327,74.6873488564914,25.312651143508603,Food
10005,2016,7989,20.14992503748126,79.85007496251873,Housing
17550,4637,12913,26.421652421652418,73.57834757834758,Housing
25718,19945,5773,77.55268683412396,22.44731316587604,Food
43706,555,43151,1.2698485333821443,98.73015146661785,Food
106929,22480,84449,21.02329583181363,78.97670416818636,Healthcare
82738,17709,65029,21.403708090599242,78.59629190940076,Transportation
27867,14365,13502,51.548426454229016,48.451573545770984,Food
121443,17693,103750,14.568974745353788,85.43102525464622,Healthcare
154528,12247,142281,7.925424518533858,92.07457548146614,Entertainment
59796,38460,21336,64.31868352398153,35.681316476018466,Transportation
22437,11530,10907,51.38833177340999,48.61166822659001,Housing
135397,18040,117357,13.323781176835528,86.67621882316448,Healthcare
92941,14457,78484,15.555029534866204,84.44497046513379,Transportation
126994,8369,118625,6.59007512165929,93.40992487834072,Healthcare
14168,9795,4373,69.13466967814794,30.865330321852063,Housing
107831,44207,63624,40.99655943096141,59.00344056903859,Healthcare
57352,25921,31431,45.19633142697727,54.80366857302273,Transportation
87175,25568,61607,29.32950960711213,70.67049039288787,Transportation
82876,48292,34584,58.2701867850765,41.7298132149235,Transportation
195077,3325,191752,1.704455163858374,98.29554483614163,Entertainment
147954,30358,117596,20.518539546075132,79.48146045392487,Healthcare
38180,18443,19737,48.305395495023575,51.694604504976425,Food
27881,26763,1118,95.99010078548115,4.009899214518848,Food
10852,10658,194,98.21231109472907,1.7876889052709177,Housing
179370,31445,147925,17.53080225232759,82.46919774767241,Entertainment
177193,42305,134888,23.875096646030038,76.12490335396997,Entertainment
127686,27195,100491,21.29834124336262,78.70165875663737,Healthcare
177794,14316,163478,8.052015253608108,91.94798474639188,Entertainment
123941,44406,79535,35.82833767679784,64.17166232320217,Healthcare
182260,20748,161512,11.383737517831669,88.61626248216832,Entertainment
18485,12021,6464,65.03110630240737,34.96889369759264,Housing
177241,16783,160458,9.469028046558076,90.53097195344192,Entertainment
18314,7973,10341,43.53500054603036,56.46499945396965,Housing
17017,2808,14209,16.50114591291062,83.49885408708938,Housing
59973,33351,26622,55.61002451102996,44.38997548897004,Transportation
190881,48784,142097,25.557284381368493,74.44271561863151,Entertainment
191599,28276,163323,14.7579058345816,85.24209416541841,Entertainment
36876,30890,5986,83.76721987200348,16.23278012799653,Food
17028,8329,8699,48.91355414611229,51.08644585388772,Housing
49300,47975,1325,97.31237322515213,2.68762677484787,Food
196807,1354,195453,0.687983659117816,99.31201634088218,Entertainment
96729,690,96039,0.7133331265701083,99.2866668734299,Transportation
125323,16878,108445,13.46759972231753,86.53240027768247,Healthcare
139116,45609,93507,32.7848701802812,67.2151298197188,Healthcare
96927,9735,87192,10.043641090717758,89.95635890928224,Transportation
135384,17997,117387,13.293299060450275,86.70670093954973,Healthcare
46324,5432,40892,11.726103099905016,88.27389690009498,Food
100529,43270,57259,43.04230620020093,56.95769379979906,Healthcare
40582,1907,38675,4.699127692080233,95.30087230791978,Food
30453,27842,2611,91.42613207237382,8.573867927626178,Food
42455,9166,33289,21.58991873748675,78.41008126251326,Food
51392,43852,7540,85.32845579078456,14.671544209215442,Transportation
8667,4468,4199,51.551863389869624,48.44813661013038,Housing
111465,12439,99026,11.159556811555197,88.84044318844481,Healthcare
111553,5608,105945,5.027206798562118,94.97279320143788,Healthcare
103857,12661,91196,12.190800812655864,87.80919918734413,Healthcare
11664,3489,8175,29.912551440329217,70.08744855967079,Housing
168745,18423,150322,10.917656819461317,89.08234318053869,Entertainment
35110,34932,178,99.49302193107377,0.5069780689262319,Food
55191,4663,50528,8.448841296588212,91.55115870341179,Transportation
125742,22286,103456,17.723592753415723,82.27640724658427,Healthcare
149674,23016,126658,15.377420260031801,84.6225797399682,Healthcare
82371,39618,42753,48.09702443821248,51.90297556178752,Transportation
196657,31040,165617,15.78382666266647,84.21617333733353,Entertainment
141231,13888,127343,9.83353513038922,90.16646486961078,Healthcare
66441,24406,42035,36.733342363901805,63.26665763609819,Transportation
57188,32800,24388,57.354689795061894,42.6453102049381,Transportation
51194,4512,46682,8.813532835879204,91.1864671641208,Transportation
48930,28820,20110,58.900470059268336,41.09952994073166,Food
117666,27476,90190,23.350840514677138,76.64915948532285,Healthcare
99493,20951,78542,21.05776285768848,78.94223714231153,Transportation
23125,8130,14995,35.15675675675676,64.84324324324324,Housing
70875,8378,62497,11.820811287477955,88.17918871252205,Transportation
72667,16630,56037,22.88521612286182,77.11478387713818,Transportation
30451,25359,5092,83.2780532659026,16.721946734097404,Food
11067,5941,5126,53.68211800849372,46.31788199150628,Housing
14344,2416,11928,16.843279419966535,83.15672058003346,Housing
17649,6980,10669,39.54898294520936,60.45101705479063,Housing
196659,19571,177088,9.951743881541145,90.04825611845885,Entertainment
199532,15034,184498,7.534631036625703,92.46536896337429,Entertainment
21772,20384,1388,93.62483924306449,6.3751607569355135,Housing
12612,1865,10747,14.787503964478274,85.21249603552172,Housing
134745,48328,86417,35.866265909681246,64.13373409031875,Healthcare
39537,446,39091,1.128057262817108,98.87194273718289,Food
138066,25511,112555,18.477394869120563,81.52260513087943,Healthcare
29669,20671,8998,69.67204826586672,30.32795173413327,Food
35786,6691,29095,18.697255910132455,81.30274408986755,Food
47967,28621,19346,59.66810515562783,40.33189484437217,Food
160358,16167,144191,10.081816934608813,89.91818306539119,Entertainment
194692,32608,162084,16.748505331497956,83.25149466850205,Entertainment
114818,25470,89348,22.182932989600936,77.81706701039907,Healthcare
47487,46277,1210,97.45193421357425,2.5480657864257585,Food
52890,9569,43321,18.09226696918132,81.90773303081869,Transportation
40541,6719,33822,16.57334550208431,83.42665449791569,Food
18851,10053,8798,53.32873587608085,46.67126412391915,Housing
65185,15261,49924,23.411827874511008,76.588172125489,Transportation
23781,13051,10730,54.87994617551827,45.12005382448173,Housing
24390,3267,21123,13.394833948339482,86.60516605166052,Housing
72785,23027,49758,31.637013120835338,68.36298687916467,Transportation
163870,658,163212,0.40153780435711234,99.5984621956429,Entertainment
92300,20269,72031,21.95991332611051,78.04008667388949,Transportation
24035,3040,20995,12.648221343873518,87.35177865612648,Housing
192197,17007,175190,8.848733330905269,91.15126666909474,Entertainment
36724,294,36430,0.8005663871038013,99.1994336128962,Food
144349,5651,138698,3.914817560218637,96.08518243978136,Healthcare
186885,25574,161311,13.684351339058779,86.31564866094122,Entertainment
142854,19659,123195,13.761602755260615,86.23839724473939,Healthcare
76509,43744,32765,57.174972879007704,42.8250271209923,Transportation
135671,41723,93948,30.753071769206393,69.24692823079361,Healthcare
164861,17013,147848,10.319602574289856,89.68039742571014,Entertainment
14704,3713,10991,25.251632208922743,74.74836779107726,Housing
106554,33525,73029,31.462920209471257,68.53707979052874,Healthcare
9267,1528,7739,16.48861551742743,83.51138448257257,Housing
11863,7455,4408,62.842451319227855,37.15754868077215,Housing
46055,23527,22528,51.0845727933992,48.9154272066008,Food
20946,4642,16304,22.16174926000191,77.83825073999809,Housing
23352,597,22755,2.5565262076053443,97.44347379239466,Housing
144543,16882,127661,11.679569401492982,88.32043059850702,Healthcare
122073,28242,93831,23.135337052419455,76.86466294758054,Healthcare
71055,32624,38431,45.91372880163254,54.08627119836746,Transportation
69478,10411,59067,14.984599441549843,85.01540055845015,Transportation
145216,47857,97359,32.9557349052446,67.04426509475539,Healthcare
17288,504,16784,2.915316982878297,97.0846830171217,Housing
25610,7940,17670,31.003514252245218,68.99648574775479,Food
66878,17810,49068,26.630581058045994,73.369418941954,Transportation
163908,21637,142271,13.200697952509943,86.79930204749006,Entertainment
22939,781,22158,3.4046819826496355,96.59531801735037,Housing
140499,17883,122616,12.728204471206201,87.27179552879379,Healthcare
106766,23171,83595,21.702601951932262,78.29739804806773,Healthcare
11137,6985,4152,62.71886504444644,37.281134955553554,Housing
37498,32551,4947,86.80729638914076,13.192703610859247,Food
35749,10514,25235,29.410612884276482,70.58938711572351,Food
180262,37536,142726,20.823024264681408,79.17697573531859,Entertainment
10242,6318,3924,61.6871704745167,38.3128295254833,Housing
54333,12002,42331,22.08970607181639,77.9102939281836,Transportation
195958,17328,178630,8.842711193214873,91.15728880678513,Entertainment
160966,27566,133400,17.125355665171526,82.87464433482847,Entertainment
145618,38862,106756,26.687634770426733,73.31236522957326,Healthcare
56964,7838,49126,13.759567446106313,86.24043255389368,Transportation
188770,39420,149350,20.882555490808922,79.11744450919109,Entertainment
144289,38745,105544,26.85235880767072,73.14764119232929,Healthcare
46638,1996,44642,4.279771859856769,95.72022814014322,Food
17111,5342,11769,31.219683244696395,68.7803167553036,Housing
137131,16015,121116,11.678613880158387,88.32138611984162,Healthcare
22473,9765,12708,43.452142571085304,56.547857428914696,Housing
107204,48171,59033,44.933957688145966,55.066042311854034,Healthcare
54858,12118,42740,22.08975901418207,77.91024098581792,Transportation
15979,2428,13551,15.194943363164153,84.80505663683586,Housing
91295,15898,75397,17.413878087518484,82.58612191248152,Transportation
19745,13025,6720,65.96606735882501,34.03393264117498,Housing
59625,27126,32499,45.49433962264151,54.50566037735849,Transportation
118414,30225,88189,25.524853480162818,74.47514651983718,Healthcare
13757,12595,1162,91.55339100094497,8.446608999055027,Housing
32646,12018,20628,36.813085829810696,63.186914170189304,Food
25227,20527,4700,81.36916795496887,18.630832045031116,Food
155711,12588,143123,8.084207281438047,91.91579271856195,Entertainment
13892,3561,10331,25.633458105384392,74.36654189461561,Housing
49790,47921,1869,96.246234183571,3.753765816429002,Food
61499,10916,50583,17.74988211190426,82.25011788809574,Transportation
166067,4721,161346,2.8428284969319613,97.15717150306804,Entertainment
70390,31498,38892,44.74783349907657,55.25216650092343,Transportation
34143,7995,26148,23.416220015815835,76.58377998418416,Food
43654,38043,5611,87.14665322765383,12.853346772346178,Food
21565,20354,1211,94.38441919777418,5.6155808022258284,Housing
12835,3775,9060,29.411764705882355,70.58823529411765,Housing
156648,21106,135542,13.473520249221183,86.52647975077882,Entertainment
91564,33349,58215,36.42151937442663,63.57848062557338,Transportation
35682,7367,28315,20.646264222857464,79.35373577714255,Food
91066,39462,51604,43.33340654031142,56.66659345968858,Transportation
71967,27846,44121,38.69273416982784,61.30726583017216,Transportation
92783,38688,54095,41.69729368526562,58.30270631473438,Transportation
99387,21586,77801,21.71913831788866,78.28086168211135,Transportation
110999,44343,66656,39.949008549626576,60.050991450373424,Healthcare
45461,14390,31071,31.65350520226128,68.34649479773873,Food
186661,23708,162953,12.701099854817022,87.29890014518298,Entertainment
33372,29148,4224,87.34268248831356,12.657317511686445,Food
180347,43085,137262,23.890056391290123,76.10994360870987,Entertainment
13772,2529,11243,18.363345919256464,81.63665408074354,Housing
47555,31826,15729,66.92461360529913,33.07538639470087,Food
10472,707,9765,6.7513368983957225,93.24866310160428,Housing
166247,17216,149031,10.355675591138487,89.64432440886151,Entertainment
106841,37834,69007,35.411499330781254,64.58850066921875,Healthcare
179474,737,178737,0.4106444387487881,99.58935556125121,Entertainment
48475,40537,7938,83.62454873646209,16.375451263537908,Food
66166,34108,32058,51.5491339963123,48.45086600368769,Transportation
132578,7711,124867,5.816198766009443,94.18380123399056,Healthcare
176668,25293,151375,14.316684402381869,85.68331559761813,Entertainment
136236,47540,88696,34.895328694324554,65.10467130567544,Healthcare
97966,19733,78233,20.142702570279486,79.85729742972052,Transportation
90984,45679,45305,50.205530642750375,49.794469357249625,Transportation
69860,11345,58515,16.23962210134555,83.76037789865445,Transportation
145074,23902,121172,16.47572962763831,83.52427037236168,Healthcare
37192,18051,19141,48.53463110346311,51.46536889653689,Food
16252,5041,11211,31.017720895889738,68.98227910411026,Housing
162126,20998,141128,12.95165488570618,87.04834511429382,Entertainment
47766,23906,23860,50.048151404764894,49.951848595235106,Food
59506,37266,22240,62.62561758478137,37.37438241521863,Transportation
17277,9471,7806,54.818544886264974,45.181455113735026,Housing
73645,43848,29797,59.539683617353525,40.460316382646475,Transportation
148786,20662,128124,13.887059266328821,86.11294073367118,Healthcare
19649,1636,18013,8.326123466843097,91.6738765331569,Housing
32382,21164,11218,65.35729726391205,34.64270273608795,Food
96114,42915,53199,44.65010300268431,55.34989699731568,Transportation
17184,2192,14992,12.756052141527002,87.243947858473,Housing
83514,8749,74765,10.4760878415595,89.5239121584405,Transportation
190431,3123,187308,1.6399640814783307,98.36003591852167,Entertainment
191902,6587,185315,3.432481162259903,96.5675188377401,Entertainment
155386,30362,125024,19.539726873720927,80.46027312627906,Entertainment
149856,25444,124412,16.978966474482167,83.02103352551782,Healthcare
19023,11950,7073,62.81869316091048,37.18130683908952,Housing
9167,1062,8105,11.5850332715174,88.4149667284826,Housing
20765,13910,6855,66.98771972068384,33.01228027931616,Housing
48890,39930,8960,81.67314379218654,18.326856207813456,Food
10494,2719,7775,25.91004383457214,74.08995616542786,Housing
41679,37052,4627,88.89848604812975,11.101513951870247,Food
55356,46069,9287,83.22313750993568,16.77686249006431,Transportation
83372,38524,44848,46.20735978505973,53.79264021494027,Transportation
23514,11128,12386,47.32499787360721,52.67500212639279,Housing
42889,19692,23197,45.91387068945417,54.08612931054583,Food
24678,5488,19190,22.238430991166222,77.76156900883377,Housing
28263,1445,26818,5.112691504794254,94.88730849520574,Food
106022,39205,66817,36.97817434117447,63.02182565882553,Healthcare
60560,18125,42435,29.92899603698811,70.07100396301189,Transportation
9819,1130,8689,11.508300234239739,88.49169976576026,Housing
165783,15827,149956,9.546817224926562,90.45318277507344,Entertainment
122103,18452,103651,15.111831814124141,84.88816818587586,Healthcare
161222,24395,136827,15.1313096227562,84.86869037724381,Entertainment
144972,6189,138783,4.269100240046353,95.73089975995364,Healthcare
170961,30268,140693,17.704622691725014,82.295377308275,Entertainment
171088,21818,149270,12.752501636584682,87.24749836341532,Entertainment
123712,40175,83537,32.4746184687015,67.5253815312985,Healthcare
16199,10717,5482,66.15840483980493,33.84159516019508,Housing
38648,27718,10930,71.71910577520183,28.280894224798182,Food
183182,22340,160842,12.19552139402343,87.80447860597657,Entertainment
49536,32528,17008,65.66537467700259,34.33462532299741,Food
48597,25530,23067,52.534107043644674,47.46589295635533,Food
128040,33910,94130,26.483911277725706,73.51608872227429,Healthcare
53191,48113,5078,90.45327217010396,9.546727829896035,Transportation
159771,3749,156022,2.3464834043725085,97.6535165956275,Entertainment
42393,20698,21695,48.82409831811856,51.17590168188144,Food
18677,5895,12782,31.562884831611072,68.43711516838893,Housing
124475,17333,107142,13.924884514962843,86.07511548503716,Healthcare
92465,46918,45547,50.741361596279674,49.258638403720326,Transportation
132768,4297,128471,3.2364726440106053,96.7635273559894,Healthcare
179693,40422,139271,22.495033195505666,77.50496680449433,Entertainment
48723,30270,18453,62.12671633520104,37.87328366479897,Food
23520,13737,9783,58.405612244897966,41.59438775510204,Housing
26135,10938,15197,41.8519227090109,58.1480772909891,Food
192489,20577,171912,10.689961504293752,89.31003849570625,Entertainment
138077,29815,108262,21.59302418215923,78.40697581784077,Healthcare
136694,18292,118402,13.381713901122213,86.61828609887779,Healthcare
176522,47750,128772,27.05045263479906,72.94954736520094,Entertainment
33003,4247,28756,12.86852710359664,87.13147289640337,Food
92265,7490,84775,8.117921205224082,91.88207879477591,Transportation
109650,30255,79395,27.592339261285908,72.40766073871409,Healthcare
41936,25752,16184,61.40785959557421,38.59214040442579,Food
127714,8983,118731,7.033684639115524,92.96631536088448,Healthcare
12167,12052,115,99.05482041587902,0.945179584120983,Housing
82431,41961,40470,50.90439276485789,49.09560723514212,Transportation
20330,5179,15151,25.474667978357108,74.52533202164288,Housing
14116,10404,3712,73.70359875318788,26.296401246812128,Housing
173732,7076,166656,4.072939930467617,95.92706006953239,Entertainment
10555,5409,5146,51.245855045002365,48.75414495499763,Housing
64275,45380,18895,70.60287825748736,29.39712174251264,Transportation
162402,41936,120466,25.822342089383138,74.17765791061687,Entertainment
139919,1766,138153,1.2621588204604093,98.73784117953959,Healthcare
26542,2765,23777,10.417451586165322,89.58254841383467,Food
123131,39159,83972,31.802714182456082,68.19728581754391,Healthcare
59342,28141,31201,47.42172491658522,52.57827508341478,Transportation
9089,4578,4511,50.368577401254264,49.631422598745736,Housing
12079,3348,8731,27.717526285288518,72.28247371471149,Housing
166247,24996,141251,15.035459286483366,84.96454071351664,Entertainment
190855,36450,154405,19.098268318880827,80.90173168111917,Entertainment
198466,24491,173975,12.340148942388117,87.65985105761189,Entertainment
79755,3424,76331,4.2931477650304055,95.7068522349696,Transportation
140884,33055,107829,23.462564947048637,76.53743505295137,Healthcare
41389,11673,29716,28.203145763367075,71.79685423663292,Food
21216,2779,18437,13.098604826546003,86.901395173454,Housing
86953,31205,55748,35.88720343173898,64.112796568261,Transportation
47814,13276,34538,27.765926297737064,72.23407370226293,Food
26675,10875,15800,40.76850984067479,59.231490159325205,Food
101950,49396,52554,48.451201569396765,51.548798430603235,Healthcare
159624,20936,138688,13.115822182128001,86.884177817872,Entertainment
24673,24504,169,99.31504073278482,0.6849592672151744,Housing
12478,8210,4268,65.79580060907196,34.20419939092803,Housing
40476,22766,17710,56.24567645024212,43.75432354975788,Food
18147,793,17354,4.369868297790268,95.63013170220972,Housing
180238,45948,134290,25.492959309357627,74.50704069064237,Entertainment
68159,14728,53431,21.608298243812264,78.39170175618774,Transportation
42460,37383,5077,88.04286387187942,11.957136128120585,Food
17064,15524,1540,90.97515236755743,9.024847632442569,Housing
191423,31957,159466,16.694441106868034,83.30555889313196,Entertainment
10139,1704,8435,16.80639116283657,83.19360883716342,Housing
30931,4022,26909,13.003136012414728,86.99686398758527,Food
128458,9114,119344,7.094925968020677,92.90507403197932,Healthcare
44582,1462,43120,3.279350410479566,96.72064958952043,Food
152666,27025,125641,17.702042366997237,82.29795763300277,Entertainment
112021,44864,67157,40.04963355085207,59.95036644914793,Healthcare
18900,7993,10907,42.29100529100529,57.70899470899471,Housing
93602,10420,83182,11.132240764086237,88.86775923591377,Transportation
39759,244,39515,0.613697527603813,99.38630247239618,Food
119645,4367,115278,3.6499644782481506,96.35003552175185,Healthcare
63454,22703,40751,35.778674315252,64.22132568474801,Transportation
48215,13237,34978,27.45411179093643,72.54588820906356,Food
14721,7002,7719,47.564703484817606,52.435296515182394,Housing
8215,7605,610,92.57455873402313,7.425441265976872,Housing
87272,11720,75552,13.429278577321476,86.57072142267852,Transportation
27231,6511,20720,23.910249348169366,76.08975065183063,Food
124687,7803,116884,6.258070207800332,93.74192979219967,Healthcare
165077,19377,145700,11.738158556310086,88.26184144368992,Entertainment
76146,10086,66060,13.245607123158143,86.75439287684186,Transportation
12780,1927,10853,15.078247261345853,84.92175273865415,Housing
27403,4895,22508,17.863007699886875,82.13699230011312,Food
145925,21509,124416,14.73976357718006,85.26023642281994,Healthcare
65235,22211,43024,34.04767379474208,65.95232620525792,Transportation
151311,29146,122165,19.262314041940108,80.73768595805988,Entertainment
11178,6052,5126,54.1420647700841,45.85793522991591,Housing
127454,35191,92263,27.610745837714003,72.389254162286,Healthcare
117198,21134,96064,18.03273093397498,81.96726906602501,Healthcare
20031,5669,14362,28.301133243472616,71.69886675652738,Housing
42654,32463,10191,76.10775073850048,23.892249261499508,Food
66706,22082,44624,33.103468953317545,66.89653104668245,Transportation
175190,25138,150052,14.348992522404247,85.65100747759575,Entertainment
100057,31457,68600,31.439079724557,68.560920275443,Healthcare
48166,3748,44418,7.781422580243325,92.21857741975667,Food
9428,3967,5461,42.07679253288078,57.92320746711922,Housing
134064,15861,118203,11.83091657715718,88.16908342284282,Healthcare
56373,39873,16500,70.7306689372572,29.269331062742804,Transportation
194053,11154,182899,5.747914229617682,94.25208577038232,Entertainment
26631,20789,5842,78.06315947579888,21.936840524201116,Food
85234,16304,68930,19.12851678907478,80.87148321092522,Transportation
125508,26714,98794,21.28469898333174,78.71530101666826,Healthcare
125168,43148,82020,34.472069538540204,65.52793046145979,Healthcare
125711,49895,75816,39.69024190404976,60.30975809595024,Healthcare
118119,13117,105002,11.104902682887596,88.8950973171124,Healthcare
100338,47024,53314,46.86559429129542,53.13440570870458,Healthcare
105400,29811,75589,28.283681214421254,71.71631878557875,Healthcare
22828,16052,6776,70.31715437182407,29.682845628175926,Housing
189223,8933,180290,4.720884881858971,95.27911511814104,Entertainment
101621,36303,65318,35.72391533246081,64.2760846675392,Healthcare
78014,21876,56138,28.041120824467402,71.9588791755326,Transportation
58206,16365,41841,28.115658179569113,71.88434182043089,Transportation
52671,36519,16152,69.33416870763797,30.66583129236202,Transportation
15190,6687,8503,44.02238314680711,55.97761685319289,Housing
104512,10796,93716,10.329914268218003,89.670085731782,Healthcare
23996,23010,986,95.89098183030505,4.1090181696949495,Housing
153570,1242,152328,0.8087517093182263,99.19124829068178,Entertainment
9607,5179,4428,53.90860830644322,46.09139169355678,Housing
180291,11101,169190,6.157267972333616,93.84273202766639,Entertainment
178411,12198,166213,6.8370223809070065,93.16297761909298,Entertainment
119406,24220,95186,20.28373783561965,79.71626216438035,Healthcare
43101,11049,32052,25.635136075729104,74.36486392427089,Food
166088,7446,158642,4.483165550792352,95.51683444920765,Entertainment
62642,41964,20678,66.99019826953162,33.009801730468375,Transportation
51005,43054,7951,84.41133222233115,15.588667777668855,Transportation
42576,19023,23553,44.68010146561443,55.31989853438557,Food
171034,41355,129679,24.179402925734063,75.82059707426593,Entertainment
9460,2723,6737,28.78435517970402,71.21564482029599,Housing
39860,27236,12624,68.32915203211239,31.670847967887607,Food
73417,22115,51302,30.12245120339976,69.87754879660024,Transportation
20972,1852,19120,8.830822048445548,91.16917795155446,Housing
29774,12446,17328,41.80157184120373,58.19842815879627,Food
67530,7942,59588,11.760698948615431,88.23930105138457,Transportation
121798,46439,75359,38.127883873298416,61.87211612670159,Healthcare
84342,46127,38215,54.690427070735815,45.309572929264185,Transportation
148229,17729,130500,11.960547531184856,88.03945246881514,Healthcare
35938,29265,6673,81.4319105125494,18.56808948745061,Food
73881,19043,54838,25.775233145192942,74.22476685480706,Transportation
12497,1466,11031,11.730815395694966,88.26918460430502,Housing
92245,8776,83469,9.513794785625237,90.48620521437476,Transportation
83001,26502,56499,31.929735786315828,68.07026421368417,Transportation
108832,19047,89785,17.501286386356956,82.49871361364305,Healthcare
124074,46698,77376,37.63721649983074,62.36278350016925,Healthcare
198721,35268,163453,17.747495232008696,82.25250476799131,Entertainment
105768,28390,77378,26.841766886014675,73.15823311398533,Healthcare
115390,44113,71277,38.229482624144204,61.770517375855796,Healthcare
38233,35903,2330,93.90578819344545,6.094211806554547,Food
127388,4090,123298,3.2106634847866364,96.78933651521336,Healthcare
10382,9437,945,90.8977075707956,9.102292429204391,Housing
90405,17862,72543,19.757756761241083,80.24224323875892,Transportation
14980,6763,8217,45.14686248331108,54.85313751668892,Housing
99395,18268,81127,18.37919412445294,81.62080587554706,Transportation
100406,42597,57809,42.42475549269964,57.57524450730036,Healthcare
66227,29732,36495,44.89407643408278,55.10592356591722,Transportation
58657,5741,52916,9.787408152479669,90.21259184752033,Transportation
31637,7362,24275,23.270221576002783,76.72977842399722,Food
146011,25551,120460,17.499366486086664,82.50063351391333,Healthcare
146933,6764,140169,4.6034587192802165,95.39654128071979,Healthcare
198751,21760,176991,10.948372586804595,89.0516274131954,Entertainment
192874,39008,153866,20.224602590292108,79.77539740970789,Entertainment
21673,11130,10543,51.354219535827994,48.64578046417201,Housing
20782,12474,8308,60.02309691078819,39.97690308921182,Housing
131347,15660,115687,11.922617189581795,88.0773828104182,Healthcare
148477,30549,117928,20.57490385716306,79.42509614283694,Healthcare
147273,42132,105141,28.60809517019413,71.39190482980588,Healthcare
42813,37146,5667,86.76336626725526,13.236633732744727,Food
193492,10611,182881,5.483947656750667,94.51605234324933,Entertainment
171553,29135,142418,16.9830897740057,83.0169102259943,Entertainment
86822,30615,56207,35.261800004607124,64.73819999539288,Transportation
32263,26849,5414,83.21916746737749,16.780832532622508,Food
99297,7507,91790,7.5601478393103525,92.43985216068965,Transportation
11654,7102,4552,60.940449631027974,39.059550368972026,Housing
55207,19517,35690,35.35240096364591,64.64759903635408,Transportation
105367,26465,78902,25.116972107016426,74.88302789298356,Healthcare
125177,18409,106768,14.706375771906979,85.29362422809302,Healthcare
70068,6704,63364,9.567848375863447,90.43215162413657,Transportation
103043,49966,53077,48.49043603155964,51.50956396844036,Healthcare
155831,30608,125223,19.641791427893036,80.35820857210696,Entertainment
32789,15689,17100,47.848363780536154,52.151636219463846,Food
12430,8820,3610,70.95736122284795,29.042638777152053,Housing
47835,46762,1073,97.75687258283683,2.243127417163165,Food
41139,9190,31949,22.338899827414377,77.66110017258563,Food
12088,4178,7910,34.56320317670417,65.43679682329582,Housing
131154,5212,125942,3.9739542827515746,96.02604571724842,Healthcare
20775,10015,10760,48.206979542719615,51.79302045728038,Housing
147588,9652,137936,6.539827086212971,93.46017291378703,Healthcare
121424,10518,110906,8.662208459612597,91.3377915403874,Healthcare
103340,23142,80198,22.394039094251983,77.60596090574802,Healthcare
55675,5002,50673,8.984283789851819,91.01571621014818,Transportation
84676,49932,34744,58.96830270678822,41.03169729321177,Transportation
86537,5752,80785,6.646867813767521,93.35313218623249,Transportation
25121,6749,18372,26.865968711436643,73.13403128856335,Food
12798,6036,6762,47.163619315518055,52.83638068448195,Housing
154966,46260,108706,29.851709407224806,70.14829059277518,Entertainment
31514,15235,16279,48.34359332360221,51.65640667639779,Food
41560,32334,9226,77.80076997112609,22.199230028873917,Food
134228,1942,132286,1.4467920255088358,98.55320797449116,Healthcare
62599,16940,45659,27.061135161903543,72.93886483809645,Transportation
177781,45724,132057,25.719283837980438,74.28071616201957,Entertainment
117431,35571,81860,30.29097938363805,69.70902061636195,Healthcare
149649,49656,99993,33.18164504941563,66.81835495058436,Healthcare
79481,47780,31701,60.11499603678867,39.88500396321133,Transportation
90598,40954,49644,45.204088390472194,54.795911609527806,Transportation
9986,8338,1648,83.49689565391549,16.50310434608452,Housing
70230,49713,20517,70.78598889363519,29.2140111063648,Transportation
118162,46022,72140,38.94822362519253,61.05177637480747,Healthcare
191539,20343,171196,10.620813515785297,89.3791864842147,Entertainment
198839,8734,190105,4.392498453522699,95.60750154647731,Entertainment
40633,16279,24354,40.06349518863978,59.93650481136022,Food
39349,11703,27646,29.741543622455463,70.25845637754455,Food
123646,21682,101964,17.535545023696685,82.46445497630332,Healthcare
21564,21559,5,99.97681320719718,0.023186792802819513,Housing
147951,30201,117750,20.412839386012937,79.58716061398707,Healthcare
192363,32840,159523,17.07189012440022,82.92810987559977,Entertainment
41897,215,41682,0.5131632336444137,99.4868367663556,Food
128288,12391,115897,9.6587365926665,90.3412634073335,Healthcare
46272,33313,12959,71.99386237897649,28.006137621023512,Food
121051,4820,116231,3.9817927980768433,96.01820720192316,Healthcare
133895,23016,110879,17.189588856940137,82.81041114305985,Healthcare
137117,26580,110537,19.384904862270908,80.6150951377291,Healthcare
85054,7045,78009,8.282973169986127,91.71702683001386,Transportation
11564,1389,10175,12.01141473538568,87.98858526461431,Housing
152694,15562,137132,10.19162508022581,89.8083749197742,Entertainment
83618,7498,76120,8.966968834461479,91.03303116553853,Transportation
80713,16679,64034,20.664576957863044,79.33542304213695,Transportation
155050,33616,121434,21.68074814575943,78.31925185424056,Entertainment
153879,1949,151930,1.2665795852585473,98.73342041474146,Entertainment
18704,16669,2035,89.1199743370402,10.880025662959794,Housing
15996,9007,6989,56.307826956739184,43.692173043260816,Housing
119324,17997,101327,15.082464550300024,84.91753544969998,Healthcare
16112,5287,10825,32.81405163853029,67.18594836146971,Housing
107444,31839,75605,29.63311120211459,70.36688879788541,Healthcare
90525,23332,67193,25.774095553714442,74.22590444628555,Transportation
70567,33205,37362,47.05457225048536,52.94542774951465,Transportation
28407,8339,20068,29.35544056042525,70.64455943957475,Food
53149,28879,24270,54.33592353572033,45.66407646427967,Transportation
146054,41241,104813,28.23681651991729,71.7631834800827,Healthcare
157320,33149,124171,21.071065344520722,78.92893465547928,Entertainment
10113,5879,4234,58.13309601503016,41.86690398496984,Housing
118186,37924,80262,32.08840302573909,67.91159697426092,Healthcare
187490,41971,145519,22.385727238786068,77.61427276121393,Entertainment
124241,21845,102396,17.5827625341071,82.4172374658929,Healthcare
8572,7082,1490,82.61782547830144,17.382174521698555,Housing
197754,37349,160405,18.886596478453026,81.11340352154697,Entertainment
86546,38674,47872,44.6860629029649,55.3139370970351,Transportation
122581,20291,102290,16.553136293552832,83.44686370644716,Healthcare
8769,1343,7426,15.315315315315313,84.68468468468468,Housing
17836,2800,15036,15.698587127158556,84.30141287284144,Housing
87031,5704,81327,6.553986510553711,93.44601348944629,Transportation
29921,19585,10336,65.4557000100264,34.544299989973595,Food
186776,20373,166403,10.907718336402963,89.09228166359703,Entertainment
19240,40,19200,0.2079002079002079,99.7920997920998,Housing
154523,20151,134372,13.040777101143519,86.95922289885648,Entertainment
42007,20225,21782,48.14673744852048,51.85326255147952,Food
22973,5619,17354,24.459147695120357,75.54085230487965,Housing
26408,8032,18376,30.415025749772795,69.5849742502272,Food
17662,16964,698,96.04801268259541,3.9519873174045976,Housing
135668,9638,126030,7.104107084942654,92.89589291505735,Healthcare
81656,43039,38617,52.707700597629085,47.29229940237092,Transportation
166013,9175,156838,5.526675621788655,94.47332437821134,Entertainment
179947,24359,155588,13.536763602616325,86.46323639738367,Entertainment
145762,46581,99181,31.956888626665386,68.04311137333463,Healthcare
136696,15797,120899,11.556300111195645,88.44369988880435,Healthcare
60392,10892,49500,18.035501390912703,81.9644986090873,Transportation
178926,3089,175837,1.7264120362608006,98.27358796373919,Entertainment
30507,13650,16857,44.74382928508211,55.256170714917886,Food
157486,49527,107959,31.44850970879951,68.5514902912005,Entertainment
102674,34890,67784,33.981338995266576,66.01866100473343,Healthcare
12460,7002,5458,56.195826645264845,43.804173354735155,Housing
100057,45301,54756,45.27519313991025,54.72480686008975,Healthcare
191248,28766,162482,15.041203045260604,84.95879695473938,Entertainment
175761,35561,140200,20.232588571981267,79.76741142801873,Entertainment
23223,6701,16522,28.855014425354174,71.14498557464583,Housing
38441,21797,16644,56.702479123852136,43.29752087614786,Food
103359,18822,84537,18.210315502278466,81.78968449772154,Healthcare
86949,37030,49919,42.588183877905436,57.411816122094564,Transportation
183063,6097,176966,3.330547407176764,96.66945259282323,Entertainment
135905,25538,110367,18.791067289650858,81.20893271034913,Healthcare
27912,24336,3576,87.18830610490112,12.811693895098882,Food
107836,27631,80205,25.62316851515264,74.37683148484736,Healthcare
164719,35597,129122,21.610743144385285,78.3892568556147,Entertainment
115730,4784,110946,4.133759612892077,95.86624038710792,Healthcare
149144,20079,129065,13.462827871050798,86.53717212894921,Healthcare
116998,34640,82358,29.607343715277185,70.39265628472282,Healthcare
24422,10736,13686,43.96036360658423,56.03963639341577,Housing
86614,20594,66020,23.77675664442238,76.22324335557762,Transportation
149915,39673,110242,26.46366274222059,73.53633725777941,Healthcare
69341,14901,54440,21.48945068574148,78.51054931425851,Transportation
14190,1256,12934,8.851303735024665,91.14869626497534,Housing
41576,25479,16097,61.28295170290552,38.71704829709447,Food
51786,45798,5988,88.43702931294172,11.562970687058279,Transportation
175824,8315,167509,4.729160979160979,95.27083902083902,Entertainment
99583,9255,90328,9.293754958175592,90.7062450418244,Transportation
160053,19521,140532,12.196584881258083,87.80341511874191,Entertainment
13251,9235,4016,69.69285336955701,30.30714663044299,Housing
165721,5543,160178,3.344778271914845,96.65522172808515,Entertainment
101377,14255,87122,14.06137486806672,85.93862513193328,Healthcare
121088,45538,75550,37.60735993657505,62.39264006342494,Healthcare
134384,47318,87066,35.211037028217646,64.78896297178235,Healthcare
88180,1587,86593,1.7997278294397825,98.20027217056023,Transportation
111214,7248,103966,6.517165105112666,93.48283489488733,Healthcare
119798,40225,79573,33.57735521461126,66.42264478538874,Healthcare
123438,19585,103853,15.866264845509487,84.13373515449052,Healthcare
71382,17274,54108,24.199377994452384,75.80062200554761,Transportation
75464,5539,69925,7.3399236722145655,92.66007632778543,Transportation
117676,43158,74518,36.675277881641115,63.32472211835888,Healthcare
89750,8221,81529,9.159888579387186,90.84011142061281,Transportation
164752,425,164327,0.25796348451005147,99.74203651548996,Entertainment
59472,45235,14237,76.06100349744418,23.938996502555824,Transportation
115196,46009,69187,39.939754852599044,60.06024514740095,Healthcare
45344,25092,20252,55.33697953422724,44.66302046577276,Food
161420,40565,120855,25.130095403295748,74.86990459670425,Entertainment
37123,34840,2283,93.85017374673383,6.149826253266169,Food
16399,5633,10766,34.34965546679676,65.65034453320324,Housing
21621,16019,5602,74.09000508764628,25.909994912353728,Housing
33107,11826,21281,35.720542483462715,64.27945751653729,Food
89024,40209,48815,45.166471962616825,54.833528037383175,Transportation
90986,32009,58977,35.18013760358736,64.81986239641263,Transportation
36411,19522,16889,53.61566559556178,46.38433440443822,Food
189730,11171,178559,5.887840615611658,94.11215938438833,Entertainment
123926,26549,97377,21.423268724884206,78.57673127511579,Healthcare
31448,5499,25949,17.486008649198677,82.51399135080132,Food
31618,3151,28467,9.965842241761022,90.03415775823898,Food
19381,7544,11837,38.92472008668283,61.07527991331717,Housing
18728,7263,11465,38.781503630926956,61.21849636907305,Housing
136869,39142,97727,28.598148594641593,71.40185140535841,Healthcare
107141,41553,65588,38.78347224685228,61.21652775314772,Healthcare
25707,15728,9979,61.18177928190766,38.81822071809235,Food
22087,2437,19650,11.033639697559652,88.96636030244035,Housing
16933,10659,6274,62.948089529321436,37.05191047067856,Housing
192838,8818,184020,4.572750184092347,95.42724981590766,Entertainment
75849,7607,68242,10.029136837664307,89.97086316233569,Transportation
25356,9718,15638,38.32623442183309,61.67376557816691,Food
175494,9325,166169,5.31357197397062,94.68642802602938,Entertainment
126569,15233,111336,12.03533250637992,87.96466749362008,Healthcare
96625,16427,80198,17.00077619663648,82.99922380336352,Transportation
114864,48795,66069,42.48067279565399,57.519327204346006,Healthcare
101083,41405,59678,40.96138816616048,59.03861183383952,Healthcare
16912,4733,12179,27.986045411542097,72.01395458845789,Housing
54923,4392,50531,7.996649855251898,92.0033501447481,Transportation
36560,7498,29062,20.50875273522976,79.49124726477024,Food
63276,28182,35094,44.538213540678925,55.461786459321075,Transportation
186086,11251,174835,6.0461292090753735,93.95387079092463,Entertainment
73244,48700,24544,66.49008792529081,33.50991207470919,Transportation
9895,2733,7162,27.6200101061142,72.37998989388579,Housing
157116,31107,126009,19.79874742228672,80.20125257771328,Entertainment
157623,40848,116775,25.914999714508667,74.08500028549133,Entertainment
67130,42679,24451,63.57664233576642,36.42335766423358,Transportation
39267,35208,4059,89.66307586523034,10.336924134769653,Food
24230,14472,9758,59.727610400330164,40.272389599669836,Housing
23253,16194,7059,69.6426267578377,30.3573732421623,Housing
8951,8914,37,99.58663836442855,0.41336163557144456,Housing
171811,41120,130691,23.933275517865564,76.06672448213445,Entertainment
24353,20783,3570,85.34061511928715,14.659384880712848,Housing
39022,5724,33298,14.66864845471785,85.33135154528215,Food
8987,7622,1365,84.81139423611884,15.18860576388116,Housing
13797,9208,4589,66.73914619120099,33.26085380879901,Housing
38278,11772,26506,30.753957887036943,69.24604211296305,Food
156067,37262,118805,23.8756431532611,76.1243568467389,Entertainment
17873,12289,5584,68.75734347899065,31.242656521009344,Housing
179785,45566,134219,25.344717301220903,74.6552826987791,Entertainment
105739,3098,102641,2.929855587815281,97.07014441218472,Healthcare
199806,4158,195648,2.0810185880303895,97.91898141196961,Entertainment
20718,9821,10897,47.403224249444925,52.59677575055507,Housing
163369,47969,115400,29.362363728736785,70.63763627126322,Entertainment
29341,2156,27185,7.348079479227019,92.65192052077298,Food
123477,9416,114061,7.625711670999458,92.37428832900054,Healthcare
59108,3869,55239,6.545645259524938,93.45435474047507,Transportation
12363,10176,2187,82.31011890317885,17.68988109682116,Housing
24873,23248,1625,93.46681140192177,6.533188598078238,Housing
18320,4892,13428,26.70305676855895,73.29694323144105,Housing
96104,21976,74128,22.866894197952217,77.13310580204778,Transportation
92279,42495,49784,46.05056405032564,53.94943594967436,Transportation
40379,34565,5814,85.60142648406351,14.398573515936503,Food
103689,3748,99941,3.614655363635487,96.38534463636451,Healthcare
171701,41233,130468,24.014420416887496,75.98557958311251,Entertainment
30600,27270,3330,89.11764705882354,10.882352941176471,Food
56488,31110,25378,55.073643959779076,44.92635604022093,Transportation
138248,15419,122829,11.153145072623111,88.84685492737688,Healthcare
18776,67,18709,0.35683851725607163,99.64316148274392,Housing
14238,6090,8148,42.772861356932154,57.227138643067846,Housing
30651,12433,18218,40.563113764640626,59.43688623535937,Food
134452,47801,86651,35.55246482015887,64.44753517984113,Healthcare
16053,3330,12723,20.743786208185387,79.25621379181462,Housing
25061,9269,15792,36.985754758389525,63.01424524161047,Food
87212,43856,43356,50.2866577993854,49.7133422006146,Transportation
99263,24665,74598,24.84813072343169,75.1518692765683,Transportation
30667,4354,26313,14.197671764437342,85.80232823556265,Food
110069,13394,96675,12.168730523580663,87.83126947641934,Healthcare
49835,25523,24312,51.215009531453795,48.784990468546205,Food
39644,32966,6678,83.15508021390374,16.844919786096256,Food
188208,25287,162921,13.435666921703648,86.56433307829636,Entertainment
70285,15700,54585,22.337625382371773,77.66237461762823,Transportation
147900,19830,128070,13.407707910750508,86.59229208924948,Healthcare
44868,18625,26243,41.51065347240795,58.48934652759205,Food
13997,2048,11949,14.631706794313068,85.36829320568692,Housing
40270,12546,27724,31.154705736280107,68.8452942637199,Food
18488,5240,13248,28.34270878407616,71.65729121592385,Housing
11249,9110,2139,80.98497644235043,19.01502355764957,Housing
150892,21972,128920,14.561408159478303,85.4385918405217,Entertainment
75739,6772,68967,8.941232390182073,91.05876760981792,Transportation
112907,14988,97919,13.2746419619687,86.7253580380313,Healthcare
32266,22763,9503,70.54794520547945,29.45205479452055,Food
62343,12239,50104,19.63171486774778,80.36828513225221,Transportation
162356,2234,160122,1.3759885683313213,98.62401143166868,Entertainment
40831,23926,16905,58.59763415052288,41.402365849477114,Food
11748,663,11085,5.643513789581205,94.3564862104188,Housing
78065,8720,69345,11.17017869723948,88.82982130276052,Transportation
195112,9917,185195,5.082721718807659,94.91727828119234,Entertainment
143202,43315,99887,30.24748257705898,69.75251742294103,Healthcare
175913,6473,169440,3.679659831848698,96.32034016815129,Entertainment
9380,6534,2846,69.6588486140725,30.341151385927507,Housing
144146,43826,100320,30.40389604983836,69.59610395016163,Healthcare
152921,24085,128836,15.7499623988857,84.2500376011143,Entertainment
50635,29881,20754,59.012540732694774,40.987459267305226,Transportation
10490,6980,3510,66.53956148713061,33.4604385128694,Housing
59618,20704,38914,34.72776678184441,65.27223321815559,Transportation
129394,22463,106931,17.360155803205714,82.63984419679429,Healthcare
21050,680,20370,3.2304038004750595,96.76959619952494,Housing
35144,25855,9289,73.56874573184612,26.431254268153882,Food
21401,7659,13742,35.788047287509926,64.21195271249007,Housing
37157,32427,4730,87.27023171946067,12.729768280539332,Food
56850,36015,20835,63.35092348284961,36.6490765171504,Transportation
12956,10195,2761,78.68941031182463,21.310589688175362,Housing
168947,20547,148400,12.161802221998615,87.83819777800139,Entertainment
13057,4008,9049,30.696178295167343,69.30382170483266,Housing
177703,45416,132287,25.55725001828894,74.44274998171106,Entertainment
138056,46229,91827,33.48568696760735,66.51431303239265,Healthcare
13704,11424,2280,83.36252189141857,16.637478108581437,Housing
177023,5938,171085,3.3543663817696,96.64563361823039,Entertainment
128181,48791,79390,38.06414367183904,61.935856328160966,Healthcare
62810,38428,24382,61.18134055086769,38.818659449132305,Transportation
32438,446,31992,1.3749306369073309,98.62506936309266,Food
21284,7253,14031,34.07724112009021,65.9227588799098,Housing
44666,4710,39956,10.544933506470246,89.45506649352976,Food
14121,1200,12921,8.497981729339282,91.50201827066073,Housing
184985,44291,140694,23.943022407222205,76.0569775927778,Entertainment
179560,1264,178296,0.7039429717086211,99.29605702829137,Entertainment
110808,10204,100604,9.20872139195726,90.79127860804273,Healthcare
17122,12576,4546,73.44936339212708,26.550636607872914,Housing
113987,32322,81665,28.35586514251625,71.64413485748375,Healthcare
28254,3782,24472,13.385715296949105,86.6142847030509,Food
14359,7863,6496,54.76008078557003,45.239919214429975,Housing
19865,8125,11740,40.90108230556255,59.09891769443746,Housing
176220,37617,138603,21.346612189308818,78.65338781069117,Entertainment
70044,47994,22050,68.51978756210382,31.48021243789618,Transportation
41153,4873,36280,11.841178042913032,88.15882195708696,Food
41782,11549,30233,27.641089464362643,72.35891053563735,Food
174513,36541,137972,20.938841232458326,79.06115876754167,Entertainment
139016,6177,132839,4.443373424641768,95.55662657535822,Healthcare
85614,22993,62621,26.856588875651177,73.14341112434882,Transportation
18587,771,17816,4.148060472373164,95.85193952762684,Housing
76373,39080,37293,51.169916069815244,48.830083930184756,Transportation
150051,6590,143461,4.391840107696717,95.60815989230328,Entertainment
95949,29455,66494,30.698600298075018,69.30139970192498,Transportation
32858,11620,21238,35.364294844482316,64.63570515551768,Food
191731,16632,175099,8.674653551068944,91.32534644893106,Entertainment
122839,40728,82111,33.15559390747238,66.84440609252762,Healthcare
145668,22485,123183,15.435785484801054,84.56421451519894,Healthcare
23282,4703,18579,20.200154625891244,79.79984537410876,Housing
161746,5818,155928,3.5969977619230153,96.40300223807698,Entertainment
49235,47966,1269,97.42256524829898,2.5774347517010257,Food
94215,41616,52599,44.1713103009075,55.82868969909251,Transportation
57638,660,56978,1.14507789999653,98.85492210000348,Transportation
175444,30819,144625,17.566288958300085,82.43371104169992,Entertainment
98044,7614,90430,7.765901024030028,92.23409897596997,Transportation
199080,34111,164969,17.13431786216596,82.86568213783404,Entertainment
192000,3051,188949,1.5890624999999998,98.41093749999999,Entertainment
40048,8084,31964,20.185777067518977,79.81422293248103,Food
107270,14974,92296,13.959168453435256,86.04083154656475,Healthcare
48457,23777,24680,49.068246073838665,50.931753926161335,Food
168226,14923,153303,8.870804750751965,91.12919524924804,Entertainment
14317,526,13791,3.6739540406509743,96.32604595934903,Housing
88143,2651,85492,3.0076126294770997,96.9923873705229,Transportation
102712,25198,77514,24.532673884258898,75.4673261157411,Healthcare
178526,5948,172578,3.3317275914992774,96.66827240850073,Entertainment
107705,28290,79415,26.26619005617195,73.73380994382805,Healthcare
198349,17913,180436,9.031051328718572,90.96894867128142,Entertainment
58818,28955,29863,49.22812744397974,50.77187255602027,Transportation
58790,32125,26665,54.64364687872087,45.35635312127913,Transportation
178659,5203,173456,2.9122518317017336,97.08774816829828,Entertainment
42807,24982,17825,58.359614081809056,41.640385918190944,Food
14773,3816,10957,25.830907737087934,74.16909226291207,Housing
150444,27041,123403,17.974129908803278,82.02587009119672,Entertainment
179425,41559,137866,23.162324090845757,76.83767590915424,Entertainment
147806,44415,103391,30.049524376547637,69.95047562345236,Healthcare
48516,27867,20649,57.43878308186991,42.5612169181301,Food
146123,3392,142731,2.3213320284965406,97.67866797150346,Healthcare
33996,28656,5340,84.29226967878574,15.70773032121426,Food
188738,12178,176560,6.452330744206254,93.54766925579374,Entertainment
77886,21885,56001,28.098759725753027,71.90124027424699,Transportation
19824,18211,1613,91.86339790153349,8.136602098466506,Housing
15287,892,14395,5.835023222345784,94.16497677765422,Housing
146354,46785,99569,31.96701149268213,68.03298850731787,Healthcare
73933,21360,52573,28.891022953214396,71.10897704678561,Transportation
80429,49907,30522,62.05100150443248,37.94899849556752,Transportation
13110,5189,7921,39.580472921434016,60.419527078565984,Housing
17108,12178,4930,71.18307224690203,28.816927753097964,Housing
20337,6807,13530,33.47101342380882,66.52898657619117,Housing
12452,10262,2190,82.41246386122711,17.58753613877289,Housing
13539,9637,3902,71.17955535859369,28.820444641406308,Housing
89711,18000,71711,20.064429111257258,79.93557088874273,Transportation
12933,9555,3378,73.88077012294131,26.119229877058686,Housing
77196,39161,38035,50.729312399606194,49.270687600393806,Transportation
55323,13932,41391,25.183016105417277,74.81698389458272,Transportation
168596,9740,158856,5.777124012432086,94.22287598756792,Entertainment
35296,34710,586,98.3397552130553,1.6602447869446961,Food
110533,23465,87068,21.228954248957326,78.77104575104268,Healthcare
125588,11656,113932,9.281141510335383,90.71885848966463,Healthcare
124576,41401,83175,33.23352812740817,66.76647187259182,Healthcare
52403,49648,2755,94.74266740453791,5.257332595462092,Transportation
110930,5267,105663,4.748039304065627,95.25196069593437,Healthcare
34857,18255,16602,52.3711162750667,47.628883724933296,Food
70394,37259,33135,52.929226922749095,47.070773077250905,Transportation
32702,17600,15102,53.819338266772675,46.180661733227325,Food
24082,661,23421,2.744788638817374,97.25521136118263,Housing
34317,12177,22140,35.483870967741936,64.51612903225806,Food
38651,26206,12445,67.80160927272257,32.198390727277435,Food
23379,10822,12557,46.28940502160058,53.71059497839942,Housing
121257,41406,79851,34.14730695959821,65.85269304040179,Healthcare
120472,26284,94188,21.81751776346371,78.18248223653629,Healthcare
199501,4601,194900,2.306254103989454,97.69374589601054,Entertainment
25535,3364,22171,13.174074799295084,86.82592520070492,Food
141199,48461,92738,34.32106459677476,65.67893540322524,Healthcare
85158,19937,65221,23.41177575800277,76.58822424199722,Transportation
42801,7766,35035,18.14443587766641,81.85556412233359,Food
14894,13467,1427,90.41896065529743,9.581039344702564,Housing
45239,40902,4337,90.41313910563893,9.58686089436106,Food
53260,12300,40960,23.094254600075104,76.9057453999249,Transportation
123904,33522,90382,27.054816632231404,72.94518336776859,Healthcare
177485,12329,165156,6.9465025213398315,93.05349747866016,Entertainment
137959,28363,109596,20.5590066613994,79.44099333860059,Healthcare
118910,31007,87903,26.07602388360945,73.92397611639055,Healthcare
67111,4923,62188,7.335608171536707,92.6643918284633,Transportation
120216,10110,110106,8.409862247953685,91.59013775204632,Healthcare
159008,35094,123914,22.07058764338901,77.92941235661098,Entertainment
40642,13998,26644,34.4422026475075,65.5577973524925,Food
138300,10412,127888,7.528561099060014,92.47143890093999,Healthcare
140648,21996,118652,15.639042147773164,84.36095785222683,Healthcare
17641,5075,12566,28.768210418910495,71.23178958108952,Housing
172069,49057,123012,28.510074446878868,71.48992555312114,Entertainment
19871,11916,7955,59.96678576820492,40.03321423179508,Housing
60165,24509,35656,40.73630848499958,59.26369151500042,Transportation
59387,19522,39865,32.872514186606494,67.1274858133935,Transportation
15446,4443,11003,28.76472873235789,71.2352712676421,Housing
87599,43988,43611,50.2151851048528,49.78481489514721,Transportation
29320,8975,20345,30.610504774897677,69.38949522510231,Food
182628,43677,138951,23.915828898087916,76.08417110191208,Entertainment
51757,35141,16616,67.89612999207837,32.10387000792163,Transportation
50487,23762,26725,47.06558123873472,52.93441876126528,Transportation
61543,17434,44109,28.328160798141138,71.67183920185887,Transportation
40034,9465,30569,23.64240395663686,76.35759604336315,Food
32831,14781,18050,45.02147360726143,54.97852639273857,Food
163563,11304,152259,6.911098475816657,93.08890152418334,Entertainment
111992,38869,73123,34.70694335309665,65.29305664690335,Healthcare
60361,21424,38937,35.49311641622902,64.50688358377099,Transportation
26192,10860,15332,41.463042150274894,58.5369578497251,Food
21395,20421,974,95.44753447067072,4.552465529329282,Housing
155016,31665,123351,20.42692367239511,79.5730763276049,Entertainment
16328,15534,794,95.13718765311123,4.86281234688878,Housing
180685,44842,135843,24.81777679386778,75.18222320613222,Entertainment
91183,17127,74056,18.783106500115153,81.21689349988485,Transportation
176293,38551,137742,21.86757273402801,78.132427265972,Entertainment
26008,22880,3128,87.97293140572133,12.027068594278683,Food
40452,18610,21842,46.00514189656877,53.994858103431234,Food
163810,25972,137838,15.854953910017702,84.1450460899823,Entertainment
131892,36181,95711,27.432293088284354,72.56770691171565,Healthcare
24018,21386,2632,89.04155216920643,10.958447830793572,Housing
167928,31317,136611,18.649063884521937,81.35093611547806,Entertainment
161241,4005,157236,2.4838595642547494,97.51614043574524,Entertainment
72362,7041,65321,9.730245156297505,90.2697548437025,Transportation
58852,44078,14774,74.89635016651941,25.103649833480596,Transportation
107277,551,106726,0.513623609907063,99.48637639009293,Healthcare
51246,41011,10235,80.02770947976427,19.972290520235724,Transportation
173361,12813,160548,7.390935677574541,92.60906432242547,Entertainment
47568,3407,44161,7.162378069290279,92.83762193070973,Food
32778,28315,4463,86.3841601073891,13.615839892610898,Food
97097,19544,77553,20.128325282964457,79.87167471703555,Transportation
33387,17046,16341,51.0558001617396,48.9441998382604,Food
178141,3659,174482,2.0539909397612006,97.94600906023881,Entertainment
131511,28000,103511,21.290994669647407,78.7090053303526,Healthcare
128174,42287,85887,32.99187042613947,67.00812957386053,Healthcare
138399,28669,109730,20.714745048735903,79.2852549512641,Healthcare
69997,6553,63444,9.361829792705402,90.63817020729459,Transportation
175358,43673,131685,24.90505138060425,75.09494861939575,Entertainment
141471,43532,97939,30.770970728983325,69.22902927101667,Healthcare
23129,9359,13770,40.464352112067104,59.535647887932896,Housing
189492,49336,140156,26.035927638106095,73.96407236189391,Entertainment
64962,21767,43195,33.507281179766636,66.49271882023336,Transportation
90137,1971,88166,2.1866714002019148,97.81332859979808,Transportation
42430,14626,27804,34.470893235917984,65.52910676408202,Food
16363,9650,6713,58.97451567560961,41.02548432439039,Housing
11420,5845,5575,51.18213660245184,48.81786339754816,Housing
93626,20446,73180,21.83795099651806,78.16204900348194,Transportation
128110,20754,107356,16.200140504254158,83.79985949574585,Healthcare
135400,13412,121988,9.905465288035451,90.09453471196454,Healthcare
130633,32309,98324,24.73264795266127,75.26735204733873,Healthcare
199144,33217,165927,16.679889928895676,83.32011007110432,Entertainment
36212,13569,22643,37.47100408704297,62.52899591295703,Food
181914,18732,163182,10.297173389623667,89.70282661037633,Entertainment
34931,3285,31646,9.404254100941857,90.59574589905814,Food
80870,49297,31573,60.958328181031284,39.041671818968716,Transportation
106599,35183,71416,33.005000046904755,66.99499995309525,Healthcare
33788,1986,31802,5.877826447259382,94.12217355274062,Food
69200,9066,60134,13.101156069364162,86.89884393063583,Transportation
44774,4239,40535,9.467548130611515,90.53245186938848,Food
116446,386,116060,0.33148412139532485,99.66851587860468,Healthcare
66912,916,65996,1.368962219033955,98.63103778096604,Transportation
24715,11641,13074,47.10095083957111,52.89904916042889,Housing
43253,31334,11919,72.44352992855987,27.55647007144013,Food
122746,615,122131,0.5010346569338308,99.49896534306617,Healthcare
124975,31129,93846,24.908181636327264,75.09181836367273,Healthcare
16987,12880,4107,75.82268793783481,24.177312062165186,Housing
38669,15960,22709,41.27337143448241,58.7266285655176,Food
47289,37392,9897,79.07124278373406,20.92875721626594,Food
149452,9669,139783,6.4696357358884455,93.53036426411155,Healthcare
25351,23698,1653,93.47954715790304,6.520452842096959,Food
31041,19944,11097,64.25050739344738,35.74949260655262,Food
60600,7058,53542,11.646864686468646,88.35313531353135,Transportation
72413,24078,48335,33.2509356054852,66.7490643945148,Transportation
22385,9738,12647,43.502345320527134,56.497654679472866,Housing
106409,40403,66006,37.96953265231324,62.03046734768676,Healthcare
47000,45436,1564,96.67234042553191,3.3276595744680852,Food
90769,25395,65374,27.977613502407213,72.02238649759279,Transportation
47303,2623,44680,5.545102847599518,94.45489715240049,Food
191354,16011,175343,8.367214691096084,91.63278530890392,Entertainment
106107,7333,98774,6.910948382293346,93.08905161770666,Healthcare
60980,2722,58258,4.4637586093801245,95.53624139061988,Transportation
16472,4249,12223,25.795288975230697,74.20471102476931,Housing
53467,46553,6914,87.0686591729478,12.931340827052201,Transportation
11292,9011,2281,79.79985830676584,20.200141693234148,Housing
42206,32930,9276,78.02208216841208,21.977917831587927,Food
22207,21357,850,96.1723780789841,3.827621921015896,Housing
9125,6764,2361,74.12602739726027,25.873972602739727,Housing
27576,6754,20822,24.492312155497533,75.50768784450247,Food
183870,21868,162002,11.89318540273019,88.10681459726982,Entertainment
8876,7027,1849,79.16854438936458,20.831455610635423,Housing
90671,45647,45024,50.34354975681309,49.6564502431869,Transportation
95366,44813,50553,46.99054170249355,53.00945829750645,Transportation
24724,2817,21907,11.393787413039961,88.60621258696004,Housing
82584,47661,34923,57.712147631502475,42.28785236849753,Transportation
89144,23482,65662,26.341649466032486,73.6583505339675,Transportation
25079,3123,21956,12.452649627178117,87.54735037282188,Food
39247,4078,35169,10.390603103421919,89.60939689657809,Food
69160,6212,62948,8.98207056101793,91.01792943898207,Transportation
46693,6221,40472,13.323196196432013,86.67680380356798,Food
134130,4473,129657,3.3348244240662046,96.66517557593379,Healthcare
78162,44721,33441,57.2157826053581,42.7842173946419,Transportation
108156,922,107234,0.8524723547468471,99.14752764525315,Healthcare
95648,48880,46768,51.10404817664771,48.89595182335229,Transportation
56854,40477,16377,71.19463889963767,28.80536110036233,Transportation
189178,12523,176655,6.619691507469155,93.38030849253084,Entertainment
39167,7754,31413,19.797278321035567,80.20272167896444,Food
18028,12448,5580,69.04814732638118,30.951852673618813,Housing
167353,21148,146205,12.636761814846462,87.36323818515353,Entertainment
18344,7266,11078,39.60968163977323,60.39031836022678,Housing
11450,7214,4236,63.004366812227076,36.995633187772924,Housing
40980,11529,29451,28.133235724743777,71.86676427525623,Food
47093,490,46603,1.0404943409848597,98.95950565901515,Food
104698,7222,97476,6.897935013085254,93.10206498691474,Healthcare
77080,4019,73061,5.214063310845874,94.78593668915413,Transportation
158464,13336,145128,8.415791599353796,91.5842084006462,Entertainment
59005,42746,16259,72.44470807558682,27.555291924413183,Transportation
55784,33480,22304,60.01720923562311,39.98279076437688,Transportation
129723,7111,122612,5.481680195493475,94.51831980450652,Healthcare
153195,32398,120797,21.14820979796991,78.85179020203009,Entertainment
58628,4947,53681,8.43794773828205,91.56205226171795,Transportation
181749,26267,155482,14.452349118839718,85.54765088116028,Entertainment
139493,9245,130248,6.627572709741708,93.3724272902583,Healthcare
36875,27529,9346,74.65491525423728,25.345084745762712,Food
55807,20738,35069,37.160212876520866,62.83978712347913,Transportation
183283,32974,150309,17.990757462503343,82.00924253749666,Entertainment
134829,46781,88048,34.69654154521653,65.30345845478347,Healthcare
14219,8143,6076,57.26844363176033,42.73155636823968,Housing
114242,44858,69384,39.26576915670244,60.73423084329757,Healthcare
170456,24491,145965,14.36793072699113,85.63206927300887,Entertainment
188080,44220,143860,23.51127179923437,76.48872820076564,Entertainment
8271,3511,4760,42.44952242775964,57.550477572240354,Housing
153277,30635,122642,19.986690762475778,80.01330923752423,Entertainment
9080,5036,4044,55.4625550660793,44.5374449339207,Housing
108063,28214,79849,26.108843915123586,73.89115608487641,Healthcare
123986,48704,75282,39.28185440291646,60.71814559708354,Healthcare
165232,21849,143383,13.223225525321972,86.77677447467804,Entertainment
71658,10141,61517,14.151943956013286,85.84805604398672,Transportation
24958,17532,7426,70.24601330234795,29.753986697652056,Housing
10427,9760,667,93.60314567948595,6.39685432051405,Housing
147665,28069,119596,19.008566688111603,80.9914333118884,Healthcare
65702,3536,62166,5.381875741986545,94.61812425801345,Transportation
51987,43593,8394,83.85365572162272,16.146344278377285,Transportation
29898,22102,7796,73.9246772359355,26.075322764064484,Food
125186,10375,114811,8.287667950090267,91.71233204990973,Healthcare
43614,3009,40605,6.899160819920209,93.10083918007979,Food
19439,9087,10352,46.746231802047426,53.25376819795257,Housing
178391,8417,169974,4.718287357546065,95.28171264245393,Entertainment
37654,15479,22175,41.10851436766346,58.89148563233654,Food
173355,30641,142714,17.675290588676415,82.32470941132358,Entertainment
192735,15721,177014,8.156795600176409,91.84320439982359,Entertainment
123028,41500,81528,33.73215853301688,66.26784146698313,Healthcare
110191,40843,69348,37.06564056955649,62.9343594304435,Healthcare
88015,41152,46863,46.7556666477305,53.2443333522695,Transportation
62013,14688,47325,23.685356296260462,76.31464370373953,Transportation
48642,5565,43077,11.44073023313186,88.55926976686814,Food
96429,16608,79821,17.223034564290828,82.77696543570917,Transportation
154112,24686,129426,16.018220514950166,83.98177948504983,Entertainment
75571,30255,45316,40.03519868732715,59.964801312672854,Transportation
96137,9777,86360,10.169861759780312,89.83013824021968,Transportation
70222,25102,45120,35.74663210959528,64.25336789040472,Transportation
27234,27021,213,99.2178894029522,0.7821105970478078,Food
94297,5745,88552,6.092452570071158,93.90754742992884,Transportation
95313,21692,73621,22.758700282228027,77.24129971777197,Transportation
75035,25788,49247,34.36796161791164,65.63203838208835,Transportation
9367,8189,1178,87.4239350912779,12.57606490872211,Housing
167097,23232,143865,13.903301675074955,86.09669832492504,Entertainment
174181,6613,167568,3.7966253494927686,96.20337465050723,Entertainment
49942,13945,35997,27.922389972367945,72.07761002763206,Food
45986,12031,33955,26.162310268342537,73.83768973165746,Food
44481,27832,16649,62.57053573435849,37.42946426564151,Food
181450,13079,168371,7.208046293744834,92.79195370625517,Entertainment
73287,7612,65675,10.386562418982903,89.6134375810171,Transportation
30696,6401,24295,20.852879854052645,79.14712014594735,Food
17903,3020,14883,16.868681226610065,83.13131877338994,Housing
32238,14175,18063,43.969849246231156,56.03015075376885,Food
95214,12938,82276,13.588337849475918,86.41166215052408,Transportation
189045,21747,167298,11.503610251527414,88.49638974847258,Entertainment
180751,10872,169879,6.014904481856255,93.98509551814375,Entertainment
117534,32624,84910,27.757074548641242,72.24292545135876,Healthcare
15832,8623,7209,54.465639211723094,45.534360788276906,Housing
187070,3970,183100,2.1222002458972575,97.87779975410274,Entertainment
39328,946,38382,2.4054109031733115,97.5945890968267,Food
20685,206,20479,0.9958907420836355,99.00410925791635,Housing
44752,30373,14379,67.86959242045049,32.13040757954952,Food
122759,21742,101017,17.71112504989451,82.2888749501055,Healthcare
12946,8234,4712,63.60265719141047,36.39734280858953,Housing
171552,13383,158169,7.801133184107442,92.19886681589256,Entertainment
158710,25358,133352,15.97756915128221,84.02243084871779,Entertainment
21333,13341,7992,62.53691463929124,37.46308536070876,Housing
177982,22026,155956,12.375408749199357,87.62459125080065,Entertainment
91799,20897,70902,22.76386453011471,77.2361354698853,Transportation
23635,5895,17740,24.941823566744233,75.05817643325577,Housing
54696,11530,43166,21.080152113500073,78.91984788649992,Transportation
110387,11692,98695,10.591826936142843,89.40817306385715,Healthcare
118703,42719,75984,35.98813846322334,64.01186153677666,Healthcare
9403,9011,392,95.83111772838457,4.168882271615442,Housing
30619,27464,3155,89.69594042914531,10.3040595708547,Food
146353,33716,112637,23.037450547648493,76.96254945235151,Healthcare
140149,2228,137921,1.5897366374358717,98.41026336256414,Healthcare
48021,33690,14331,70.15680639720122,29.843193602798774,Food
79883,42072,37811,52.667025524830066,47.332974475169934,Transportation
178895,30995,147900,17.325805640179993,82.67419435982,Entertainment
8728,7164,1564,82.08065994500458,17.919340054995416,Housing
123419,18040,105379,14.616874225200332,85.38312577479967,Healthcare
14581,11851,2730,81.27700432069132,18.722995679308692,Housing
27568,16121,11447,58.47721996517702,41.52278003482298,Food
63663,13739,49924,21.580824026514616,78.4191759734854,Transportation
35847,7933,27914,22.130164309426174,77.86983569057384,Food
27001,15566,11435,57.6497166771601,42.35028332283989,Food
21986,12666,9320,57.609387792231416,42.39061220776858,Housing
151437,27569,123868,18.2049301029471,81.7950698970529,Entertainment
158084,41062,117022,25.974798208547355,74.02520179145264,Entertainment
25029,14831,10198,59.25526389388309,40.7447361061169,Food
34664,28919,5745,83.4266097392107,16.573390260789292,Food
197931,1325,196606,0.6694252037326139,99.33057479626738,Entertainment
11167,10533,634,94.32255753559595,5.677442464404048,Housing
82643,25378,57265,30.707984947303462,69.29201505269654,Transportation
151095,11135,139960,7.3695357225586555,92.63046427744135,Entertainment
33062,8609,24453,26.03895711088258,73.96104288911741,Food
23169,6476,16693,27.95114161163624,72.04885838836375,Housing
174894,4629,170265,2.646746029023294,97.35325397097671,Entertainment
80991,19515,61476,24.09526984479757,75.90473015520243,Transportation
23623,2378,21245,10.066460652753673,89.93353934724632,Housing
51096,38669,12427,75.67911382495694,24.320886175043054,Transportation
63092,35103,27989,55.63779877005008,44.36220122994992,Transportation
113057,6655,106402,5.886411279266211,94.11358872073379,Healthcare
23275,22335,940,95.96133190118152,4.038668098818475,Housing
9136,2064,7072,22.59194395796848,77.40805604203153,Housing
184893,17684,167209,9.564450790457183,90.43554920954281,Entertainment
129256,31514,97742,24.38107321903819,75.61892678096181,Healthcare
23222,1300,21922,5.5981396951167,94.4018603048833,Housing
110530,32175,78355,29.10974396091559,70.8902560390844,Healthcare
34907,29122,5785,83.4273927865471,16.57260721345289,Food
29939,19222,10717,64.20388122515782,35.79611877484218,Food
25984,21991,3993,84.63285098522168,15.367149014778326,Food
143872,42185,101687,29.3212021797153,70.6787978202847,Healthcare
31090,23780,7310,76.48761659697652,23.512383403023478,Food
142596,9617,132979,6.744228449605879,93.25577155039412,Healthcare
65022,4327,60695,6.654670726830919,93.34532927316909,Transportation
19964,11284,8680,56.52173913043478,43.47826086956522,Housing
29816,19235,10581,64.51234236651462,35.48765763348538,Food
113622,6820,106802,6.002358698139445,93.99764130186055,Healthcare
8082,1920,6162,23.756495916852263,76.24350408314774,Housing
194942,5933,189009,3.0434693395984445,96.95653066040155,Entertainment
100558,30666,69892,30.495833250462418,69.50416674953757,Healthcare
19093,17771,1322,93.0759964384853,6.9240035615146915,Housing
170492,47342,123150,27.767871806301763,72.23212819369824,Entertainment
184715,21587,163128,11.686652410470185,88.31334758952981,Entertainment
115497,2928,112569,2.5351307826177303,97.46486921738227,Healthcare
189096,28451,160645,15.045796843931125,84.95420315606887,Entertainment
42917,24813,18104,57.81624997087401,42.18375002912599,Food
151477,40800,110677,26.93478217815246,73.06521782184754,Entertainment
13791,8783,5008,63.686462185483286,36.313537814516714,Housing
43174,21665,21509,50.18066428869227,49.81933571130773,Food
37663,6782,30881,18.007062634415743,81.99293736558427,Food
63585,26783,36802,42.12156955256743,57.87843044743257,Transportation
121794,12262,109532,10.067819432812783,89.93218056718722,Healthcare
32708,17130,15578,52.372508254861195,47.627491745138805,Food
120436,40343,80093,33.49745923145903,66.50254076854097,Healthcare
107934,17849,90085,16.536957770489373,83.46304222951063,Healthcare
131588,42192,89396,32.063714016475664,67.93628598352434,Healthcare
126130,10534,115596,8.351700626337905,91.64829937366208,Healthcare
127033,26427,100606,20.80325584690592,79.19674415309407,Healthcare
136510,13881,122629,10.16848582521427,89.83151417478574,Healthcare
164306,16146,148160,9.826786605480018,90.17321339451998,Entertainment
21970,5661,16309,25.766954938552573,74.23304506144743,Housing
45867,14079,31788,30.69527110994833,69.30472889005166,Food
121495,10886,110609,8.960039507798676,91.03996049220132,Healthcare
193443,5392,188051,2.7873843974710897,97.21261560252891,Entertainment
138042,42225,95817,30.58851653844482,69.41148346155518,Healthcare
194340,20581,173759,10.590202737470413,89.4097972625296,Entertainment
81286,23039,58247,28.34313411903649,71.65686588096352,Transportation
196979,25282,171697,12.834870722259733,87.16512927774028,Entertainment
123222,16417,106805,13.323107886578695,86.6768921134213,Healthcare
96889,8118,88771,8.378660116215462,91.62133988378454,Transportation
93715,15186,78529,16.20444966120685,83.79555033879315,Transportation
79522,38409,41113,48.29984155328086,51.70015844671914,Transportation
26094,3880,22214,14.869318617306659,85.13068138269334,Food
169338,5131,164207,3.030034605345522,96.96996539465448,Entertainment
81251,28798,52453,35.443256083002055,64.55674391699795,Transportation
27263,19613,7650,71.9399919304552,28.060008069544807,Food
71782,30048,41734,41.86007634225851,58.1399236577415,Transportation
171673,33193,138480,19.335014824695786,80.66498517530421,Entertainment
112271,10472,101799,9.32743094833038,90.67256905166961,Healthcare
186656,47646,139010,25.526101491513803,74.4738985084862,Entertainment
12444,7618,4826,61.21825779492125,38.78174220507875,Housing
168370,27868,140502,16.55164221654689,83.4483577834531,Entertainment
132927,48764,84163,36.684796918609464,63.315203081390536,Healthcare
187098,30085,157013,16.07980844263434,83.92019155736565,Entertainment
157399,2452,154947,1.5578243826199658,98.44217561738003,Entertainment
11586,4431,7155,38.24443293630244,61.75556706369757,Housing
187585,30473,157112,16.24490231095237,83.75509768904763,Entertainment
170330,16713,153617,9.81212939587859,90.18787060412141,Entertainment
27173,13158,14015,48.42306701505171,51.5769329849483,Food
181254,24230,157024,13.367980844560673,86.63201915543934,Entertainment
22631,10442,12189,46.140250099421145,53.859749900578855,Housing
14313,13704,609,95.7451268077971,4.254873192202893,Housing
187243,9941,177302,5.309143733010046,94.69085626698995,Entertainment
131542,3465,128077,2.63413966641833,97.36586033358167,Healthcare
180997,32125,148872,17.748912965408266,82.25108703459173,Entertainment
13881,6665,7216,48.015272674879334,51.98472732512067,Housing
17200,1229,15971,7.145348837209302,92.8546511627907,Housing
169267,38017,131250,22.459782473843102,77.5402175261569,Entertainment
97801,40761,57040,41.677487960245806,58.322512039754194,Transportation
104271,13286,90985,12.741797815308187,87.25820218469181,Healthcare
79091,20567,58524,26.004222983651744,73.99577701634826,Transportation
93210,31639,61571,33.94378285591675,66.05621714408325,Transportation
181301,26526,154775,14.630917645241889,85.3690823547581,Entertainment
82768,28523,54245,34.46138604291514,65.53861395708486,Transportation
52836,2738,50098,5.182072829131653,94.81792717086834,Transportation
61546,5241,56305,8.51558184122445,91.48441815877555,Transportation
43204,27281,15923,63.14461623923711,36.85538376076289,Food
50371,48676,1695,96.63496853348157,3.3650314665184333,Transportation
94652,29739,64913,31.41930439927313,68.58069560072687,Transportation
71072,582,70490,0.8188878883385863,99.18111211166142,Transportation
50672,33545,17127,66.20026839280075,33.79973160719924,Transportation
103213,35523,67690,34.41717613091374,65.58282386908625,Healthcare
32838,7370,25468,22.443510567026006,77.55648943297399,Food
121278,49945,71333,41.18224245122776,58.81775754877224,Healthcare
12491,7192,5299,57.57745576815307,42.422544231846935,Housing
92099,49361,42738,53.59558735708314,46.40441264291686,Transportation
197005,19394,177611,9.844420192380904,90.15557980761909,Entertainment
26302,15927,10375,60.55433046916584,39.44566953083416,Food
84249,31159,53090,36.984415245284815,63.01558475471519,Transportation
158104,18402,139702,11.639174214441127,88.36082578555887,Entertainment
71712,5097,66615,7.107597054886211,92.89240294511379,Transportation
12895,5280,7615,40.94610314075223,59.053896859247764,Housing
156669,5000,151669,3.191441829589772,96.80855817041024,Entertainment
114508,9963,104545,8.700702134348692,91.29929786565131,Healthcare
97362,40823,56539,41.92908937778599,58.070910622214,Transportation
117117,36744,80373,31.373754450677527,68.62624554932248,Healthcare
76310,23284,53026,30.51238369807365,69.48761630192635,Transportation
36610,23781,12829,64.95766184102703,35.04233815897296,Food
155798,16283,139515,10.451353675913683,89.5486463240863,Entertainment
44882,20756,24126,46.24571097544673,53.75428902455327,Food
156554,23253,133301,14.853021960473702,85.1469780395263,Entertainment
46693,35230,11463,75.45028162679631,24.549718373203692,Food
59922,34959,24963,58.34084309602483,41.65915690397517,Transportation
197554,3656,193898,1.8506332445812284,98.14936675541878,Entertainment
26387,21147,5240,80.14173646113618,19.858263538863834,Food
24538,10729,13809,43.7240198875214,56.27598011247861,Housing
111940,18226,93714,16.28193675183134,83.71806324816866,Healthcare
41224,5313,35911,12.888123423248594,87.11187657675141,Food
26450,20884,5566,78.95652173913044,21.043478260869566,Food
27064,20026,7038,73.99497487437185,26.00502512562814,Food
84230,30846,53384,36.621156357592305,63.37884364240769,Transportation
14432,13452,980,93.20953436807096,6.790465631929046,Housing
147530,42800,104730,29.01104860028469,70.98895139971532,Healthcare
118585,45674,72911,38.5158325251929,61.48416747480711,Healthcare
19969,2869,17100,14.367269267364415,85.6327307326356,Housing
159180,38623,120557,24.26372659881895,75.73627340118105,Entertainment
78980,19422,59558,24.591035705241833,75.40896429475816,Transportation
153082,29815,123267,19.4764897244614,80.5235102755386,Entertainment
10079,2717,7362,26.957039388828257,73.04296061117175,Housing
133171,12901,120270,9.687544585532887,90.31245541446712,Healthcare
9763,8712,1051,89.23486633207006,10.76513366792994,Housing
106513,10596,95917,9.948081454845887,90.05191854515411,Healthcare
161102,29778,131324,18.48394185050465,81.51605814949535,Entertainment
53066,2036,51030,3.8367316172313726,96.16326838276863,Transportation
31705,15896,15809,50.13720233401672,49.86279766598328,Food
144298,15945,128353,11.050049203731167,88.94995079626882,Healthcare
143831,44542,99289,30.96828917270964,69.03171082729035,Healthcare
126399,16042,110357,12.691556104083102,87.3084438959169,Healthcare
23317,17304,6013,74.2119483638547,25.788051636145305,Housing
160953,3457,157496,2.147831975794176,97.85216802420582,Entertainment
142603,10489,132114,7.355385230324747,92.64461476967524,Healthcare
116260,22099,94161,19.00825735420609,80.9917426457939,Healthcare
88645,19924,68721,22.476168988662643,77.52383101133735,Transportation
23089,3180,19909,13.772792238728398,86.2272077612716,Housing
172449,30924,141525,17.932258232868847,82.06774176713115,Entertainment
133044,5271,127773,3.96184720844232,96.03815279155768,Healthcare
40897,1141,39756,2.7899356921045553,97.21006430789545,Food
182549,18371,164178,10.063599362362982,89.93640063763702,Entertainment
10230,4287,5943,41.90615835777126,58.09384164222874,Housing
178275,45013,133262,25.249193661478053,74.75080633852194,Entertainment
66979,46648,20331,69.64570984935577,30.354290150644232,Transportation
138024,18269,119755,13.23610386599432,86.76389613400568,Healthcare
123514,23621,99893,19.1241478698771,80.87585213012291,Healthcare
38265,23185,15080,60.5906180582778,39.4093819417222,Food
121344,15739,105605,12.97056302742616,87.02943697257383,Healthcare
17339,11589,5750,66.83776457696521,33.16223542303477,Housing
43926,39531,4395,89.99453626553749,10.005463734462506,Food
42616,9837,32779,23.08287966960766,76.91712033039234,Food
193189,13012,180177,6.735373132010622,93.26462686798938,Entertainment
145539,47310,98229,32.50675076783543,67.49324923216457,Healthcare
42304,12242,30062,28.93816187594554,71.06183812405446,Food
79073,33717,45356,42.64034499766039,57.359655002339615,Transportation
13510,10738,2772,79.48186528497409,20.51813471502591,Housing
20468,16990,3478,83.0076216533125,16.992378346687513,Housing
108272,37926,70346,35.0284468745382,64.9715531254618,Healthcare
108368,46228,62140,42.658349328214975,57.341650671785025,Healthcare
29923,13639,16284,45.58032282859339,54.41967717140661,Food
62885,18824,44061,29.934006519837798,70.0659934801622,Transportation
14971,12755,2216,85.19804956248748,14.801950437512524,Housing
50180,3873,46307,7.718214428058988,92.28178557194101,Transportation
161865,43982,117883,27.17202607110864,72.82797392889137,Entertainment
138576,3192,135384,2.3034291652234153,97.69657083477658,Healthcare
9240,60,9180,0.6493506493506493,99.35064935064936,Housing
110311,18951,91360,17.179610374305373,82.82038962569462,Healthcare
78452,28207,50245,35.95446897465966,64.04553102534034,Transportation
49713,22754,26959,45.77072395550459,54.2292760444954,Food
141038,11805,129233,8.370084658035424,91.62991534196458,Healthcare
117746,39433,78313,33.48988500670936,66.51011499329064,Healthcare
125722,3515,122207,2.7958511636785923,97.20414883632141,Healthcare
129521,29541,99980,22.80788443572857,77.19211556427143,Healthcare
141148,1214,139934,0.8600901181738316,99.13990988182617,Healthcare
199077,17568,181509,8.824726111002274,91.17527388899772,Entertainment
175879,28390,147489,16.141779291444685,83.85822070855531,Entertainment
26815,13001,13814,48.484057430542606,51.515942569457394,Food
38738,33332,5406,86.04471062006299,13.955289379937014,Food
36152,16567,19585,45.82595707014826,54.17404292985174,Food
19922,2489,17433,12.493725529565305,87.5062744704347,Housing
122579,12787,109792,10.431640003589521,89.56835999641048,Healthcare
77760,12026,65734,15.465534979423868,84.53446502057614,Transportation
87553,15185,72368,17.343780338766233,82.65621966123376,Transportation
17472,6276,11196,35.92032967032967,64.07967032967034,Housing
161958,7108,154850,4.38879215599106,95.61120784400894,Entertainment
187828,46225,141603,24.61028174713035,75.38971825286964,Entertainment
46452,45991,461,99.00757771463016,0.9924222853698441,Food
184847,45037,139810,24.364474403155043,75.63552559684496,Entertainment
160349,17924,142425,11.17811773069991,88.82188226930009,Entertainment
8974,4133,4841,46.05527078225986,53.94472921774014,Housing
170711,15285,155426,8.953728816537891,91.04627118346211,Entertainment
65733,18526,47207,28.183712899152635,71.81628710084736,Transportation
64987,46118,18869,70.96496222321387,29.035037776786126,Transportation
20996,2871,18125,13.674033149171272,86.32596685082873,Housing
16050,12757,3293,79.48286604361371,20.517133956386292,Housing
43301,29491,13810,68.10697212535507,31.893027874644925,Food
79167,39973,39194,50.491997928429775,49.508002071570225,Transportation
32854,12379,20475,37.67882145248676,62.32117854751324,Food
172136,30544,141592,17.744109308918528,82.25589069108146,Entertainment
44404,3681,40723,8.289793712278174,91.71020628772183,Food
31993,27559,4434,86.14071828212421,13.859281717875785,Food
192518,10349,182169,5.375601242481222,94.62439875751878,Entertainment
97662,23244,74418,23.800454629231428,76.19954537076858,Transportation
101920,31171,70749,30.58379120879121,69.41620879120879,Healthcare
22434,1060,21374,4.724971026121066,95.27502897387893,Housing
112700,34633,78067,30.73025732031943,69.26974267968056,Healthcare
91873,496,91377,0.5398756979743777,99.46012430202562,Transportation
198246,23557,174689,11.882711378792006,88.11728862120799,Entertainment
127499,25037,102462,19.63701676091577,80.36298323908423,Healthcare
40990,28931,12059,70.58062942181019,29.419370578189803,Food
17789,16312,1477,91.69711619540165,8.302883804598347,Housing
10658,3500,7158,32.839181835241135,67.16081816475887,Housing
136436,39227,97209,28.751209358233897,71.2487906417661,Healthcare
49210,3981,45229,8.089819142450722,91.91018085754928,Food
21507,7059,14448,32.82187194866788,67.17812805133212,Housing
125460,20542,104918,16.37334608640204,83.62665391359796,Healthcare
11041,105,10936,0.9510008151435558,99.04899918485644,Housing
76973,46835,30138,60.846010938900655,39.153989061099345,Transportation
112986,22525,90461,19.93609827766272,80.06390172233728,Healthcare
32634,31153,1481,95.46178831893117,4.538211681068824,Food
19104,13429,5675,70.29417922948073,29.705820770519264,Housing
153774,24956,128818,16.229011406349578,83.77098859365042,Entertainment
44188,11957,32231,27.059382637820224,72.94061736217978,Food
72621,34112,38509,46.97263876840033,53.02736123159968,Transportation
11700,10655,1045,91.06837606837607,8.931623931623932,Housing
141553,9797,131756,6.921082562715025,93.07891743728497,Healthcare
38947,5930,33017,15.2258197036999,84.7741802963001,Food
21794,2763,19031,12.677801229696248,87.32219877030374,Housing
40750,10832,29918,26.58159509202454,73.41840490797547,Food
45377,17297,28080,38.11843004165106,61.88156995834895,Food
63778,38346,25432,60.124180751983445,39.87581924801656,Transportation
84018,27742,56276,33.019114951557995,66.98088504844199,Transportation
153846,46264,107582,30.071630071630075,69.92836992836993,Entertainment
169492,49454,120038,29.17777830222075,70.82222169777924,Entertainment
174438,39727,134711,22.77428083330467,77.22571916669533,Entertainment
12757,2713,10044,21.26675550678059,78.73324449321942,Housing
12243,3701,8542,30.22951890876419,69.77048109123581,Housing
22414,11801,10613,52.650129383421074,47.349870616578926,Housing
28999,8864,20135,30.566571261077968,69.43342873892203,Food
17996,15775,2221,87.65836852633917,12.341631473660813,Housing
19618,8235,11383,41.976756040371086,58.023243959628914,Housing
11191,392,10799,3.5028147618622105,96.49718523813779,Housing
146106,30164,115942,20.645284930119228,79.35471506988078,Healthcare
14336,1678,12658,11.704799107142858,88.29520089285714,Housing
93953,21034,72919,22.387789639500603,77.6122103604994,Transportation
38276,34550,3726,90.26544048489914,9.734559515100846,Food
25017,13374,11643,53.459647439740976,46.540352560259024,Food
93627,23697,69930,25.31000672882822,74.68999327117177,Transportation
72554,44402,28152,61.19855555861841,38.80144444138159,Transportation
127685,3055,124630,2.392606805811176,97.60739319418883,Healthcare
147859,15816,132043,10.696677239802785,89.30332276019722,Healthcare
18081,1823,16258,10.082406946518445,89.91759305348155,Housing
151562,41412,110150,27.323471582586667,72.67652841741334,Entertainment
9378,3374,6004,35.977820430795475,64.02217956920452,Housing
23512,13146,10366,55.91187478734263,44.08812521265737,Housing
161387,47989,113398,29.735356627237636,70.26464337276236,Entertainment
158118,47318,110800,29.925751653828154,70.07424834617184,Entertainment
23193,12096,11097,52.15366705471478,47.84633294528521,Housing
111565,39619,71946,35.51203334379062,64.48796665620938,Healthcare
172900,49008,123892,28.344707923655292,71.65529207634471,Entertainment
21395,3808,17587,17.798551063332553,82.20144893666745,Housing
27851,26644,1207,95.66622383397365,4.333776166026355,Food
30339,12472,17867,41.10880384983025,58.89119615016975,Food
96708,11219,85489,11.600901683418124,88.39909831658187,Transportation
161085,44771,116314,27.79340099947233,72.20659900052767,Entertainment
35351,18816,16535,53.22621708013917,46.77378291986082,Food
109696,48582,61114,44.28785005834306,55.71214994165694,Healthcare
59785,37029,22756,61.936940704190015,38.063059295809985,Transportation
45177,2941,42236,6.509949753192997,93.490050246807,Food
183327,19280,164047,10.516726941476161,89.48327305852384,Entertainment
71062,34157,36905,48.06647716078917,51.93352283921083,Transportation
39623,1001,38622,2.526310476238548,97.47368952376145,Food
58607,44384,14223,75.73156790144522,24.26843209855478,Transportation
104113,45531,58582,43.73229087625945,56.26770912374055,Healthcare
72821,25060,47761,34.41315005286936,65.58684994713063,Transportation
98385,44843,53542,45.57910250546323,54.42089749453677,Transportation
141430,3830,137600,2.708053454005515,97.29194654599449,Healthcare
15206,5596,9610,36.80126265947653,63.19873734052348,Housing
40104,4616,35488,11.510073808098943,88.48992619190106,Food
66559,17718,48841,26.61999128592677,73.38000871407323,Transportation
26933,25424,1509,94.39720788623622,5.602792113763784,Food
42137,34160,7977,81.06889432090561,18.931105679094383,Food
69929,37245,32684,53.26116489582291,46.7388351041771,Transportation
33849,13136,20713,38.80764572070076,61.192354279299245,Food
83561,14195,69366,16.98758990438123,83.01241009561878,Transportation
103680,29489,74191,28.4423225308642,71.55767746913581,Healthcare
132306,25857,106449,19.543331368191918,80.45666863180809,Healthcare
48777,17755,31022,36.4003526252127,63.599647374787295,Food
173425,20976,152449,12.095141992215655,87.90485800778434,Entertainment
47105,41901,5204,88.9523405158688,11.047659484131197,Food
11726,7232,4494,61.674910455398255,38.32508954460174,Housing
160385,14319,146066,8.927892259251177,91.07210774074882,Entertainment
101074,32683,68391,32.335714427053446,67.66428557294655,Healthcare
159306,32646,126660,20.492636812172798,79.5073631878272,Entertainment
109666,27097,82569,24.70866084292306,75.29133915707695,Healthcare
165601,30284,135317,18.28732918279479,81.71267081720521,Entertainment
75363,148,75215,0.19638284038586573,99.80361715961413,Transportation
189236,21325,167911,11.268997442347121,88.73100255765289,Entertainment
78619,45615,33004,58.02032587542452,41.97967412457548,Transportation
77660,24976,52684,32.16070048931239,67.83929951068761,Transportation
11134,2070,9064,18.591701095742767,81.40829890425722,Housing
10962,859,10103,7.8361612844371455,92.16383871556285,Housing
181654,21673,159981,11.9309236240325,88.0690763759675,Entertainment
52108,7928,44180,15.214554387042298,84.7854456129577,Transportation
119466,4131,115335,3.4578875998191956,96.5421124001808,Healthcare
23195,18452,4743,79.551627505928,20.448372494071997,Housing
144417,42723,101694,29.583082324103117,70.41691767589688,Healthcare
99653,18617,81036,18.68182593599791,81.3181740640021,Transportation
35047,4683,30364,13.362056666761776,86.63794333323823,Food
54926,29430,25496,53.58118195390161,46.41881804609839,Transportation
9150,7560,1590,82.62295081967214,17.37704918032787,Housing
123302,37006,86296,30.012489659535124,69.98751034046488,Healthcare
38384,1695,36689,4.415902459358066,95.58409754064193,Food
196074,45693,150381,23.303956669420728,76.69604333057927,Entertainment
29096,14549,14547,50.00343689854275,49.99656310145725,Food
8489,5876,2613,69.21898928024503,30.781010719754974,Housing
20688,4389,16299,21.215197215777263,78.78480278422273,Housing
23360,6262,17098,26.80650684931507,73.19349315068493,Housing
181645,38014,143631,20.927633570976354,79.07236642902365,Entertainment
122565,32362,90203,26.40394892506017,73.59605107493982,Healthcare
58573,47776,10797,81.56659211582128,18.433407884178717,Transportation
184953,29425,155528,15.909447264980834,84.09055273501916,Entertainment
86197,29928,56269,34.72046590948641,65.2795340905136,Transportation
12964,12328,636,95.09410675717372,4.905893242826289,Housing
83436,3370,80066,4.039023922527446,95.96097607747255,Transportation
111468,23901,87567,21.44202820540424,78.55797179459576,Healthcare
15069,920,14149,6.105249187072799,93.8947508129272,Housing
39784,1551,38233,3.8985521817816204,96.10144781821838,Food
16003,15323,680,95.75079672561395,4.249203274386053,Housing
19639,14424,5215,73.44569479097713,26.55430520902286,Housing
86296,20927,65369,24.250254936497637,75.74974506350236,Transportation
169845,20881,148964,12.294150549029997,87.70584945096999,Entertainment
38328,35474,2854,92.55374660822375,7.4462533917762475,Food
132334,29992,102342,22.66386567322079,77.33613432677922,Healthcare
165065,31115,133950,18.850149940932358,81.14985005906765,Entertainment
129724,47475,82249,36.596928864358176,63.40307113564182,Healthcare
30883,28815,2068,93.3037593498041,6.6962406501959,Food
103771,19726,84045,19.009164410095305,80.99083558990469,Healthcare
82329,8859,73470,10.760485369675326,89.23951463032466,Transportation
41807,23099,18708,55.25151290453751,44.74848709546248,Food
103281,34980,68301,33.86876579428937,66.13123420571063,Healthcare
145705,30013,115692,20.598469510311933,79.40153048968807,Healthcare
92934,47307,45627,50.90386726063658,49.09613273936342,Transportation
67536,5492,62044,8.131959251362236,91.86804074863775,Transportation
52964,6786,46178,12.812476399063517,87.18752360093649,Transportation
61416,39534,21882,64.37084798749511,35.62915201250488,Transportation
184890,45678,139212,24.705500567905244,75.29449943209477,Entertainment
75893,39601,36292,52.18004295521326,47.81995704478674,Transportation
44253,10707,33546,24.194969832553724,75.80503016744628,Food
167466,7994,159472,4.773506263958057,95.22649373604195,Entertainment
190712,17748,172964,9.306178950459332,90.69382104954067,Entertainment
78461,31017,47444,39.53174188450313,60.46825811549687,Transportation
126016,29191,96825,23.1645187912646,76.8354812087354,Healthcare
64634,13628,51006,21.0848779280255,78.9151220719745,Transportation
41514,35131,6383,84.62446403622874,15.37553596377126,Food
40386,15620,24766,38.67676917743773,61.323230822562266,Food
97735,44098,53637,45.11996725840282,54.88003274159718,Transportation
70432,40088,30344,56.917310313493864,43.08268968650613,Transportation
34108,32703,1405,95.88073179312772,4.119268206872288,Food
70158,35395,34763,50.450411927363945,49.549588072636055,Transportation
33751,16122,17629,47.76747355633908,52.23252644366093,Food
23372,19991,3381,85.53397227451651,14.466027725483485,Housing
61736,30177,31559,48.88071789555527,51.11928210444473,Transportation
93878,41212,52666,43.89952917616481,56.10047082383519,Transportation
45437,24502,20935,53.92521513304135,46.074784866958645,Food
107920,43102,64818,39.93884358784285,60.06115641215716,Healthcare
106962,26499,80463,24.774218881471924,75.22578111852808,Healthcare
41289,32698,8591,79.19300540095425,20.80699459904575,Food
131923,42402,89521,32.14147646733322,67.85852353266678,Healthcare
79493,1421,78072,1.7875787805215555,98.21242121947844,Transportation
162776,7549,155227,4.637661571730476,95.36233842826952,Entertainment
183302,24977,158325,13.626147014216974,86.37385298578303,Entertainment
44227,15216,29011,34.40432315101635,65.59567684898366,Food
173472,4787,168685,2.759523150710201,97.2404768492898,Entertainment
110217,38997,71220,35.382019107760144,64.61798089223986,Healthcare
127797,6007,121790,4.700423327621149,95.29957667237885,Healthcare
57087,2317,54770,4.058717396254839,95.94128260374517,Transportation
57253,11721,45532,20.472289661677117,79.52771033832289,Transportation
40775,14345,26430,35.18087063151441,64.81912936848559,Food
68741,3810,64931,5.542543751181973,94.45745624881803,Transportation
52378,33615,18763,64.17770819809844,35.822291801901564,Transportation
157083,25532,131551,16.253827594329113,83.74617240567088,Entertainment
52771,4846,47925,9.183074036876315,90.81692596312368,Transportation
57513,28231,29282,49.086293533635875,50.913706466364125,Transportation
17503,15149,2354,86.55087699251557,13.449123007484431,Housing
117994,28682,89312,24.30801566181331,75.69198433818669,Healthcare
135798,19230,116568,14.160738744311404,85.8392612556886,Healthcare
108071,1320,106751,1.2214192521583034,98.77858074784169,Healthcare
22072,11927,10145,54.03678869155492,45.96321130844509,Housing
58516,2431,56085,4.15441930412195,95.84558069587806,Transportation
63807,47560,16247,74.53727647436801,25.462723525631986,Transportation
38059,5622,32437,14.771801676344623,85.22819832365538,Food
97178,2108,95070,2.169215254481467,97.83078474551853,Transportation
13600,12740,860,93.67647058823529,6.323529411764706,Housing
30066,22880,7186,76.09924832036187,23.90075167963813,Food
119797,10498,109299,8.763157675066989,91.23684232493301,Healthcare
78313,40060,38253,51.15370372735051,48.8462962726495,Transportation
27078,13907,13171,51.35903685648866,48.64096314351134,Food
42328,29799,12529,70.4002079002079,29.5997920997921,Food
144399,46971,97428,32.528618619242515,67.47138138075749,Healthcare
79411,33744,45667,42.492853634886856,57.50714636511315,Transportation
58438,43118,15320,73.78418152571956,26.215818474280432,Transportation
153049,33290,119759,21.751203862815178,78.24879613718483,Entertainment
188597,33063,155534,17.531031776751487,82.46896822324852,Entertainment
14465,12737,1728,88.05392326304874,11.94607673695126,Housing
82545,37,82508,0.04482403537464413,99.95517596462535,Transportation
146119,40667,105452,27.831425071345954,72.16857492865404,Healthcare
34080,8399,25681,24.644953051643192,75.3550469483568,Food
49597,32649,16948,65.82857834143195,34.17142165856806,Food
18965,9762,9203,51.473767466385446,48.526232533614554,Housing
56475,47447,9028,84.01416555998229,15.985834440017706,Transportation
169559,22369,147190,13.19245808243738,86.80754191756262,Entertainment
20208,10828,9380,53.5827395091053,46.4172604908947,Housing
36928,24594,12334,66.59987001733101,33.40012998266898,Food
10143,5207,4936,51.335896677511585,48.664103322488415,Housing
48005,41833,6172,87.14300593688158,12.856994063118426,Food
49327,29991,19336,60.80037302086079,39.19962697913921,Food
24859,7684,17175,30.910334285369483,69.08966571463053,Housing
10975,6102,4873,55.5990888382688,44.4009111617312,Housing
15404,954,14450,6.193196572318879,93.80680342768112,Housing
40791,12205,28586,29.920815866245004,70.07918413375499,Food
33647,13543,20104,40.25024519273635,59.74975480726364,Food
78585,47850,30735,60.889482725711005,39.11051727428899,Transportation
10200,2961,7239,29.02941176470588,70.97058823529412,Housing
80419,11340,69079,14.10114525174399,85.898854748256,Transportation
64409,22369,42040,34.729618531571674,65.27038146842833,Transportation
103685,23795,79890,22.949317644789506,77.0506823552105,Healthcare
37477,4711,32766,12.570376497585187,87.42962350241481,Food
73196,37412,35784,51.11208262746598,48.88791737253402,Transportation
164498,23194,141304,14.09986747559241,85.9001325244076,Entertainment
142379,8142,134237,5.718539953223439,94.28146004677657,Healthcare
78584,21550,57034,27.42288506566222,72.57711493433779,Transportation
145907,37305,108602,25.56765610971372,74.43234389028628,Healthcare
32449,20694,11755,63.77392215476594,36.22607784523406,Food
148587,3332,145255,2.242457280919596,97.7575427190804,Healthcare
101455,17522,83933,17.27071115272781,82.72928884727219,Healthcare
71701,11017,60684,15.365197138115228,84.63480286188478,Transportation
99985,15401,84584,15.403310496574484,84.59668950342551,Transportation
175029,42135,132894,24.07315359169052,75.92684640830947,Entertainment
155617,7975,147642,5.124761433519474,94.87523856648052,Entertainment
142341,35950,106391,25.2562508342642,74.7437491657358,Healthcare
28327,3659,24668,12.917004977583224,87.08299502241678,Food
191973,46874,145099,24.416975303818766,75.58302469618124,Entertainment
10674,6898,3776,64.62432077946411,35.375679220535886,Housing
31987,6862,25125,21.452465063932223,78.54753493606778,Food
184891,28807,156084,15.580531231915021,84.41946876808498,Entertainment
65457,27588,37869,42.1467528301022,57.85324716989779,Transportation
49311,37899,11412,76.85709070998358,23.142909290016426,Food
42633,28311,14322,66.40630497501935,33.59369502498065,Food
14924,362,14562,2.4256231573304743,97.57437684266954,Housing
103693,20373,83320,19.647420751641867,80.35257924835814,Healthcare
143155,7851,135304,5.4842653068352485,94.51573469316476,Healthcare
52811,11663,41148,22.08441423188351,77.91558576811649,Transportation
14548,2293,12255,15.761616717074512,84.23838328292548,Housing
16659,14043,2616,84.29677651719791,15.70322348280209,Housing
41199,21411,19788,51.96970800262142,48.030291997378576,Food
10951,1238,9713,11.304903661766048,88.69509633823395,Housing
29007,1625,27382,5.602096045782052,94.39790395421794,Food
28970,2965,26005,10.234725578184328,89.76527442181566,Food
151580,31758,119822,20.95131283810529,79.0486871618947,Entertainment
8419,4517,3902,53.652452785366435,46.347547214633565,Housing
53575,36087,17488,67.35790947270182,32.64209052729818,Transportation
41880,13335,28545,31.840974212034386,68.15902578796562,Food
45215,41081,4134,90.85701647683291,9.142983523167091,Food
41588,19159,22429,46.06857747427143,53.93142252572858,Food
146815,868,145947,0.5912202431631646,99.40877975683684,Healthcare
180805,10934,169871,6.047399131661182,93.95260086833882,Entertainment
76868,45382,31486,59.03887183223188,40.96112816776812,Transportation
20466,18230,2236,89.0745626893384,10.925437310661586,Housing
8060,3390,4670,42.05955334987593,57.940446650124066,Housing
34776,14559,20217,41.86507936507937,58.13492063492064,Food
84732,5153,79579,6.08152764008875,93.91847235991125,Transportation
31579,4875,26704,15.437474270876214,84.56252572912378,Food
192326,40503,151823,21.05955513035159,78.9404448696484,Entertainment
24633,22841,1792,92.72520602443876,7.274793975561239,Housing
14736,391,14345,2.6533659066232356,97.34663409337676,Housing
186371,41352,145019,22.188001352141697,77.8119986478583,Entertainment
24509,15147,9362,61.801787098616835,38.198212901383165,Housing
9171,5591,3580,60.963907970777456,39.036092029222544,Housing
115066,19934,95132,17.323970590791372,82.67602940920862,Healthcare
128907,41911,86996,32.51258659343558,67.48741340656443,Healthcare
70313,21795,48518,30.99711290941931,69.00288709058069,Transportation
100869,49963,50906,49.532562035907965,50.46743796409204,Healthcare
110003,11390,98613,10.354263065552757,89.64573693444724,Healthcare
97099,42899,54200,44.18068157241578,55.81931842758422,Transportation
62665,42367,20298,67.6087129976861,32.39128700231389,Transportation
124662,42637,82025,34.202082430893135,65.79791756910687,Healthcare
139340,24968,114372,17.918759867948904,82.08124013205111,Healthcare
13949,2838,11111,20.345544483475518,79.65445551652448,Housing
22896,15240,7656,66.56184486373165,33.43815513626834,Housing
18775,161,18614,0.8575233022636485,99.14247669773634,Housing
166491,35194,131297,21.13868016889802,78.86131983110198,Entertainment
42810,15867,26943,37.063770147161875,62.936229852838125,Food
24923,14823,10100,59.47518356538137,40.52481643461863,Housing
38700,37292,1408,96.36175710594316,3.638242894056848,Food
161076,22699,138377,14.092105589907868,85.90789441009214,Entertainment
14990,5160,9830,34.422948632421615,65.57705136757839,Housing
146630,47800,98830,32.599058855623,67.400941144377,Healthcare
148219,42811,105408,28.88361141284181,71.1163885871582,Healthcare
92216,14184,78032,15.381278736878635,84.61872126312137,Transportation
143987,15608,128379,10.839867488037115,89.16013251196289,Healthcare
197200,11377,185823,5.769269776876268,94.23073022312374,Entertainment
20771,17649,3122,84.96942853016225,15.030571469837756,Housing
163458,477,162981,0.29181808170906287,99.70818191829093,Entertainment
150889,41983,108906,27.82376448912777,72.17623551087223,Entertainment
33698,17513,16185,51.970443349753694,48.029556650246306,Food
24964,4958,20006,19.86059926293863,80.13940073706138,Housing
24438,7643,16795,31.27506342581226,68.72493657418775,Housing
12142,6966,5176,57.37110854883875,42.62889145116126,Housing
67207,11894,55313,17.69756126593956,82.30243873406043,Transportation
188735,37438,151297,19.836278379738786,80.16372162026121,Entertainment
16656,11234,5422,67.44716618635927,32.55283381364073,Housing
177598,27768,149830,15.635311208459553,84.36468879154044,Entertainment
10942,8411,2531,76.8689453481996,23.131054651800405,Housing
49625,38176,11449,76.92896725440806,23.07103274559194,Food
198449,48915,149534,24.64865028294423,75.35134971705577,Entertainment
163581,48608,114973,29.714942444415914,70.28505755558409,Entertainment
109760,48432,61328,44.12536443148688,55.87463556851312,Healthcare
69397,39032,30365,56.244506246667726,43.755493753332274,Transportation
46711,12254,34457,26.233649461582925,73.76635053841709,Food
20693,17047,3646,82.38051515005074,17.619484849949256,Housing
49341,24976,24365,50.619160535862676,49.38083946413733,Food
123398,7704,115694,6.2432130180391905,93.7567869819608,Healthcare
24346,2600,21746,10.679372381500041,89.32062761849996,Housing
94919,32848,62071,34.60634857088676,65.39365142911325,Transportation
135986,6584,129402,4.8416748782962955,95.1583251217037,Healthcare
40155,27812,12343,69.26161125638151,30.73838874361848,Food
155024,982,154042,0.6334503044689854,99.36654969553102,Entertainment
81922,4746,77176,5.793315592881034,94.20668440711897,Transportation
24921,5986,18935,24.01990289314233,75.98009710685767,Housing
119616,39776,79840,33.25307651150348,66.74692348849652,Healthcare
79487,47650,31837,59.94690955753771,40.05309044246229,Transportation
29533,4924,24609,16.672874411675075,83.32712558832492,Food
175062,9947,165115,5.681986953193725,94.31801304680627,Entertainment
32834,1893,30941,5.76536517025035,94.23463482974965,Food
46008,7349,38659,15.973308989740914,84.02669101025909,Food
146037,20133,125904,13.786232256209043,86.21376774379095,Healthcare
39293,3052,36241,7.767286794085461,92.23271320591454,Food
32867,2013,30854,6.124684333830286,93.87531566616971,Food
158925,15921,143004,10.01793298725814,89.98206701274187,Entertainment
22289,6150,16139,27.59208578222442,72.40791421777558,Housing
177968,9748,168220,5.477389193562888,94.52261080643711,Entertainment
55774,12786,42988,22.924660235952235,77.07533976404777,Transportation
135290,39293,95997,29.043536107620664,70.95646389237933,Healthcare
10187,2330,7857,22.872288210464315,77.12771178953568,Housing
69277,31923,37354,46.0802286473144,53.9197713526856,Transportation
117489,41621,75868,35.42544408412702,64.57455591587298,Healthcare
158850,49852,108998,31.383065785332075,68.61693421466792,Entertainment
187225,26897,160328,14.366137000934703,85.63386299906529,Entertainment
106451,25010,81441,23.49437769490188,76.50562230509811,Healthcare
12544,4976,7568,39.66836734693878,60.33163265306123,Housing
140387,33550,106837,23.89822419454793,76.10177580545208,Healthcare
193774,28570,165204,14.743980100529482,85.25601989947052,Entertainment
176142,36989,139153,20.999534466509974,79.00046553349003,Entertainment
25805,21015,4790,81.43770587095524,18.56229412904476,Food
36802,22372,14430,60.790174447040926,39.209825552959074,Food
37667,35321,2346,93.77173653330502,6.228263466694985,Food
47033,37939,9094,80.66463972104692,19.335360278953075,Food
92297,46930,45367,50.84672307875662,49.153276921243375,Transportation
10738,5732,5006,53.38051778729744,46.61948221270255,Housing
189742,7139,182603,3.762477469405825,96.23752253059418,Entertainment
15710,1619,14091,10.305537873965626,89.69446212603437,Housing
167887,44296,123591,26.38441332562974,73.61558667437026,Entertainment
27160,16172,10988,59.543446244477174,40.456553755522826,Food
26295,15096,11199,57.41015402167713,42.58984597832288,Food
12809,4178,8631,32.61769068623624,67.38230931376376,Housing
15081,8690,6391,57.62217359591539,42.377826404084615,Housing
145207,37937,107270,26.126150943136352,73.87384905686365,Healthcare
15031,14806,225,98.50309360654647,1.4969063934535294,Housing
46647,36591,10056,78.44234355907133,21.557656440928678,Food
31916,5033,26883,15.769519989973682,84.23048001002633,Food
85996,22948,63048,26.684962091260054,73.31503790873994,Transportation
73087,20101,52986,27.502839082189716,72.49716091781028,Transportation
186734,39952,146782,21.395139610354835,78.60486038964515,Entertainment
32068,21475,10593,66.96706997630037,33.032930023699635,Food
61907,40002,21905,64.61627925759608,35.38372074240393,Transportation
51243,41307,9936,80.6100345413032,19.389965458696796,Transportation
21878,6837,15041,31.250571350214827,68.74942864978517,Housing
120129,31781,88348,26.45572676039924,73.54427323960077,Healthcare
156016,21506,134510,13.784483642703313,86.21551635729668,Entertainment
102077,25350,76727,24.834193794880335,75.16580620511967,Healthcare
19613,10589,9024,53.989700708713606,46.010299291286394,Housing
82016,12970,69046,15.813987514631291,84.1860124853687,Transportation
91094,20800,70294,22.833556545985463,77.16644345401453,Transportation
43072,36877,6195,85.61710624071323,14.382893759286775,Food
27245,18,27227,0.06606716828775921,99.93393283171224,Food
197237,45805,151432,23.223330308207892,76.77666969179211,Entertainment
37272,20923,16349,56.13597338484654,43.86402661515347,Food
140254,30328,109926,21.623625707644702,78.3763742923553,Healthcare
175408,35939,139469,20.488803247286327,79.51119675271367,Entertainment
174344,43095,131249,24.718372872023124,75.28162712797688,Entertainment
197737,2366,195371,1.1965388369399759,98.80346116306002,Entertainment
130553,47904,82649,36.69314378068677,63.30685621931323,Healthcare
25341,23806,1535,93.94262262736277,6.0573773726372275,Food
177359,777,176582,0.4380944863243478,99.56190551367565,Entertainment
96301,47176,49125,48.98806865972316,51.01193134027684,Transportation
95688,34131,61557,35.6690494105844,64.33095058941561,Transportation
12312,1324,10988,10.753736192332683,89.24626380766732,Housing
105363,33718,71645,32.001746343593105,67.99825365640689,Healthcare
199484,7485,191999,3.752180626015119,96.24781937398488,Entertainment
115390,26324,89066,22.813068723459573,77.18693127654042,Healthcare
18975,11023,7952,58.09222661396575,41.90777338603426,Housing
48349,13161,35188,27.22083186829097,72.77916813170904,Food
35901,5581,30320,15.545527979722012,84.45447202027798,Food
20677,5713,14964,27.629733520336607,72.37026647966339,Housing
127454,43350,84104,34.012271093884856,65.98772890611515,Healthcare
40793,38367,2426,94.05290123305468,5.9470987669453095,Food
193875,38997,154878,20.11450676982592,79.88549323017408,Entertainment
104643,27158,77485,25.953002111942507,74.04699788805749,Healthcare
136528,24102,112426,17.653521621938356,82.34647837806163,Healthcare
82350,22257,60093,27.027322404371585,72.97267759562841,Transportation
139462,21706,117756,15.564096312974144,84.43590368702586,Healthcare
192655,33149,159506,17.206405232150736,82.79359476784927,Entertainment
173101,33691,139410,19.463203563237645,80.53679643676234,Entertainment
131924,30175,101749,22.873017798126195,77.1269822018738,Healthcare
140800,15510,125290,11.015625,88.984375,Healthcare
19003,13843,5160,72.84639267484081,27.153607325159186,Housing
109733,33298,76435,30.344563622611247,69.65543637738875,Healthcare
91616,47553,44063,51.9046891372686,48.0953108627314,Transportation
173024,45885,127139,26.5194423894951,73.4805576105049,Entertainment
194586,35271,159315,18.126175572754462,81.87382442724554,Entertainment
38855,2159,36696,5.556556427744177,94.44344357225583,Food
122489,38515,83974,31.443639837046593,68.55636016295341,Healthcare
151644,23729,127915,15.647833082746432,84.35216691725357,Entertainment
77786,29510,48276,37.93741804437817,62.06258195562183,Transportation
46918,27829,19089,59.314122511616006,40.68587748838399,Food
19826,18693,1133,94.28528195299101,5.714718047008978,Housing
36096,20343,15753,56.35804521276596,43.64195478723404,Food
92090,19648,72442,21.33564990769899,78.664350092301,Transportation
124830,43336,81494,34.71601377873908,65.28398622126092,Healthcare
122445,41457,80988,33.85765037363714,66.14234962636286,Healthcare
130103,38698,91405,29.74412580801365,70.25587419198635,Healthcare
10327,8004,2323,77.50556792873051,22.494432071269486,Housing
16234,9135,7099,56.27078970062831,43.72921029937169,Housing
152067,25645,126422,16.864276930563502,83.1357230694365,Entertainment
146062,41850,104212,28.652216182169216,71.34778381783077,Healthcare
65836,19257,46579,29.24995443222553,70.75004556777446,Transportation
84503,31385,53118,37.14069322982616,62.85930677017384,Transportation
75193,24722,50471,32.878060457755375,67.12193954224462,Transportation
39120,25159,13961,64.31237218813905,35.68762781186094,Food
167917,31239,136678,18.60383403705402,81.39616596294597,Entertainment
102854,18620,84234,18.103330935111906,81.8966690648881,Healthcare
35402,5543,29859,15.657307496751596,84.3426925032484,Food
33564,17558,16006,52.31200095340246,47.68799904659755,Food
36534,14586,21948,39.92445393332238,60.07554606667762,Food
173575,24619,148956,14.183494166786693,85.81650583321331,Entertainment
117565,13093,104472,11.136817930506528,88.86318206949348,Healthcare
59400,33312,26088,56.080808080808076,43.91919191919192,Transportation
152590,23560,129030,15.440068156497805,84.5599318435022,Entertainment
54219,37571,16648,69.29489662295505,30.705103377044946,Transportation
153416,19952,133464,13.005162434165928,86.99483756583408,Entertainment
154442,45779,108663,29.641548283498015,70.35845171650199,Entertainment
129895,43023,86872,33.12136725817006,66.87863274182993,Healthcare
146871,16720,130151,11.384139823382423,88.61586017661757,Healthcare
140359,34136,106223,24.32049245149937,75.67950754850064,Healthcare
43258,28164,15094,65.10703222525314,34.89296777474687,Food
67573,38412,29161,56.8451896467524,43.1548103532476,Transportation
18592,3864,14728,20.783132530120483,79.21686746987952,Housing
164953,29075,135878,17.626232926954952,82.37376707304504,Entertainment
147022,21224,125798,14.435934758063418,85.56406524193659,Healthcare
145951,25046,120905,17.16055388452289,82.83944611547712,Healthcare
16706,8894,7812,53.2383574763558,46.7616425236442,Housing
47079,18460,28619,39.21068841734107,60.78931158265893,Food
87564,34414,53150,39.301539445434194,60.698460554565806,Transportation
141019,27009,114010,19.152738283493715,80.8472617165063,Healthcare
134867,15438,119429,11.446832805652976,88.55316719434703,Healthcare
67921,16702,51219,24.59033288673606,75.40966711326394,Transportation
93340,21175,72165,22.685879580029997,77.31412041997,Transportation
172278,17676,154602,10.260160902726987,89.739839097273,Entertainment
89714,2400,87314,2.675167755311323,97.32483224468868,Transportation
35161,20706,14455,58.889110093569585,41.11088990643042,Food
48649,39886,8763,81.9872967584123,18.012703241587698,Food
17324,541,16783,3.122835372893096,96.87716462710691,Housing
107254,13775,93479,12.843343837992055,87.15665616200793,Healthcare
11356,8707,2649,76.67312433955618,23.326875660443818,Housing
192873,26315,166558,13.643693000057034,86.35630699994297,Entertainment
61325,28149,33176,45.90134529147982,54.09865470852018,Transportation
115246,36527,78719,31.694809364316335,68.30519063568367,Healthcare
172786,18940,153846,10.961536235574641,89.03846376442536,Entertainment
79098,34207,44891,43.24635262585653,56.75364737414347,Transportation
47464,42224,5240,88.96005393561435,11.039946064385639,Food
34108,5993,28115,17.570657910167704,82.4293420898323,Food
115006,42269,72737,36.75373458776064,63.24626541223937,Healthcare
172540,44370,128170,25.71577605192999,74.28422394807002,Entertainment
109967,23814,86153,21.65558758536652,78.34441241463348,Healthcare
133710,45583,88127,34.09094308578267,65.90905691421733,Healthcare
19593,7274,12319,37.12550400653294,62.87449599346705,Housing
48625,21067,27558,43.325449871465295,56.674550128534705,Food
110457,22320,88137,20.206958363888212,79.7930416361118,Healthcare
117869,10437,107432,8.854745522571667,91.14525447742832,Healthcare
31364,8123,23241,25.89912001020278,74.10087998979722,Food
173032,23636,149396,13.659901058763696,86.34009894123629,Entertainment
33672,11706,21966,34.7647897362794,65.2352102637206,Food
178175,6861,171314,3.8507085730321315,96.14929142696786,Entertainment
31876,10100,21776,31.685280461789432,68.31471953821057,Food
26252,5366,20886,20.440347402102695,79.5596525978973,Food
150590,5063,145527,3.3621090377847134,96.6378909622153,Entertainment
199005,10819,188186,5.436546820431647,94.56345317956836,Entertainment
29429,402,29027,1.3659995242787726,98.63400047572122,Food
142726,36930,105796,25.874753023275364,74.12524697672464,Healthcare
29477,16862,12615,57.203921701665706,42.796078298334294,Food
56285,25692,30593,45.6462645465044,54.3537354534956,Transportation
147499,15256,132243,10.343120970311663,89.65687902968834,Healthcare
19814,5141,14673,25.946300595538506,74.0536994044615,Housing
45366,39029,6337,86.03138914605651,13.968610853943481,Food
60068,46144,13924,76.81960444829194,23.180395551708063,Transportation
29568,9271,20297,31.354843073593074,68.64515692640693,Food
162454,38197,124257,23.512502000566315,76.48749799943369,Entertainment
143215,8644,134571,6.035680620046783,93.96431937995322,Healthcare
66499,25989,40510,39.0817907036196,60.9182092963804,Transportation
102264,26913,75351,26.31717906594696,73.68282093405304,Healthcare
44163,15960,28203,36.13884926295768,63.861150737042315,Food
152165,27188,124977,17.86744652186771,82.13255347813228,Entertainment
30957,16473,14484,53.212520593080725,46.787479406919275,Food
89237,14021,75216,15.712092517677645,84.28790748232235,Transportation
77568,910,76658,1.173164191419142,98.82683580858085,Transportation
48577,31508,17069,64.86197171500916,35.13802828499084,Food
84186,31194,52992,37.05366688047894,62.94633311952106,Transportation
34176,25464,8712,74.50842696629213,25.491573033707866,Food
31469,4150,27319,13.187581429343162,86.81241857065683,Food
103274,15330,87944,14.84400720413657,85.15599279586343,Healthcare
28321,10750,17571,37.95769923378412,62.04230076621589,Food
177931,31192,146739,17.530390994261822,82.46960900573818,Entertainment
40303,14650,25653,36.34965139071533,63.65034860928467,Food
121218,44813,76405,36.96893200679767,63.03106799320233,Healthcare
128081,35285,92796,27.548972915576865,72.45102708442313,Healthcare
47203,39469,7734,83.61544817066712,16.38455182933288,Food
9930,6287,3643,63.31319234642498,36.68680765357502,Housing
69155,40167,28988,58.08256814402429,41.91743185597571,Transportation
29713,29703,10,99.96634469760711,0.033655302392892,Food
28933,14595,14338,50.44412954066291,49.555870459337086,Food
29068,4195,24873,14.431677445988717,85.56832255401129,Food
190310,42637,147673,22.403972465976565,77.59602753402343,Entertainment
52769,38070,14699,72.14463037010366,27.855369629896344,Transportation
99164,30099,69065,30.352748981485217,69.6472510185148,Transportation
62214,31831,30383,51.16372520654515,48.83627479345485,Transportation
32383,22615,9768,69.83602507488497,30.163974925115028,Food
103334,40002,63332,38.71136315249579,61.28863684750421,Healthcare
33845,17883,15962,52.837937656965586,47.16206234303442,Food
150165,39726,110439,26.454899610428527,73.54510038957147,Entertainment
174407,31286,143121,17.938500174878303,82.0614998251217,Entertainment
34146,22223,11923,65.08229368007966,34.91770631992034,Food
23070,822,22248,3.563068920676203,96.4369310793238,Housing
87529,31389,56140,35.86125741182922,64.13874258817079,Transportation
112212,33268,78944,29.647453035325988,70.35254696467402,Healthcare
33738,26957,6781,79.90100183769043,20.098998162309563,Food
14801,4846,9955,32.74103101141815,67.25896898858186,Housing
99955,22829,77126,22.839277674953728,77.16072232504627,Transportation
59097,7436,51661,12.58270301368936,87.41729698631065,Transportation
151152,21698,129454,14.35508627077379,85.64491372922622,Entertainment
31277,5739,25538,18.348946510215175,81.65105348978483,Food
117428,27201,90227,23.163981333242496,76.8360186667575,Healthcare
145856,9984,135872,6.845107503290918,93.15489249670908,Healthcare
102304,47931,54373,46.85154050672505,53.14845949327495,Healthcare
119096,49094,70002,41.22220729495533,58.777792705044675,Healthcare
134475,24644,109831,18.326082915039972,81.67391708496004,Healthcare
52940,47113,5827,88.99319984888552,11.006800151114469,Transportation
29628,23773,5855,80.23828810584583,19.76171189415418,Food
24489,21923,2566,89.52182612601575,10.478173873984238,Housing
12760,11,12749,0.08620689655172414,99.91379310344828,Housing
183771,9734,174037,5.296809616315958,94.70319038368405,Entertainment
91191,40318,50873,44.21269642837561,55.78730357162439,Transportation
10125,364,9761,3.595061728395062,96.40493827160493,Housing
170018,18374,151644,10.807091013892647,89.19290898610735,Entertainment
62715,38953,23762,62.11113768635893,37.88886231364108,Transportation
188287,29533,158754,15.685097749711877,84.31490225028813,Entertainment
122797,31746,91051,25.852423104798977,74.14757689520103,Healthcare
101301,27075,74226,26.727278111765923,73.27272188823407,Healthcare
22849,16232,6617,71.04030810976411,28.959691890235895,Housing
19064,11312,7752,59.33697020562316,40.66302979437684,Housing
199394,28022,171372,14.053582354534239,85.94641764546576,Entertainment
108600,15911,92689,14.651012891344383,85.34898710865562,Healthcare
167971,4682,163289,2.7873859178072404,97.21261408219276,Entertainment
36354,28477,7877,78.33250811465038,21.66749188534962,Food
53599,37097,16502,69.21211216627175,30.787887833728238,Transportation
86785,2837,83948,3.268998098749784,96.73100190125021,Transportation
16016,7011,9005,43.77497502497503,56.22502497502497,Housing
37749,21097,16652,55.88757318074651,44.11242681925349,Food
30797,14450,16347,46.92015456050914,53.07984543949086,Food
28045,9612,18433,34.2734890354787,65.7265109645213,Food
188775,28743,160032,15.22606277314263,84.77393722685737,Entertainment
40824,37341,3483,91.46825396825396,8.531746031746032,Food
12944,3432,9512,26.514215080346105,73.4857849196539,Housing
35890,30286,5604,84.3856227361382,15.614377263861801,Food
137171,43555,93616,31.752338322240124,68.24766167775988,Healthcare
9733,2125,7608,21.832939484228913,78.1670605157711,Housing
61020,15487,45533,25.38020321206162,74.61979678793838,Transportation
192587,36484,156103,18.94416549403646,81.05583450596355,Entertainment
107274,10033,97241,9.352685646102504,90.6473143538975,Healthcare
174993,47618,127375,27.211374169252483,72.7886258307475,Entertainment
188011,37790,150221,20.099887772523946,79.90011222747604,Entertainment
117906,19056,98850,16.16202737774159,83.8379726222584,Healthcare
152312,32011,120301,21.016728819790956,78.98327118020904,Entertainment
133169,26732,106437,20.073740885641552,79.92625911435844,Healthcare
49364,46694,2670,94.59120006482456,5.4087999351754315,Food
34727,20245,14482,58.29757825323235,41.70242174676764,Food
82443,21699,60744,26.320002911102215,73.67999708889779,Transportation
73124,7902,65222,10.806301624637602,89.1936983753624,Transportation
135776,30810,104966,22.691786471835965,77.30821352816403,Healthcare
42899,18982,23917,44.2481176717406,55.75188232825939,Food
143272,1161,142111,0.8103467530292032,99.1896532469708,Healthcare
49932,44460,5472,89.04109589041096,10.95890410958904,Food
161329,3389,157940,2.1006762578333715,97.89932374216663,Entertainment
194677,36122,158555,18.554836986392846,81.44516301360716,Entertainment
162304,15128,147176,9.320780757097792,90.6792192429022,Entertainment
12357,1363,10994,11.030185320061502,88.9698146799385,Housing
96734,48891,47843,50.541691649265,49.458308350735,Transportation
159887,11465,148422,7.170689299317642,92.82931070068236,Entertainment
64670,10523,54147,16.27184165764651,83.72815834235348,Transportation
37159,15735,21424,42.34505772491187,57.65494227508814,Food
20977,19874,1103,94.7418601325261,5.258139867473901,Housing
136049,46365,89684,34.07963307337798,65.92036692662202,Healthcare
37127,23595,13532,63.552131871683684,36.447868128316316,Food
96941,44646,52295,46.05481684736076,53.94518315263923,Transportation
187665,49282,138383,26.260623984227216,73.73937601577279,Entertainment
130216,16102,114114,12.365607913006082,87.63439208699391,Healthcare
9932,1757,8175,17.690293999194523,82.30970600080548,Housing
19254,11442,7812,59.426612651916486,40.573387348083514,Housing
16808,3267,13541,19.43717277486911,80.56282722513089,Housing
149998,13156,136842,8.77078361044814,91.22921638955187,Healthcare
153248,4415,148833,2.8809511380246398,97.11904886197537,Entertainment
18395,16241,2154,88.29029627616201,11.709703723838,Housing
169515,20917,148598,12.33932100404094,87.66067899595906,Entertainment
46319,37953,8366,81.93829745892614,18.061702541073856,Food
62044,6403,55641,10.320095416156276,89.67990458384372,Transportation
66572,31740,34832,47.677702337319,52.322297662681,Transportation
27065,5315,21750,19.637908738222798,80.36209126177721,Food
193200,11556,181644,5.981366459627329,94.01863354037268,Entertainment
126270,38732,87538,30.67395264116576,69.32604735883424,Healthcare
80654,26329,54325,32.644382175713545,67.35561782428647,Transportation
22541,3152,19389,13.9834080120669,86.0165919879331,Housing
28934,3385,25549,11.69903919264533,88.30096080735467,Food
35681,10068,25613,28.21669796250105,71.78330203749896,Food
48206,18830,29376,39.06152761067087,60.938472389329135,Food
67153,42364,24789,63.0857891680193,36.9142108319807,Transportation
168256,13350,154906,7.934338151388361,92.06566184861164,Entertainment
12214,3227,8987,26.42050106435238,73.57949893564762,Housing
153135,45459,107676,29.685571554510727,70.31442844548927,Entertainment
182047,5441,176606,2.9887886095349003,97.0112113904651,Entertainment
48863,25103,23760,51.37425045535476,48.62574954464523,Food
41302,7194,34108,17.418042709796136,82.58195729020386,Food
76426,3175,73251,4.154345379844555,95.84565462015544,Transportation
14610,6430,8180,44.01095140314853,55.989048596851475,Housing
25925,18554,7371,71.56798457087753,28.43201542912247,Food
12757,4384,8373,34.36544642157247,65.63455357842753,Housing
143086,43200,99886,30.19163300392771,69.8083669960723,Healthcare
164610,40090,124520,24.354534961423973,75.64546503857603,Entertainment
109409,23606,85803,21.575921542103483,78.42407845789651,Healthcare
117904,32499,85405,27.563950332473873,72.43604966752612,Healthcare
87019,39759,47260,45.690021719394615,54.309978280605385,Transportation
11054,7970,3084,72.10059706893432,27.899402931065676,Housing
188936,39132,149804,20.71177541601389,79.2882245839861,Entertainment
197178,40351,156827,20.464250575622025,79.53574942437798,Entertainment
20080,3390,16690,16.882470119521912,83.11752988047809,Housing
38136,29475,8661,77.28917558212713,22.710824417872878,Food
110336,17669,92667,16.0138123549884,83.9861876450116,Healthcare
137870,1369,136501,0.9929643867411329,99.00703561325886,Healthcare
190245,17945,172300,9.432573786433283,90.56742621356672,Entertainment
157821,49282,108539,31.226516116359676,68.77348388364032,Entertainment
29783,25881,3902,86.89856629620924,13.101433703790752,Food
15390,6905,8485,44.86679662118259,55.13320337881742,Housing
65083,14648,50435,22.50664536053962,77.49335463946038,Transportation
23585,7291,16294,30.913716345134617,69.08628365486538,Housing
153588,30023,123565,19.547751126390082,80.45224887360992,Entertainment
33964,25009,8955,73.63384760334472,26.366152396655284,Food
29995,29878,117,99.60993498916486,0.39006501083513917,Food
137373,42220,95153,30.733841439001843,69.26615856099816,Healthcare
45982,24143,21839,52.50532817189335,47.49467182810665,Food
185789,24437,161352,13.153093024883066,86.84690697511694,Entertainment
86010,35825,50185,41.65213347285199,58.34786652714801,Transportation
196381,5728,190653,2.916779118142794,97.0832208818572,Entertainment
41513,26177,15336,63.05735552718426,36.94264447281574,Food
78877,22908,55969,29.04268671475842,70.95731328524157,Transportation
118473,19336,99137,16.321018291087423,83.67898170891259,Healthcare
32130,19089,13041,59.411764705882355,40.588235294117645,Food
24920,13891,11029,55.74237560192616,44.25762439807384,Housing
68206,11595,56611,16.999970677066536,83.00002932293347,Transportation
19536,13547,5989,69.34377559377559,30.656224406224407,Housing
190206,15162,175044,7.9713573704299545,92.02864262957004,Entertainment
126563,24373,102190,19.257602932926684,80.74239706707331,Healthcare
159353,10486,148867,6.580359328032732,93.41964067196726,Entertainment
37145,12879,24266,34.67223044824337,65.32776955175663,Food
37479,7533,29946,20.099255583126553,79.90074441687345,Food
49889,4633,45256,9.286616288159715,90.7133837118403,Food
95808,22301,73507,23.27676185704743,76.72323814295258,Transportation
148479,14434,134045,9.721240040679154,90.27875995932084,Healthcare
8995,7629,1366,84.81378543635353,15.18621456364647,Housing
169624,35085,134539,20.683983398575673,79.31601660142432,Entertainment
178603,17540,161063,9.820663706656664,90.17933629334334,Entertainment
181086,9442,171644,5.214097169300774,94.78590283069923,Entertainment
86527,38765,47762,44.80104476059496,55.198955239405045,Transportation
179257,23485,155772,13.10130148334514,86.89869851665486,Entertainment
54859,41349,13510,75.37322955212453,24.62677044787546,Transportation
17523,2292,15231,13.079952063002912,86.9200479369971,Housing
49163,6008,43155,12.220572381669141,87.77942761833086,Food
41475,25105,16370,60.53044002411091,39.46955997588909,Food
99483,25792,73691,25.926037614466797,74.0739623855332,Transportation
179640,34621,145019,19.272433756401693,80.7275662435983,Entertainment
30683,5782,24901,18.8443111820878,81.15568881791219,Food
40167,15567,24600,38.7556949734857,61.2443050265143,Food
142583,8888,133695,6.23356220587307,93.76643779412693,Healthcare
163948,49948,114000,30.465757435284356,69.53424256471564,Entertainment
157661,26245,131416,16.64647566614445,83.35352433385556,Entertainment
101849,34329,67520,33.705780125479876,66.29421987452012,Healthcare
130524,44627,85897,34.19064693083264,65.80935306916736,Healthcare
45926,19641,26285,42.76662456996037,57.23337543003962,Food
158196,16561,141635,10.46865913171003,89.53134086828996,Entertainment
30093,6022,24071,20.011298308576745,79.98870169142326,Food
121528,37550,83978,30.89822921466658,69.10177078533341,Healthcare
36373,14837,21536,40.79124625408957,59.20875374591043,Food
48337,15493,32844,32.052051223700275,67.94794877629973,Food
37307,24042,13265,64.4436700887233,35.5563299112767,Food
124761,45087,79674,36.138697189025415,63.861302810974585,Healthcare
20355,3236,17119,15.897813804961928,84.10218619503807,Housing
8089,1709,6380,21.12745704042527,78.87254295957473,Housing
79172,22164,57008,27.994745617137372,72.00525438286263,Transportation
154518,21961,132557,14.212583647212623,85.78741635278739,Entertainment
142397,13230,129167,9.29092607288075,90.70907392711925,Healthcare
124768,38881,85887,31.162637855860474,68.83736214413952,Healthcare
36368,35031,1337,96.32369115706115,3.6763088429388477,Food
169875,42531,127344,25.036644591611477,74.96335540838852,Entertainment
41973,32092,9881,76.45867581540514,23.54132418459486,Food
108079,26118,81961,24.165656603040368,75.83434339695964,Healthcare
175993,29433,146560,16.7239606120698,83.2760393879302,Entertainment
22749,11718,11031,51.509956481603595,48.49004351839641,Housing
126251,41751,84500,33.069837070597465,66.93016292940254,Healthcare
137896,21946,115950,15.914892382665197,84.0851076173348,Healthcare
37172,24111,13061,64.86333799634133,35.13666200365867,Food
11074,8312,2762,75.0586960447896,24.941303955210405,Housing
188848,40075,148773,21.220770143183938,78.77922985681607,Entertainment
177425,14503,162922,8.174158094969705,91.82584190503029,Entertainment
152670,49427,103243,32.3750573131591,67.6249426868409,Entertainment
79903,35758,44145,44.751761510831884,55.24823848916811,Transportation
162198,3359,158839,2.0709256587627465,97.92907434123725,Entertainment
25720,8597,17123,33.4253499222395,66.5746500777605,Food
124556,19874,104682,15.95587526895533,84.04412473104466,Healthcare
10749,6680,4069,62.14531584333426,37.85468415666573,Housing
31856,18678,13178,58.63259668508287,41.36740331491713,Food
80599,35454,45145,43.98813881065522,56.01186118934478,Transportation
110775,15457,95318,13.95350936583164,86.04649063416836,Healthcare
16578,2158,14420,13.017251779466763,86.98274822053324,Housing
178669,46196,132473,25.85563248241161,74.14436751758839,Entertainment
48852,15366,33486,31.45418816015721,68.54581183984278,Food
155148,5443,149705,3.508263077835357,96.49173692216463,Entertainment
16717,8150,8567,48.75276664473291,51.2472333552671,Housing
83360,526,82834,0.6309980806142035,99.3690019193858,Transportation
19390,8448,10942,43.56884992264053,56.43115007735946,Housing
123828,37502,86326,30.28555738605162,69.71444261394838,Healthcare
172792,8301,164491,4.804041853789527,95.19595814621047,Entertainment
46763,2663,44100,5.694673139020166,94.30532686097983,Food
15123,10754,4369,71.11022945182835,28.88977054817166,Housing
67008,26462,40546,39.4908070678128,60.509192932187204,Transportation
77210,42751,34459,55.369770755083536,44.630229244916464,Transportation
140085,31318,108767,22.356426455366385,77.64357354463361,Healthcare
9518,6163,3355,64.75099810884639,35.249001891153604,Housing
165078,39911,125167,24.17705569488363,75.82294430511637,Entertainment
106321,39281,67040,36.94566454416343,63.05433545583657,Healthcare
10093,7071,3022,70.05845635589021,29.94154364410978,Housing
14710,5000,9710,33.990482664853836,66.00951733514616,Housing
18738,11186,7552,59.69687266517237,40.30312733482762,Housing
49407,11279,38128,22.828748962697592,77.1712510373024,Food
48509,9045,39464,18.646024449071305,81.3539755509287,Food
43951,17359,26592,39.49625719551319,60.50374280448681,Food
29109,19404,9705,66.6597959394002,33.34020406059982,Food
162573,12279,150294,7.552914690631285,92.44708530936872,Entertainment
40883,858,40025,2.0986718195827114,97.9013281804173,Food
190869,32503,158366,17.02895703335796,82.97104296664205,Entertainment
42144,1798,40346,4.266324981017464,95.73367501898254,Food
87033,35901,51132,41.249870738685324,58.750129261314676,Transportation
81076,30697,50379,37.86200601904386,62.13799398095614,Transportation
28916,15787,13129,54.59607137916724,45.40392862083276,Food
52893,33966,18927,64.21643695763144,35.783563042368556,Transportation
17333,16608,725,95.81722725437028,4.182772745629724,Housing
25516,12478,13038,48.90264931807493,51.09735068192507,Food
179329,12176,167153,6.789755142782261,93.21024485721775,Entertainment
182253,7796,174457,4.277570190888491,95.7224298091115,Entertainment
63113,31021,32092,49.15152187346506,50.84847812653494,Transportation
58522,1746,56776,2.9834933871022864,97.01650661289771,Transportation
152336,36442,115894,23.92211952525995,76.07788047474004,Entertainment
174233,39412,134821,22.620284331900386,77.3797156680996,Entertainment
99160,27167,71993,27.397135941912058,72.60286405808793,Transportation
107241,31559,75682,29.4281105174327,70.5718894825673,Healthcare
166525,46387,120138,27.85587749587149,72.1441225041285,Entertainment
103744,30924,72820,29.80798889574337,70.19201110425664,Healthcare
8522,5904,2618,69.27951185167801,30.72048814832199,Housing
181544,35424,146120,19.512625038558145,80.48737496144184,Entertainment
19738,14730,5008,74.62762184618502,25.372378153814978,Housing
70013,18812,51201,26.86929570222673,73.13070429777328,Transportation
10711,1668,9043,15.572775651199702,84.4272243488003,Housing
27561,5867,21694,21.28732629440151,78.71267370559849,Food
148391,14557,133834,9.809894131045684,90.19010586895432,Healthcare
87375,17667,69708,20.219742489270388,79.78025751072961,Transportation
135740,5539,130201,4.0805952556357745,95.91940474436423,Healthcare
96733,897,95836,0.927294718451821,99.07270528154818,Transportation
45182,5178,40004,11.460316055066176,88.53968394493383,Food
178312,15136,163176,8.488492081295707,91.5115079187043,Entertainment
81324,20796,60528,25.5717869263686,74.4282130736314,Transportation
89329,27301,62028,30.56230339531395,69.43769660468605,Transportation
186018,111,185907,0.059671644679547144,99.94032835532045,Entertainment
55704,27109,28595,48.66616400976591,51.33383599023409,Transportation
20972,8307,12665,39.6099561319855,60.3900438680145,Housing
83794,32839,50955,39.19015681313698,60.80984318686302,Transportation
64275,30958,33317,48.16491637495138,51.83508362504862,Transportation
49925,28853,21072,57.792689033550324,42.207310966449676,Food
93372,34875,58497,37.35059760956175,62.64940239043825,Transportation
116728,48971,67757,41.95308751970393,58.04691248029607,Healthcare
30612,26412,4200,86.27989023912191,13.720109760878088,Food
184104,5413,178691,2.940185981836353,97.05981401816365,Entertainment
74396,18756,55640,25.21103285122856,74.78896714877143,Transportation
24779,7400,17379,29.86399774002179,70.1360022599782,Housing
137852,8816,129036,6.3952644865507935,93.60473551344921,Healthcare
38504,10303,28201,26.75825888219406,73.24174111780594,Food
56010,20842,35168,37.2112122835208,62.7887877164792,Transportation
113527,11278,102249,9.93420067472936,90.06579932527065,Healthcare
66106,35656,30450,53.93761534505188,46.06238465494811,Transportation
32962,26140,6822,79.30344032522298,20.696559674777014,Food
128982,35764,93218,27.727900017056644,72.27209998294336,Healthcare
35256,1447,33809,4.104265940549126,95.89573405945087,Food
85166,12674,72492,14.88152549139328,85.11847450860672,Transportation
24034,5710,18324,23.758009486560706,76.24199051343929,Housing
147021,8730,138291,5.937927234884812,94.06207276511519,Healthcare
19053,3476,15577,18.243846113472944,81.75615388652706,Housing
176724,3572,173152,2.021230845838709,97.9787691541613,Entertainment
43260,19790,23470,45.74664817383264,54.25335182616736,Food
115026,7145,107881,6.211639107680003,93.78836089232,Healthcare
48885,17400,31485,35.59374041116907,64.40625958883092,Food
161039,25933,135106,16.103552555592124,83.89644744440787,Entertainment
27774,13159,14615,47.37884352271909,52.621156477280906,Food
13093,11166,1927,85.2822118689376,14.7177881310624,Housing
49140,3358,45782,6.833536833536834,93.16646316646316,Food
18724,5178,13546,27.65434736167486,72.34565263832515,Housing
64027,20422,43605,31.895918909210174,68.10408109078982,Transportation
52512,24226,28286,46.1342169408897,53.86578305911029,Transportation
78468,23402,55066,29.82362236835398,70.17637763164602,Transportation
193830,36366,157464,18.76180157870299,81.23819842129701,Entertainment
184004,13149,170855,7.146040303471664,92.85395969652834,Entertainment
145415,7535,137880,5.181721280473129,94.81827871952687,Healthcare
42654,26140,16514,61.28381863365687,38.716181366343136,Food
130625,34119,96506,26.119808612440192,73.88019138755982,Healthcare
152700,29485,123215,19.309102815979042,80.69089718402095,Entertainment
195098,47735,147363,24.46719084767655,75.53280915232344,Entertainment
170115,19050,151065,11.198307027598977,88.80169297240103,Entertainment
10137,4445,5692,43.84926506856072,56.15073493143928,Housing
39210,15029,24181,38.3295077786279,61.6704922213721,Food
143148,8744,134404,6.108363372174253,93.89163662782575,Healthcare
100107,4754,95353,4.74891865703697,95.25108134296303,Healthcare
9058,4293,4765,47.39456833738132,52.605431662618685,Housing
159461,34553,124908,21.66862116755821,78.33137883244179,Entertainment
34220,6310,27910,18.439509059029806,81.5604909409702,Food
130315,37443,92872,28.732686183478496,71.26731381652151,Healthcare
36619,8307,28312,22.684944973920643,77.31505502607936,Food
171165,20429,150736,11.935267139894254,88.06473286010575,Entertainment
30128,23331,6797,77.43959107806691,22.560408921933085,Food
24446,7829,16617,32.02568927431891,67.9743107256811,Housing
173915,30067,143848,17.288330506281806,82.7116694937182,Entertainment
15230,11002,4228,72.23900196979646,27.76099803020354,Housing
68658,3629,65029,5.285618573217979,94.71438142678203,Transportation
176694,6959,169735,3.9384472591033086,96.0615527408967,Entertainment
95441,36923,58518,38.68672792615333,61.31327207384667,Transportation
99985,41756,58229,41.76226433965095,58.23773566034905,Transportation
79291,16016,63275,20.199013759443062,79.80098624055694,Transportation
88898,43183,45715,48.575895970663005,51.424104029336995,Transportation
63073,11133,51940,17.650975853376245,82.34902414662375,Transportation
147982,29989,117993,20.265302536795016,79.73469746320498,Healthcare
35592,8012,27580,22.510676556529557,77.48932344347045,Food
10376,3009,7367,28.999614494988435,71.00038550501156,Housing
193740,38733,155007,19.992257664911737,80.00774233508827,Entertainment
74152,36,74116,0.048548926529291186,99.95145107347071,Transportation
13433,1098,12335,8.173900096776594,91.82609990322341,Housing
183586,6203,177383,3.378797947555914,96.62120205244409,Entertainment
100998,43769,57229,43.3365017129052,56.6634982870948,Healthcare
92550,37763,54787,40.802809292274446,59.197190707725554,Transportation
8502,6910,1592,81.27499411903082,18.725005880969185,Housing
195039,34310,160729,17.591353524166962,82.40864647583304,Entertainment
174971,25744,149227,14.713295346085923,85.28670465391409,Entertainment
8853,4146,4707,46.8315825144019,53.168417485598106,Housing
132146,41388,90758,31.3199037428299,68.68009625717009,Healthcare
20001,14350,5651,71.74641267936603,28.253587320633965,Housing
14420,13869,551,96.17891816920942,3.8210818307905687,Housing
161227,39698,121529,24.62242676474784,75.37757323525216,Entertainment
167585,48347,119238,28.849240683832083,71.1507593161679,Entertainment
140404,14604,125800,10.40141306515484,89.59858693484516,Healthcare
110403,13074,97329,11.842069508980735,88.15793049101927,Healthcare
135106,5594,129512,4.140452681598152,95.85954731840185,Healthcare
177303,10590,166713,5.972826178914063,94.02717382108594,Entertainment
41126,727,40399,1.7677381705004134,98.23226182949959,Food
182400,25236,157164,13.835526315789473,86.16447368421053,Entertainment
104428,46244,58184,44.28314245221588,55.716857547784116,Healthcare
45864,3432,42432,7.482993197278912,92.51700680272108,Food
13788,5408,8380,39.22251232956194,60.777487670438056,Housing
158262,4474,153788,2.8269578294220974,97.1730421705779,Entertainment
173529,29402,144127,16.9435656287998,83.05643437120021,Entertainment
29701,11027,18674,37.126696070839365,62.87330392916063,Food
11644,5241,6403,45.01030573686018,54.98969426313981,Housing
32814,5753,27061,17.53215091119644,82.46784908880356,Food
153361,42553,110808,27.74695000684659,72.25304999315341,Entertainment
175785,21125,154660,12.017521403987825,87.98247859601217,Entertainment
66992,22553,44439,33.66521375686649,66.33478624313351,Transportation
26858,769,26089,2.8632064934097845,97.13679350659021,Food
99396,23396,76000,23.538170550122743,76.46182944987726,Transportation
15340,14267,1073,93.00521512385919,6.994784876140808,Housing
9958,6344,3614,63.70757180156657,36.29242819843342,Housing
41577,39405,2172,94.77595786131755,5.224042138682445,Food
32906,10338,22568,31.41676290038291,68.5832370996171,Food
101754,29531,72223,29.021954910863457,70.97804508913654,Healthcare
124055,43034,81021,34.689452259078635,65.31054774092136,Healthcare
149696,32747,116949,21.87566802052159,78.12433197947841,Healthcare
37902,24484,13418,64.59817423882645,35.401825761173555,Food
180784,3143,177641,1.7385388087441365,98.26146119125586,Entertainment
113137,38244,74893,33.80326506801489,66.19673493198512,Healthcare
14046,12237,1809,87.12088850918411,12.87911149081589,Housing
89940,28314,61626,31.48098732488325,68.51901267511674,Transportation
128925,7433,121492,5.7653674617025406,94.23463253829746,Healthcare
58169,6861,51308,11.794942323230586,88.20505767676941,Transportation
44783,24881,19902,55.559029095862265,44.440970904137735,Food
170172,25091,145081,14.7444938062666,85.2555061937334,Entertainment
57856,43463,14393,75.12271847345133,24.87728152654867,Transportation
91543,6869,84674,7.503577553717925,92.49642244628208,Transportation
14809,4621,10188,31.20399756904585,68.79600243095415,Housing
95956,17573,78383,18.313602067614323,81.68639793238567,Transportation
197420,36556,160864,18.516867591935974,81.48313240806402,Entertainment
189317,3024,186293,1.597320895640645,98.40267910435936,Entertainment
47524,17958,29566,37.78722329770222,62.21277670229779,Food
55256,9411,45845,17.031634573620963,82.96836542637904,Transportation
38118,22250,15868,58.371373104570026,41.62862689542998,Food
188799,49330,139469,26.12831635760783,73.87168364239217,Entertainment
51824,6852,44972,13.221673355974067,86.77832664402594,Transportation
17435,11310,6125,64.86951534270146,35.13048465729854,Housing
111978,23466,88512,20.955902052188826,79.04409794781118,Healthcare
48611,21602,27009,44.43850157371788,55.56149842628212,Food
45658,27433,18225,60.08366551316308,39.91633448683692,Food
143474,16040,127434,11.1797259433765,88.8202740566235,Healthcare
8929,3699,5230,41.426811513047376,58.573188486952624,Housing
122254,29202,93052,23.886335007443517,76.11366499255648,Healthcare
17310,7984,9326,46.12362796071635,53.87637203928365,Housing
96348,43351,52997,44.99418773612322,55.005812263876784,Transportation
52621,35414,17207,67.30012732559244,32.69987267440755,Transportation
45529,1168,44361,2.565397878275385,97.43460212172461,Food
30078,13247,16831,44.04215705831505,55.95784294168495,Food
31999,28806,3193,90.02156317384919,9.978436826150817,Food
35957,30663,5294,85.27685846983898,14.723141530161026,Food
182122,48503,133619,26.632147681224673,73.36785231877533,Entertainment
114330,49150,65180,42.98959153328085,57.01040846671914,Healthcare
13301,10406,2895,78.23471919404557,21.76528080595444,Housing
189946,45969,143977,24.201088730481295,75.79891126951871,Entertainment
24347,22687,1660,93.18191152914117,6.818088470858832,Housing
41969,30266,11703,72.11513259786986,27.88486740213014,Food
77000,12779,64221,16.596103896103894,83.4038961038961,Transportation
16475,4396,12079,26.682852807283762,73.31714719271623,Housing
94625,15764,78861,16.659445178335535,83.34055482166447,Transportation
111585,5965,105620,5.34570058699646,94.65429941300354,Healthcare
186177,46575,139602,25.016516540711258,74.98348345928875,Entertainment
101601,5700,95901,5.610181002155491,94.38981899784451,Healthcare
24661,16616,8045,67.37764080937512,32.62235919062487,Housing
20206,8226,11980,40.710679996040774,59.289320003959226,Housing
37927,33765,4162,89.02628734147177,10.973712658528227,Food
24610,23705,905,96.32263307598538,3.677366924014628,Housing
59231,40232,18999,67.92389120561867,32.07610879438132,Transportation
32236,17197,15039,53.34718947760268,46.65281052239732,Food
111095,2407,108688,2.1666141590530628,97.83338584094695,Healthcare
42930,1070,41860,2.4924295364546936,97.5075704635453,Food
29959,524,29435,1.7490570446276579,98.25094295537234,Food
193863,25602,168261,13.206233267823153,86.79376673217685,Entertainment
26031,15881,10150,61.00802888863278,38.99197111136722,Food
30738,19601,11137,63.76797449411152,36.23202550588848,Food
171967,13794,158173,8.021306413439788,91.97869358656021,Entertainment
41180,2892,38288,7.022826614861584,92.97717338513841,Food
76854,8183,68671,10.64746142035548,89.35253857964453,Transportation
12650,4987,7663,39.422924901185766,60.57707509881423,Housing
17078,2844,14234,16.653003864621148,83.34699613537884,Housing
171512,15029,156483,8.762652175941042,91.23734782405896,Entertainment
31790,27181,4609,85.50173010380622,14.498269896193772,Food
148682,23806,124876,16.01135308914327,83.98864691085673,Healthcare
14450,13230,1220,91.55709342560554,8.442906574394463,Housing
24590,21259,3331,86.45384302562017,13.54615697437983,Housing
16662,7114,9548,42.695954867362865,57.304045132637135,Housing
158725,5084,153641,3.203024098283194,96.7969759017168,Entertainment
132522,44692,87830,33.72421182897934,66.27578817102065,Healthcare
91685,6766,84919,7.379614986093691,92.62038501390631,Transportation
27411,1820,25591,6.639670205391996,93.36032979460799,Food
45184,1132,44052,2.5053116147308785,97.49468838526913,Food
34282,28251,6031,82.40767749839566,17.59232250160434,Food
63937,42029,21908,65.7350204107168,34.2649795892832,Transportation
60859,44159,16700,72.55952283146289,27.440477168537107,Transportation
176446,11152,165294,6.32034730172404,93.67965269827596,Entertainment
67439,1764,65675,2.615697148534231,97.38430285146576,Transportation
129428,16980,112448,13.119263219705166,86.88073678029482,Healthcare
23261,1431,21830,6.1519281200292335,93.84807187997076,Housing
42443,22499,19944,53.00991918573145,46.990080814268545,Food
38568,12317,26251,31.93580170089193,68.06419829910807,Food
112226,11481,100745,10.230249674763424,89.76975032523657,Healthcare
23463,22483,980,95.82321101308443,4.17678898691557,Housing
106322,24440,81882,22.986776020014673,77.01322397998533,Healthcare
48383,22394,25989,46.28485211747928,53.71514788252072,Food
150446,17409,133037,11.571593794451166,88.42840620554884,Entertainment
135596,2058,133538,1.5177438862503319,98.48225611374967,Healthcare
67431,2176,65255,3.227002417285818,96.77299758271418,Transportation
42323,35278,7045,83.35420456961936,16.645795430380645,Food
147665,19280,128385,13.056580774049367,86.94341922595063,Healthcare
39617,4933,34684,12.451725269455032,87.54827473054497,Food
21992,5699,16293,25.91396871589669,74.08603128410331,Housing
9920,4188,5732,42.21774193548387,57.782258064516135,Housing
191130,37693,153437,19.721132213676558,80.27886778632345,Entertainment
36603,11819,24784,32.2897030298063,67.7102969701937,Food
91759,13750,78009,14.984906112751883,85.01509388724811,Transportation
128343,21395,106948,16.67017289606757,83.32982710393243,Healthcare
11225,1316,9909,11.723830734966592,88.27616926503342,Housing
25732,1129,24603,4.3875330327996265,95.61246696720038,Food
47951,36445,11506,76.00467143542366,23.995328564576337,Food
151966,32556,119410,21.423213087137913,78.57678691286209,Entertainment
107190,45520,61670,42.466648008209724,57.53335199179028,Healthcare
195154,2413,192741,1.2364594115416543,98.76354058845834,Entertainment
83215,32876,50339,39.50730036652046,60.49269963347954,Transportation
169764,48673,121091,28.67097853490728,71.32902146509271,Entertainment
40129,15663,24466,39.03162301577413,60.96837698422587,Food
105625,33706,71919,31.911005917159763,68.08899408284023,Healthcare
55431,41366,14065,74.62611174252675,25.373888257473254,Transportation
27659,10910,16749,39.44466538920424,60.55533461079576,Food
33223,24074,9149,72.46184871926076,27.53815128073925,Food
191233,37649,153584,19.687501634132186,80.31249836586781,Entertainment
194309,38892,155417,20.0155422548621,79.98445774513789,Entertainment
80383,39770,40613,49.47563539554383,50.52436460445616,Transportation
14718,2581,12137,17.53635004756081,82.46364995243918,Housing
168281,39427,128854,23.42926414746763,76.57073585253237,Entertainment
106750,33064,73686,30.97330210772834,69.02669789227166,Healthcare
52887,49629,3258,93.83969595552783,6.160304044472176,Transportation
42959,40828,2131,95.03945622570357,4.960543774296422,Food
11423,10211,1212,89.3898275409262,10.610172459073798,Housing
102809,13055,89754,12.698304623136107,87.3016953768639,Healthcare
192584,34621,157963,17.977090516346113,82.02290948365388,Entertainment
82384,39963,42421,48.50820547679161,51.49179452320839,Transportation
99081,39802,59279,40.171173080610814,59.828826919389186,Transportation
68707,24563,44144,35.750360225304554,64.24963977469544,Transportation
186137,16128,170009,8.664585762099959,91.33541423790004,Entertainment
59477,17270,42207,29.03643425189569,70.9635657481043,Transportation
36242,9497,26745,26.204403730478447,73.79559626952155,Food
159305,47647,111658,29.909293493612882,70.09070650638712,Entertainment
68165,27180,40985,39.87383554610137,60.126164453898625,Transportation
56477,19743,36734,34.95759335658764,65.04240664341236,Transportation
10711,4853,5858,45.30856129212958,54.69143870787041,Housing
194058,9496,184562,4.893382390831607,95.1066176091684,Entertainment
64440,44518,19922,69.08441961514588,30.91558038485413,Transportation
22203,17071,5132,76.88600639553214,23.113993604467865,Housing
126163,23913,102250,18.954051504799345,81.04594849520065,Healthcare
134148,9675,124473,7.212183558457823,92.78781644154218,Healthcare
13571,9010,4561,66.39157026011347,33.608429739886525,Housing
144789,4747,140042,3.2785639793078207,96.72143602069218,Healthcare
25871,4196,21675,16.21893239534614,83.78106760465386,Food
37160,4423,32737,11.902583423035521,88.09741657696448,Food
112998,18330,94668,16.221526044708757,83.77847395529125,Healthcare
46342,32018,14324,69.09067368693626,30.909326313063744,Food
31200,546,30654,1.7500000000000002,98.25,Food
12769,4796,7973,37.55971493460725,62.44028506539275,Housing
16837,14955,1882,88.82223674051197,11.177763259488033,Housing
13029,133,12896,1.0207997543940441,98.97920024560595,Housing
53061,13731,39330,25.8777633289987,74.12223667100129,Transportation
12998,162,12836,1.2463455916294814,98.75365440837052,Housing
31796,6984,24812,21.96502704742735,78.03497295257264,Food
119395,35136,84259,29.428368022111478,70.57163197788852,Healthcare
36804,15408,21396,41.865014672318225,58.134985327681775,Food
34491,21252,13239,61.61607375837175,38.38392624162825,Food
10854,9695,1159,89.32190897365027,10.678091026349733,Housing
122334,15958,106376,13.044615560678144,86.95538443932186,Healthcare
44055,36133,7922,82.01793213029168,17.982067869708317,Food
15314,2383,12931,15.560924644116495,84.4390753558835,Housing
145969,16101,129868,11.030424268166529,88.96957573183347,Healthcare
13808,6796,7012,49.217844727694086,50.78215527230591,Housing
159459,2945,156514,1.8468697282687085,98.1531302717313,Entertainment
12481,7898,4583,63.28018588254146,36.71981411745854,Housing
115630,31949,83681,27.630372740638244,72.36962725936176,Healthcare
49071,48669,402,99.1807788714312,0.8192211285688084,Food
182408,4073,178335,2.2329064514714267,97.76709354852858,Entertainment
80867,21988,58879,27.19032485439054,72.80967514560945,Transportation
8155,1070,7085,13.120784794604537,86.87921520539547,Housing
28304,19497,8807,68.88425664217071,31.115743357829285,Food
126075,17310,108765,13.729922665080311,86.27007733491969,Healthcare
194085,34189,159896,17.61547775459206,82.38452224540794,Entertainment
137368,12274,125094,8.935123172791334,91.06487682720866,Healthcare
168911,31087,137824,18.40436679671543,81.59563320328456,Entertainment
139108,27430,111678,19.71849210685223,80.28150789314778,Healthcare
67974,25737,42237,37.86300644364022,62.13699355635979,Transportation
45390,44523,867,98.08988764044943,1.9101123595505618,Food
12283,7736,4547,62.981356346169505,37.018643653830495,Housing
75104,34263,40841,45.620739241585,54.37926075841499,Transportation
121160,29536,91624,24.377682403433475,75.62231759656652,Healthcare
15815,13778,2037,87.11982295289282,12.880177047107178,Housing
171330,36734,134596,21.440494951263645,78.55950504873636,Entertainment
17821,7778,10043,43.64513775882386,56.35486224117614,Housing
169279,40264,129015,23.785584744711393,76.2144152552886,Entertainment
24211,7122,17089,29.416380983850317,70.58361901614968,Housing
197754,15026,182728,7.598329237335275,92.40167076266472,Entertainment
23034,13623,9411,59.143005991143525,40.856994008856475,Housing
8190,2300,5890,28.083028083028083,71.91697191697192,Housing
16702,384,16318,2.2991258531912346,97.70087414680877,Housing
11866,5818,6048,49.03084442946233,50.96915557053767,Housing
64678,27818,36860,43.00998794025789,56.990012059742114,Transportation
14767,10755,4012,72.83131306291054,27.168686937089454,Housing
153213,38943,114270,25.417555951518473,74.58244404848152,Entertainment
128606,49616,78990,38.57984852961759,61.420151470382415,Healthcare
75819,10251,65568,13.520357693981719,86.47964230601828,Transportation
34662,18064,16598,52.11470774912007,47.88529225087992,Food
23688,1863,21825,7.864741641337386,92.13525835866263,Housing
102776,15828,86948,15.400482602942322,84.59951739705768,Healthcare
85802,41628,44174,48.5163516001958,51.4836483998042,Transportation
19023,10699,8324,56.24244335804026,43.75755664195973,Housing
26811,20950,5861,78.13956957965014,21.860430420349854,Food
52940,22149,30791,41.837929731771816,58.162070268228184,Transportation
144553,2433,142120,1.6831196862050597,98.31688031379494,Healthcare
151659,28963,122696,19.097448882031397,80.9025511179686,Entertainment
25127,5602,19525,22.294742707048197,77.7052572929518,Food
21680,16767,4913,77.33856088560886,22.661439114391143,Housing
139984,37956,102028,27.114527374557092,72.8854726254429,Healthcare
25655,21865,3790,85.2270512570649,14.7729487429351,Food
26642,16855,9787,63.26476991216876,36.73523008783125,Food
85037,33743,51294,39.680374425250186,60.319625574749814,Transportation
156124,3061,153063,1.9606210448105355,98.03937895518946,Entertainment
32530,20858,11672,64.11927451583153,35.88072548416846,Food
180784,41249,139535,22.816731569165412,77.18326843083459,Entertainment
109400,13686,95714,12.510054844606946,87.48994515539306,Healthcare
163866,25345,138521,15.466905886517033,84.53309411348296,Entertainment
197580,31968,165612,16.179775280898877,83.82022471910112,Entertainment
86496,13703,72793,15.842351091379946,84.15764890862005,Transportation
59851,27701,32150,46.28327012079998,53.71672987920001,Transportation
20588,3374,17214,16.38818729356907,83.61181270643094,Housing
30984,16527,14457,53.340433772269556,46.659566227730444,Food
125715,20875,104840,16.60501928966313,83.39498071033688,Healthcare
102244,1701,100543,1.6636673056609679,98.33633269433903,Healthcare
8525,6477,2048,75.97653958944281,24.023460410557185,Housing
101226,12196,89030,12.048287989251772,87.95171201074822,Healthcare
46585,8521,38064,18.291295481378125,81.70870451862187,Food
11436,8754,2682,76.54774396642182,23.452256033578177,Housing
153743,41742,112001,27.15050441320906,72.84949558679095,Entertainment
159218,49513,109705,31.097614591315054,68.90238540868495,Entertainment
36990,11939,25051,32.276290889429575,67.72370911057043,Food
26052,12225,13827,46.92538000921234,53.07461999078765,Food
109405,33639,75766,30.74722361866459,69.2527763813354,Healthcare
92579,9455,83124,10.21289925361043,89.78710074638957,Transportation
193902,7649,186253,3.9447762271663,96.0552237728337,Entertainment
92027,7833,84194,8.511632455692352,91.48836754430765,Transportation
16853,11695,5158,69.39417314424732,30.60582685575268,Housing
119740,34168,85572,28.535159512276596,71.46484048772341,Healthcare
147959,13421,134538,9.070756087835145,90.92924391216486,Healthcare
44460,3164,41296,7.11650922177238,92.88349077822761,Food
187180,21941,165239,11.721871994871247,88.27812800512875,Entertainment
26850,2642,24208,9.839851024208567,90.16014897579143,Food
16787,10096,6691,60.141776374575564,39.858223625424436,Housing
104888,44411,60477,42.34135458775074,57.65864541224926,Healthcare
91877,29388,62489,31.986242476354253,68.01375752364575,Transportation
141070,31126,109944,22.06422343517403,77.93577656482597,Healthcare
18271,12819,5452,70.16036341743747,29.83963658256253,Housing
50257,15704,34553,31.247388423503192,68.7526115764968,Transportation
130263,11280,118983,8.65940443564174,91.34059556435827,Healthcare
29767,21746,8021,73.05405314610138,26.94594685389861,Food
10243,2645,7598,25.822512935663376,74.17748706433662,Housing
28540,14744,13796,51.660826909600566,48.33917309039944,Food
9936,3807,6129,38.315217391304344,61.684782608695656,Housing
11363,24,11339,0.2112118278623603,99.78878817213764,Housing
116443,9765,106678,8.386077308210885,91.61392269178911,Healthcare
92433,16360,76073,17.69930652472602,82.30069347527397,Transportation
15165,10900,4265,71.87603033300363,28.123969666996373,Housing
197028,12631,184397,6.410763952331648,93.58923604766835,Entertainment
40199,3985,36214,9.913181919948258,90.08681808005174,Food
19528,15743,3785,80.6175747644408,19.382425235559197,Housing
25809,24747,1062,95.88515634081133,4.114843659188655,Food
31214,26573,4641,85.13167168578202,14.86832831421798,Food
12255,11015,1240,89.88168094655242,10.118319053447571,Housing
73366,5392,67974,7.34945342529237,92.65054657470763,Transportation
110529,28190,82339,25.504618697355447,74.49538130264456,Healthcare
160162,23581,136581,14.723217742036187,85.27678225796382,Entertainment
20127,15748,4379,78.24315595965618,21.756844040343818,Housing
48835,34474,14361,70.59281253199549,29.4071874680045,Food
163709,18072,145637,11.039099866226048,88.96090013377396,Entertainment
115978,44839,71139,38.661642725344464,61.33835727465554,Healthcare
60893,34326,26567,56.37101144630746,43.628988553692544,Transportation
28186,15011,13175,53.256936067551266,46.74306393244873,Food
61269,5067,56202,8.270087646281153,91.72991235371884,Transportation
174975,35398,139577,20.23031861694528,79.76968138305473,Entertainment
127327,18510,108817,14.537372277678735,85.46262772232127,Healthcare
163074,11371,151703,6.972908004954806,93.0270919950452,Entertainment
37584,23513,14071,62.561196253724994,37.43880374627501,Food
17160,6652,10508,38.764568764568764,61.235431235431236,Housing
192501,3956,188545,2.0550542594583927,97.94494574054161,Entertainment
145811,46901,98910,32.16561164795523,67.83438835204477,Healthcare
40373,25938,14435,64.24590691798974,35.75409308201025,Food
28716,14877,13839,51.80735478478897,48.19264521521103,Food
43800,2637,41163,6.02054794520548,93.97945205479452,Food
76856,35790,41066,46.567606953263244,53.432393046736756,Transportation
174658,5656,169002,3.2383286193589758,96.76167138064102,Entertainment
149323,24524,124799,16.42345787320105,83.57654212679894,Healthcare
183953,27326,156627,14.85488140992536,85.14511859007465,Entertainment
24023,8322,15701,34.641801606793486,65.35819839320651,Housing
49355,27761,21594,56.24759396211123,43.75240603788876,Food
140499,31283,109216,22.26563890134449,77.7343610986555,Healthcare
32395,29416,2979,90.80413644080878,9.195863559191233,Food
50365,19797,30568,39.307058473146036,60.69294152685396,Transportation
24377,20324,4053,83.37367190384379,16.62632809615621,Housing
120107,14322,105785,11.924367439033528,88.07563256096648,Healthcare
51032,10208,40824,20.003135287662644,79.99686471233736,Transportation
9913,9408,505,94.90567941087461,5.094320589125391,Housing
9974,3291,6683,32.99578905153398,67.00421094846601,Housing
47411,24685,22726,52.06597625023729,47.93402374976271,Food
118831,20289,98542,17.07382753658557,82.92617246341443,Healthcare
100306,21881,78425,21.814248399896314,78.18575160010369,Healthcare
43538,9486,34052,21.787863475584544,78.21213652441546,Food
26411,12665,13746,47.953504221725794,52.046495778274206,Food
75352,15445,59907,20.4971334536575,79.5028665463425,Transportation
184594,13786,170808,7.468281742635188,92.53171825736482,Entertainment
73556,26616,46940,36.184675621295334,63.815324378704666,Transportation
31079,29631,1448,95.34090543453779,4.659094565462209,Food
21324,10350,10974,48.536859876195834,51.463140123804166,Housing
171388,15324,156064,8.941116064135178,91.05888393586483,Entertainment
13991,10531,3460,75.26981631048531,24.730183689514686,Housing
29599,10214,19385,34.50792256495152,65.49207743504849,Food
103600,27293,76307,26.344594594594597,73.6554054054054,Healthcare
123226,2637,120589,2.1399704607793812,97.86002953922062,Healthcare
28896,25258,3638,87.41002214839423,12.589977851605758,Food
43644,42788,856,98.03867656493446,1.9613234350655304,Food
71578,1214,70364,1.6960518595099054,98.30394814049009,Transportation
173213,40118,133095,23.16107913378326,76.83892086621674,Entertainment
187915,10306,177609,5.484394540084613,94.51560545991539,Entertainment
29778,15994,13784,53.7107932030358,46.2892067969642,Food
40311,8226,32085,20.40634070104934,79.59365929895066,Food
181534,6966,174568,3.837297696299316,96.16270230370068,Entertainment
111347,40491,70856,36.36469774668379,63.635302253316205,Healthcare
10839,3384,7455,31.220592305563244,68.77940769443676,Housing
58151,42875,15276,73.73046035321835,26.269539646781652,Transportation
121700,43085,78615,35.40262941659819,64.5973705834018,Healthcare
24625,2668,21957,10.834517766497461,89.16548223350253,Housing
129058,34094,94964,26.417579692851277,73.58242030714872,Healthcare
185123,38087,147036,20.573888711829433,79.42611128817056,Entertainment
56692,2763,53929,4.873703520778946,95.12629647922105,Transportation
151072,34390,116682,22.763980088964203,77.2360199110358,Entertainment
72607,10150,62457,13.979368380459183,86.02063161954081,Transportation
83788,44225,39563,52.78202129183177,47.21797870816823,Transportation
17127,10487,6640,61.230805161441005,38.769194838559,Housing
89230,7044,82186,7.8942059845343495,92.10579401546565,Transportation
189242,29816,159426,15.75548768243836,84.24451231756164,Entertainment
18602,5628,12974,30.254811310611764,69.74518868938824,Housing
43280,22908,20372,52.92975970425139,47.07024029574861,Food
188026,35719,152307,18.99684086243392,81.00315913756609,Entertainment
173685,29858,143827,17.19089155655353,82.80910844344646,Entertainment
53642,21596,32046,40.25949815443123,59.74050184556877,Transportation
147169,24346,122823,16.542886069756538,83.45711393024347,Healthcare
50685,37001,13684,73.00187432179146,26.998125678208545,Transportation
106048,39017,67031,36.79183011466506,63.20816988533494,Healthcare
187097,921,186176,0.49225802658514034,99.50774197341487,Entertainment
44767,36931,7836,82.49603502580025,17.503964974199747,Food
185635,18630,167005,10.035822985967085,89.96417701403291,Entertainment
12324,10787,1537,87.52839987017202,12.471600129827978,Housing
198504,28207,170297,14.209789223390965,85.79021077660903,Entertainment
11696,11622,74,99.3673050615595,0.6326949384404925,Housing
45058,17948,27110,39.833103999289804,60.16689600071019,Food
148898,22209,126689,14.915579792878347,85.08442020712165,Healthcare
48992,40437,8555,82.5379653821032,17.462034617896798,Food
113058,32400,80658,28.657857029135485,71.34214297086451,Healthcare
152556,12767,139789,8.368730171215816,91.63126982878418,Entertainment
195331,42678,152653,21.84906645642525,78.15093354357475,Entertainment
71214,1950,69264,2.7382256297918945,97.26177437020812,Transportation
25756,6495,19261,25.21742506600404,74.78257493399596,Food
184515,28402,156113,15.392786494322955,84.60721350567705,Entertainment
60395,26872,33523,44.49374948257306,55.506250517426935,Transportation
22996,16336,6660,71.0384414680814,28.961558531918598,Housing
58253,30844,27409,52.94834600793092,47.05165399206908,Transportation
19667,4529,15138,23.02842324706361,76.97157675293639,Housing
12927,11580,1347,89.57994894407055,10.42005105592945,Housing
19821,18031,1790,90.96917410826902,9.030825891730993,Housing
25936,12172,13764,46.93090684762492,53.06909315237508,Food
8851,1687,7164,19.05999322110496,80.94000677889504,Housing
120240,13065,107175,10.865768463073852,89.13423153692615,Healthcare
114003,19523,94480,17.12498793891389,82.87501206108611,Healthcare
70473,12076,58397,17.13564059994608,82.86435940005393,Transportation
94332,22185,72147,23.518000254420556,76.48199974557944,Transportation
83989,29506,54483,35.130790936908404,64.86920906309159,Transportation
173117,26170,146947,15.116944032070794,84.8830559679292,Entertainment
34282,20425,13857,59.579371098535674,40.420628901464326,Food
36268,6743,29525,18.592147347523987,81.40785265247601,Food
13569,4300,9269,31.689881347188443,68.31011865281155,Housing
113120,7664,105456,6.775106082036775,93.22489391796323,Healthcare
154672,24133,130539,15.602694734664322,84.39730526533567,Entertainment
162644,35069,127575,21.561815990752812,78.4381840092472,Entertainment
118800,35453,83347,29.84259259259259,70.15740740740742,Healthcare
42794,26270,16524,61.3871103425714,38.61288965742861,Food
18896,4937,13959,26.12722269263336,73.87277730736665,Housing
132211,48978,83233,37.04532905734016,62.95467094265984,Healthcare
103056,17043,86013,16.537610619469024,83.46238938053098,Healthcare
148704,27354,121350,18.394932214331828,81.60506778566817,Healthcare
30650,19645,11005,64.09461663947798,35.90538336052202,Food
170615,26190,144425,15.350350203674939,84.64964979632505,Entertainment
18340,1382,16958,7.535441657579062,92.46455834242093,Housing
155519,19627,135892,12.62032291874305,87.37967708125696,Entertainment
156219,49892,106327,31.937216343722596,68.0627836562774,Entertainment
198614,24067,174547,12.117474095481688,87.88252590451832,Entertainment
150059,2636,147423,1.756642387327651,98.24335761267234,Entertainment
79266,15954,63312,20.127166754976912,79.87283324502309,Transportation
163419,34854,128565,21.327997356488535,78.67200264351146,Entertainment
165625,1735,163890,1.0475471698113208,98.95245283018868,Entertainment
144398,11549,132849,7.998033213756424,92.00196678624357,Healthcare
44268,15696,28572,35.45676335050149,64.54323664949851,Food
176091,20681,155410,11.744495743677986,88.25550425632201,Entertainment
72463,17821,54642,24.593240688351298,75.40675931164871,Transportation
22262,8308,13954,37.31919863444435,62.68080136555566,Housing
97081,14318,82763,14.748508977039792,85.25149102296021,Transportation
94564,30628,63936,32.388646842350155,67.61135315764984,Transportation
25868,13779,12089,53.26658419669089,46.73341580330911,Food
144294,21662,122632,15.012405228214618,84.98759477178538,Healthcare
124017,31098,92919,25.075594474951014,74.92440552504898,Healthcare
121088,49500,71588,40.87936046511628,59.12063953488372,Healthcare
47739,8695,39044,18.21361989149333,81.78638010850668,Food
121183,9415,111768,7.7692415602848595,92.23075843971515,Healthcare
42719,21972,20747,51.433788244106836,48.566211755893164,Food
143788,20191,123597,14.042201018165631,85.95779898183437,Healthcare
140048,28389,111659,20.270907117559695,79.72909288244031,Healthcare
120299,43446,76853,36.115013424883,63.884986575117,Healthcare
157414,31578,125836,20.06047746706138,79.93952253293862,Entertainment
173413,22863,150550,13.184132677480928,86.81586732251907,Entertainment
186154,22440,163714,12.054535492119427,87.94546450788057,Entertainment
98357,1789,96568,1.8188842685319804,98.18111573146801,Transportation
30852,23057,7795,74.73421496175288,25.265785038247113,Food
22502,21777,725,96.7780641720736,3.2219358279264068,Housing
39589,12061,27528,30.465533355224938,69.53446664477507,Food
162394,29190,133204,17.974802024705347,82.02519797529465,Entertainment
81360,21498,59862,26.42330383480826,73.57669616519173,Transportation
43208,5147,38061,11.91214589890761,88.08785410109239,Food
172771,33887,138884,19.61382407927256,80.38617592072742,Entertainment
25308,24121,1187,95.3097834676782,4.690216532321796,Food
13624,7461,6163,54.763652378156195,45.236347621843805,Housing
52691,36859,15832,69.95312292421856,30.046877075781442,Transportation
135534,24175,111359,17.83685274543657,82.16314725456343,Healthcare
131341,11573,119768,8.811414562094091,91.18858543790591,Healthcare
77914,10567,67347,13.562389301024206,86.4376106989758,Transportation
197854,20932,176922,10.579518230614493,89.4204817693855,Entertainment
74880,11966,62914,15.98023504273504,84.01976495726495,Transportation
44661,15613,29048,34.958912697879576,65.04108730212042,Food
21500,20454,1046,95.13488372093023,4.865116279069767,Housing
42872,37777,5095,88.11578652733719,11.884213472662811,Food
159781,22706,137075,14.210700896852568,85.78929910314743,Entertainment
16326,3644,12682,22.32022540732574,77.67977459267426,Housing
109281,40449,68832,37.01375353446619,62.98624646553381,Healthcare
173844,21053,152791,12.110282782264559,87.88971721773544,Entertainment
50841,13873,36968,27.287032119745874,72.71296788025413,Transportation
92664,31738,60926,34.25062591729258,65.74937408270742,Transportation
162560,42741,119819,26.292445866141733,73.70755413385827,Entertainment
18748,8024,10724,42.799231918071264,57.20076808192874,Housing
180030,13487,166543,7.491529189579514,92.50847081042049,Entertainment
41132,10770,30362,26.183992998152288,73.81600700184771,Food
79363,27315,52048,34.41780174640576,65.58219825359424,Transportation
107866,16557,91309,15.34960043016335,84.65039956983665,Healthcare
153043,30241,122802,19.75980606757578,80.24019393242422,Entertainment
173280,26570,146710,15.333564173591874,84.66643582640813,Entertainment
18701,919,17782,4.914175712528742,95.08582428747125,Housing
174090,7626,166464,4.380492848526624,95.61950715147337,Entertainment
165820,1528,164292,0.9214811241104813,99.07851887588951,Entertainment
116389,47137,69252,40.49953174269046,59.500468257309535,Healthcare
144329,16772,127557,11.62067221417733,88.37932778582267,Healthcare
72492,24188,48304,33.3664404348066,66.6335595651934,Transportation
198992,32874,166118,16.520262121090294,83.47973787890972,Entertainment
72672,1409,71263,1.938848524878908,98.0611514751211,Transportation
14588,8616,5972,59.062242939402246,40.937757060597754,Housing
9125,1529,7596,16.756164383561647,83.24383561643836,Housing
103550,18693,84857,18.052148720424917,81.94785127957508,Healthcare
8987,3321,5666,36.95337710025592,63.04662289974408,Housing
106819,14101,92718,13.200835057433602,86.79916494256639,Healthcare
105892,35844,70048,33.84958259358592,66.15041740641409,Healthcare
54612,9372,45240,17.161063502526915,82.83893649747309,Transportation
106618,21534,85084,20.197340036391605,79.80265996360839,Healthcare
50256,1502,48754,2.988697866921363,97.01130213307863,Transportation
75558,38191,37367,50.5452764763493,49.454723523650706,Transportation
184023,15667,168356,8.513609711829499,91.48639028817051,Entertainment
170512,10119,160393,5.9344796847142725,94.06552031528572,Entertainment
19590,10886,8704,55.56916794282797,44.430832057172026,Housing
99113,42459,56654,42.83898176828468,57.16101823171531,Transportation
108303,12907,95396,11.917490743562045,88.08250925643796,Healthcare
184815,19605,165210,10.607905202499797,89.39209479750019,Entertainment
70813,29669,41144,41.897674155875336,58.10232584412467,Transportation
36453,21598,14855,59.24889583847695,40.75110416152305,Food
12557,2179,10378,17.352870908656527,82.64712909134347,Housing
39807,1848,37959,4.642399577963674,95.35760042203633,Food
90959,30160,60799,33.15779636979298,66.84220363020702,Transportation
62810,14855,47955,23.650692564878202,76.34930743512179,Transportation
158412,9586,148826,6.051309244249173,93.94869075575083,Entertainment
78556,6398,72158,8.144508376190233,91.85549162380977,Transportation
66494,3632,62862,5.462146960628027,94.53785303937198,Transportation
11762,9768,1994,83.04710083319164,16.952899166808365,Housing
80032,49573,30459,61.94147341063575,38.058526589364256,Transportation
110808,17738,93070,16.007869467908453,83.99213053209155,Healthcare
123661,2395,121266,1.9367464277338855,98.06325357226612,Healthcare
23020,22495,525,97.71937445699392,2.2806255430060816,Housing
42398,41787,611,98.55889428746639,1.44110571253361,Food
35653,12454,23199,34.9311418393964,65.0688581606036,Food
45909,6509,39400,14.17804787732253,85.82195212267747,Food
92726,45723,47003,49.309794448159096,50.690205551840904,Transportation
18720,1169,17551,6.244658119658119,93.75534188034187,Housing
158168,12816,145352,8.102776794294673,91.89722320570533,Entertainment
72450,44028,28422,60.77018633540373,39.22981366459627,Transportation
30270,23327,6943,77.06309877766766,22.93690122233234,Food
25932,13128,12804,50.62471078204535,49.37528921795465,Food
15193,4976,10217,32.751925228723756,67.24807477127625,Housing
44174,23989,20185,54.305700185629554,45.694299814370446,Food
22069,2849,19220,12.909511078888938,87.09048892111106,Housing
69252,46566,22686,67.24137931034483,32.758620689655174,Transportation
45872,14645,31227,31.925793512382285,68.07420648761772,Food
10421,7119,3302,68.31398138374436,31.68601861625564,Housing
143076,28804,114272,20.131957840588218,79.86804215941177,Healthcare
80986,28287,52699,34.928259205294744,65.07174079470526,Transportation
10071,8595,1476,85.34405719392315,14.655942806076855,Housing
134470,8496,125974,6.318137874618874,93.68186212538112,Healthcare
49295,31730,17565,64.36758291916016,35.63241708083984,Food
13686,9242,4444,67.52886161040479,32.471138389595204,Housing
19281,13917,5364,72.17986618951299,27.820133810487008,Housing
156095,39113,116982,25.057176719305552,74.94282328069445,Entertainment
83838,5263,78575,6.277582957608721,93.72241704239129,Transportation
33720,4886,28834,14.489916963226571,85.51008303677344,Food
64964,11580,53384,17.825257065451634,82.17474293454836,Transportation
176039,36622,139417,20.803344713387375,79.19665528661262,Entertainment
154961,33556,121405,21.65448080484767,78.34551919515232,Entertainment
124510,22244,102266,17.865231708296523,82.13476829170348,Healthcare
103189,25669,77520,24.87571349659363,75.12428650340637,Healthcare
151240,6566,144674,4.34144406241735,95.65855593758265,Entertainment
175413,13181,162232,7.51426633145776,92.48573366854224,Entertainment
50566,38773,11793,76.67800498358581,23.321995016414192,Transportation
36089,35871,218,99.39593782038848,0.604062179611516,Food
57408,17254,40154,30.05504459308807,69.94495540691193,Transportation
24386,14005,10381,57.430492905765604,42.569507094234396,Housing
165578,27190,138388,16.42126369445216,83.57873630554784,Entertainment
108585,27766,80819,25.570751024542986,74.42924897545701,Healthcare
107897,28133,79764,26.073940888069174,73.92605911193083,Healthcare
26538,17138,9400,64.57909412917327,35.42090587082674,Food
144421,37710,106711,26.11116111922781,73.88883888077218,Healthcare
46940,24338,22602,51.84916915210908,48.15083084789092,Food
9137,4117,5020,45.058553135602494,54.941446864397506,Housing
20891,4777,16114,22.8663060648126,77.1336939351874,Housing
59629,329,59300,0.5517449563132033,99.4482550436868,Transportation
42417,36110,6307,85.13096164273757,14.869038357262419,Food
35165,10450,24715,29.717048201336553,70.28295179866345,Food
14154,5420,8734,38.29306203193443,61.70693796806557,Housing
83726,7146,76580,8.534983159353128,91.46501684064687,Transportation
16734,845,15889,5.049599617545118,94.95040038245489,Housing
196645,23088,173557,11.740954511937755,88.25904548806224,Entertainment
98890,33099,65791,33.47052280311457,66.52947719688544,Transportation
160294,9332,150962,5.821802438020137,94.17819756197986,Entertainment
44643,10789,33854,24.16728266469547,75.83271733530452,Food
124253,24003,100250,19.317843432351733,80.68215656764826,Healthcare
153313,45833,107480,29.89505130028112,70.10494869971888,Entertainment
44622,32826,11796,73.56460938550491,26.43539061449509,Food
17302,7429,9873,42.93723268986244,57.06276731013755,Housing
161664,36345,125319,22.481814133016627,77.51818586698337,Entertainment
14439,6401,8038,44.33132488399474,55.66867511600526,Housing
11738,2469,9269,21.034247742375193,78.96575225762481,Housing
94292,43989,50303,46.651889874008404,53.348110125991596,Transportation
16244,14743,1501,90.75966510711648,9.240334892883526,Housing
198708,49028,149680,24.673390100046298,75.3266098999537,Entertainment
72685,34493,38192,47.45545848524455,52.54454151475545,Transportation
165495,45166,120329,27.29145895646394,72.70854104353606,Entertainment
58096,37909,20187,65.25234095290554,34.747659047094466,Transportation
34222,2671,31551,7.804920811174099,92.1950791888259,Food
199614,11093,188521,5.557225445109061,94.44277455489095,Entertainment
199243,3372,195871,1.6924057557856487,98.30759424421434,Entertainment
144864,19416,125448,13.402915838303512,86.59708416169649,Healthcare
10179,9596,583,94.27252185872875,5.727478141271244,Housing
31829,24746,7083,77.74670897609099,22.253291023909014,Food
176041,46110,129931,26.192761913417893,73.8072380865821,Entertainment
64926,21251,43675,32.73110926285309,67.2688907371469,Transportation
47786,12817,34969,26.821663248650236,73.17833675134978,Food
65766,31127,34639,47.32992731806709,52.67007268193291,Transportation
62538,22419,40119,35.848604048738366,64.15139595126163,Transportation
90413,44716,45697,49.45748952031234,50.54251047968765,Transportation
133432,37436,95996,28.05623838359614,71.94376161640386,Healthcare
168840,27410,141430,16.234304667140485,83.76569533285951,Entertainment
186432,129,186303,0.06919412976313079,99.93080587023687,Entertainment
19494,1306,18188,6.699497281214732,93.30050271878527,Housing
110223,23786,86437,21.579888045144845,78.42011195485516,Healthcare
10027,2695,7332,26.877430936471526,73.12256906352847,Housing
36269,17369,18900,47.88938211695939,52.11061788304061,Food
28093,20543,7550,73.12497775246503,26.875022247534975,Food
144764,20765,123999,14.344035810008013,85.65596418999199,Healthcare
169110,3497,165613,2.0678848087043935,97.93211519129561,Entertainment
91925,43242,48683,47.040522164808266,52.959477835191734,Transportation
85056,44725,40331,52.583004138449965,47.416995861550035,Transportation
85362,10315,75047,12.0838312129519,87.9161687870481,Transportation
101470,7292,94178,7.186360500640583,92.81363949935941,Healthcare
100023,1128,98895,1.1277406196574788,98.87225938034251,Healthcare
41893,9484,32409,22.638626978254123,77.36137302174588,Food
129666,27157,102509,20.943809479740256,79.05619052025973,Healthcare
41849,20855,20994,49.83392673660064,50.16607326339937,Food
109841,37080,72761,33.75788639943191,66.2421136005681,Healthcare
174195,46861,127334,26.901461006343464,73.09853899365653,Entertainment
48989,15470,33519,31.578517626405926,68.42148237359407,Food
174512,33427,141085,19.154556706702117,80.84544329329788,Entertainment
37582,15997,21585,42.56558991006333,57.43441008993667,Food
56806,16788,40018,29.553216209555327,70.44678379044467,Transportation
164782,39865,124917,24.19256957677416,75.80743042322584,Entertainment
171789,20501,151288,11.933825797926525,88.06617420207348,Entertainment
17833,7896,9937,44.277463130151965,55.722536869848035,Housing
165061,27437,137624,16.6223396198981,83.3776603801019,Entertainment
135791,21649,114142,15.942882812557531,84.05711718744246,Healthcare
173534,45897,127637,26.44841932992958,73.55158067007042,Entertainment
198217,25041,173176,12.633124303162695,87.36687569683731,Entertainment
62756,865,61891,1.3783542609471604,98.62164573905284,Transportation
87444,11803,75641,13.497781437262704,86.5022185627373,Transportation
53000,44070,8930,83.15094339622642,16.849056603773587,Transportation
136835,33715,103120,24.639163956590053,75.36083604340995,Healthcare
46634,32463,14171,69.61230003859845,30.387699961401555,Food
32280,23915,8365,74.08612143742255,25.913878562577448,Food
53984,39452,14532,73.08091286307054,26.91908713692946,Transportation
42491,16508,25983,38.85058012284954,61.14941987715046,Food
63834,2970,60864,4.65269292226713,95.34730707773286,Transportation
132020,3145,128875,2.382214815936979,97.61778518406302,Healthcare
196026,23563,172463,12.02034424004979,87.97965575995022,Entertainment
113306,24398,88908,21.53284027324237,78.46715972675763,Healthcare
189138,47568,141570,25.149890556101894,74.8501094438981,Entertainment
86075,35670,50405,41.44060412431019,58.5593958756898,Transportation
10850,165,10685,1.5207373271889402,98.47926267281106,Housing
179482,31681,147801,17.65135222473563,82.34864777526437,Entertainment
179474,13679,165795,7.621716794633206,92.3782832053668,Entertainment
118241,17910,100331,15.147030217944707,84.8529697820553,Healthcare
152224,35337,116887,23.213816480975407,76.7861835190246,Entertainment
53259,31629,21630,59.387145834506846,40.612854165493154,Transportation
100028,8660,91368,8.65757587875395,91.34242412124604,Healthcare
8077,7577,500,93.80958276587842,6.19041723412158,Housing
17337,13659,3678,78.78525696487281,21.214743035127185,Housing
22683,670,22013,2.953753912621787,97.04624608737821,Housing
14640,11779,2861,80.45765027322405,19.542349726775956,Housing
159146,23042,136104,14.478529149334573,85.52147085066542,Entertainment
41344,23866,17478,57.72542569659442,42.27457430340557,Food
100948,20505,80443,20.31243808693585,79.68756191306416,Healthcare
71696,46156,25540,64.37737112251729,35.622628877482704,Transportation
75652,35757,39895,47.265108655422196,52.734891344577804,Transportation
33489,15574,17915,46.50482247902296,53.49517752097703,Food
108916,13898,95018,12.76029233537772,87.23970766462227,Healthcare
23504,3719,19785,15.82283866575902,84.17716133424098,Housing
97929,3414,94515,3.4861991851239162,96.51380081487608,Transportation
128875,20096,108779,15.593404461687681,84.40659553831232,Healthcare
8569,5442,3127,63.50799393161396,36.49200606838604,Housing
30403,22047,8356,72.51587014439365,27.484129855606355,Food
139995,886,139109,0.6328797457052038,99.36712025429479,Healthcare
112318,2175,110143,1.9364661051656902,98.06353389483431,Healthcare
19246,13790,5456,71.65125220825107,28.348747791748934,Housing
25075,20541,4534,81.91824526420739,18.08175473579262,Food
150020,33443,116577,22.292361018530862,77.70763898146915,Entertainment
176535,2369,174166,1.3419435239470927,98.6580564760529,Entertainment
122162,27738,94424,22.705915096347475,77.29408490365253,Healthcare
57379,46359,11020,80.79436727722687,19.20563272277314,Transportation
28072,16939,11133,60.34126531775434,39.65873468224566,Food
17067,4713,12354,27.614695025487784,72.38530497451222,Housing
39344,20142,19202,51.194591297275316,48.805408702724684,Food
134362,14758,119604,10.98376028936753,89.01623971063248,Healthcare
13039,4897,8142,37.55656108597285,62.44343891402715,Housing
28202,20563,7639,72.9132685625133,27.086731437486705,Food
158907,9868,149039,6.209921526427407,93.79007847357259,Entertainment
79509,12676,66833,15.942849237193274,84.05715076280673,Transportation
18457,10380,8077,56.2388253779054,43.7611746220946,Housing
139843,3996,135847,2.8574901854222237,97.14250981457778,Healthcare
180946,12939,168007,7.150752158102418,92.84924784189758,Entertainment
13782,6257,7525,45.39979683645334,54.60020316354666,Housing
31720,28702,3018,90.48549810844892,9.514501891551072,Food
18651,935,17716,5.013136024878023,94.98686397512198,Housing
117825,36394,81431,30.888181625291743,69.11181837470825,Healthcare
86559,15659,70900,18.09055095368477,81.90944904631523,Transportation
112824,29986,82838,26.57767850811884,73.42232149188116,Healthcare
84580,44871,39709,53.05154882951052,46.94845117048948,Transportation
52553,45987,6566,87.50594637794227,12.494053622057733,Transportation
143564,18361,125203,12.789417959934246,87.21058204006576,Healthcare
10336,5373,4963,51.98335913312694,48.01664086687307,Housing
138486,2696,135790,1.9467671822422483,98.05323281775775,Healthcare
16548,7186,9362,43.42518733381678,56.57481266618323,Housing
30899,18395,12504,59.53267096022525,40.467329039774754,Food
19873,17674,2199,88.93473557087506,11.065264429124944,Housing
157711,38560,119151,24.449784732834107,75.55021526716588,Entertainment
36797,25988,10809,70.6253227165258,29.3746772834742,Food
170271,22615,147656,13.281768474960504,86.71823152503949,Entertainment
114867,30472,84395,26.52807159584563,73.47192840415437,Healthcare
115792,14372,101420,12.411911012850629,87.58808898714938,Healthcare
159984,35371,124613,22.10908590859086,77.89091409140913,Entertainment
133072,5067,128005,3.807713117710713,96.1922868822893,Healthcare
26986,14252,12734,52.81256948047136,47.18743051952865,Food
16490,956,15534,5.797453001819284,94.20254699818071,Housing
14019,13794,225,98.3950353092232,1.6049646907768027,Housing
10368,6655,3713,64.18788580246914,35.81211419753087,Housing
38599,28807,9792,74.6314671364543,25.36853286354569,Food
195021,29236,165785,14.99120607524318,85.00879392475682,Entertainment
50561,1312,49249,2.594885385969423,97.40511461403058,Transportation
9828,7909,1919,80.47415547415547,19.525844525844526,Housing
111086,15008,96078,13.510253317249699,86.48974668275031,Healthcare
127610,49222,78388,38.57221220907452,61.42778779092548,Healthcare
25229,24746,483,98.08553648579016,1.9144635142098378,Food
24500,2433,22067,9.930612244897958,90.06938775510204,Housing
67258,16682,50576,24.802997412947157,75.19700258705284,Transportation
9735,8258,1477,84.82794042116076,15.172059578839239,Housing
43935,36993,6942,84.19938545578695,15.800614544213044,Food
119360,8698,110662,7.287198391420911,92.71280160857908,Healthcare
103647,42816,60831,41.30944455700599,58.69055544299401,Healthcare
189104,31147,157957,16.47083086555546,83.52916913444453,Entertainment
148116,24070,124046,16.25077641848281,83.74922358151719,Healthcare
13495,9900,3595,73.36050389032975,26.639496109670247,Housing
34703,26535,8168,76.46312998876178,23.53687001123822,Food
42357,27386,14971,64.65519276624879,35.344807233751204,Food
116651,26014,90637,22.30070895234503,77.69929104765497,Healthcare
172779,43130,129649,24.962524380856472,75.03747561914354,Entertainment
118729,33387,85342,28.120341281405555,71.87965871859444,Healthcare
176302,49314,126988,27.97132193622307,72.02867806377694,Entertainment
90776,48671,42105,53.616594694632944,46.383405305367056,Transportation
134722,45499,89223,33.77250931547928,66.22749068452072,Healthcare
69933,38931,31002,55.66899746900605,44.33100253099395,Transportation
172344,13003,159341,7.5447941326649035,92.4552058673351,Entertainment
20812,15599,5213,74.95195079761676,25.04804920238324,Housing
9538,3408,6130,35.73076116586286,64.26923883413713,Housing
162397,27881,134516,17.16842059890269,82.83157940109731,Entertainment
174266,48192,126074,27.65427564757325,72.34572435242676,Entertainment
157598,30320,127278,19.23882282770086,80.76117717229914,Entertainment
157078,1971,155107,1.254790613580514,98.74520938641949,Entertainment
27740,940,26800,3.3886085075702956,96.6113914924297,Food
138312,24709,113603,17.864682746254847,82.13531725374516,Healthcare
47623,16645,30978,34.951599017281566,65.04840098271843,Food
162877,18055,144822,11.08505191033725,88.91494808966274,Entertainment
20168,5448,14720,27.013090043633483,72.98690995636652,Housing
20356,195,20161,0.9579485164079388,99.04205148359206,Housing
93729,13535,80194,14.440568020569941,85.55943197943006,Transportation
17018,1500,15518,8.814196732871078,91.18580326712892,Housing
154050,41057,112993,26.651736449204805,73.3482635507952,Entertainment
94773,30554,64219,32.23913983940574,67.76086016059426,Transportation
103082,23021,80061,22.332706001047708,77.66729399895229,Healthcare
198465,28368,170097,14.293704179578262,85.70629582042174,Entertainment
186254,21181,165073,11.372104760166224,88.62789523983378,Entertainment
160373,41148,119225,25.65768552063003,74.34231447936996,Entertainment
77747,10057,67690,12.935547352309415,87.06445264769059,Transportation
141350,40512,100838,28.660771135479308,71.33922886452069,Healthcare
152986,43585,109401,28.489534990129815,71.51046500987019,Entertainment
69185,14799,54386,21.390474813904746,78.60952518609525,Transportation
158952,7014,151938,4.412652876340027,95.58734712365997,Entertainment
195168,28645,166523,14.67709870470569,85.3229012952943,Entertainment
60639,38596,22043,63.64880687346427,36.35119312653573,Transportation
28728,13732,14996,47.80005569479254,52.19994430520747,Food
16036,15394,642,95.99650785732102,4.003492142678972,Housing
9531,7576,1955,79.48798657013954,20.512013429860456,Housing
41886,26708,15178,63.763548679749796,36.236451320250204,Food
107772,41335,66437,38.35411795271499,61.645882047285006,Healthcare
146758,35510,111248,24.19629594298096,75.80370405701903,Healthcare
105401,39643,65758,37.61159761292588,62.38840238707412,Healthcare
36469,32922,3547,90.27393128410431,9.72606871589569,Food
93095,43314,49781,46.526666308609485,53.473333691390515,Transportation
187740,8389,179351,4.468413763715777,95.53158623628423,Entertainment
42394,34318,8076,80.95013445298864,19.04986554701137,Food
155903,1222,154681,0.7838207090306151,99.2161792909694,Entertainment
33580,3121,30459,9.29422275163788,90.70577724836212,Food
111044,19853,91191,17.87849861316235,82.12150138683765,Healthcare
168406,2821,165585,1.6751184637126943,98.32488153628731,Entertainment
29493,9730,19763,32.9908791916726,67.00912080832741,Food
10539,7056,3483,66.95132365499573,33.04867634500427,Housing
9116,492,8624,5.3971039929793765,94.60289600702062,Housing
160848,3236,157612,2.011837262508704,97.9881627374913,Entertainment
13355,4968,8387,37.19955073006365,62.80044926993635,Housing
172460,40658,131802,23.575321813753913,76.42467818624608,Entertainment
24456,21856,2600,89.3686620870134,10.631337912986588,Housing
132736,7245,125491,5.45820274831244,94.54179725168757,Healthcare
84077,49538,34539,58.919799707411066,41.080200292588934,Transportation
18177,9882,8295,54.36540683281069,45.63459316718931,Housing
29142,23350,5792,80.12490563447945,19.875094365520553,Food
81825,37405,44420,45.713412771157955,54.286587228842045,Transportation
19577,11763,7814,60.085814986974505,39.91418501302549,Housing
165635,39499,126136,23.84701301053521,76.1529869894648,Entertainment
94707,4023,90684,4.247838068991732,95.75216193100827,Transportation
119018,3890,115128,3.2684131811994823,96.73158681880052,Healthcare
37389,29332,8057,78.45088127524139,21.54911872475862,Food
117106,18547,98559,15.837787986951993,84.162212013048,Healthcare
137390,47700,89690,34.7186840381396,65.2813159618604,Healthcare
50592,6277,44315,12.407099936748892,87.59290006325111,Transportation
33515,14287,19228,42.62867372818141,57.37132627181859,Food
33922,10310,23612,30.393255114674844,69.60674488532516,Food
50560,8308,42252,16.431962025316455,83.56803797468353,Transportation
10424,9256,1168,88.79508825786647,11.204911742133538,Housing
131821,48175,83646,36.54577040077074,63.454229599229265,Healthcare
32777,8997,23780,27.449125911462307,72.5508740885377,Food
127220,36182,91038,28.440496777236284,71.55950322276372,Healthcare
35590,1657,33933,4.6558021916268615,95.34419780837314,Food
119623,13536,106087,11.315549685261196,88.68445031473881,Healthcare
45954,19128,26826,41.62423292858076,58.37576707141925,Food
12799,686,12113,5.35979373388546,94.64020626611453,Housing
137118,14456,122662,10.54274420572062,89.45725579427938,Healthcare
126869,38187,88682,30.09955150588402,69.90044849411598,Healthcare
10050,1165,8885,11.592039800995025,88.40796019900498,Housing
116483,33293,83190,28.58185314595263,71.41814685404736,Healthcare
164202,16289,147913,9.92009841536644,90.07990158463356,Entertainment
45259,20914,24345,46.20959367197685,53.79040632802315,Food
32385,22433,9952,69.26972363748649,30.730276362513507,Food
199560,693,198867,0.3472639807576669,99.65273601924234,Entertainment
137318,33362,103956,24.295431043271822,75.70456895672818,Healthcare
93643,24829,68814,26.51452858195487,73.48547141804514,Transportation
22394,22010,384,98.28525497901224,1.7147450209877644,Housing
157164,2470,154694,1.5716067292764246,98.42839327072357,Entertainment
183965,16462,167503,8.948441279591227,91.05155872040878,Entertainment
12748,4849,7899,38.03733919046125,61.96266080953875,Housing
48489,39008,9481,80.44711171605931,19.552888283940685,Food
161435,14548,146887,9.01167652615604,90.98832347384396,Entertainment
60074,37251,22823,62.00852282185305,37.99147717814695,Transportation
27934,15187,12747,54.36743753132384,45.63256246867616,Food
112878,9982,102896,8.843175818139938,91.15682418186006,Healthcare
36060,3516,32544,9.750415973377704,90.2495840266223,Food
43611,23590,20021,54.09185755887276,45.90814244112724,Food
96793,44768,52025,46.25127850154453,53.74872149845547,Transportation
160529,999,159530,0.6223174628883255,99.37768253711168,Entertainment
118444,9290,109154,7.843369018270237,92.15663098172976,Healthcare
99811,4761,95050,4.770015328971756,95.22998467102825,Transportation
91004,49306,41698,54.18003604237176,45.81996395762823,Transportation
48716,44172,4544,90.67246900402331,9.32753099597668,Food
116864,31499,85365,26.953552847754654,73.04644715224534,Healthcare
51196,34012,17184,66.43487772482224,33.56512227517775,Transportation
99951,37696,62255,37.71448009524667,62.28551990475333,Transportation
137191,26014,111177,18.96188525486366,81.03811474513634,Healthcare
155705,1776,153929,1.1406184772486432,98.85938152275135,Entertainment
21490,17589,3901,81.84737087017217,18.152629129827826,Housing
30553,627,29926,2.0521716361732074,97.9478283638268,Food
88961,43535,45426,48.93717471701082,51.06282528298918,Transportation
120774,33939,86835,28.101246957126534,71.89875304287347,Healthcare
45277,33367,11910,73.69525366079908,26.304746339200918,Food
9685,769,8916,7.9401135776974705,92.05988642230253,Housing
31074,2542,28532,8.180472420673231,91.81952757932676,Food
126468,49982,76486,39.52145997406459,60.47854002593541,Healthcare
169193,3331,165862,1.968757572712819,98.03124242728718,Entertainment
92609,12931,79678,13.963005755380149,86.03699424461986,Transportation
78709,35459,43250,45.050756584380444,54.94924341561956,Transportation
180809,8172,172637,4.519686520029423,95.48031347997058,Entertainment
61573,43066,18507,69.94299449434006,30.05700550565995,Transportation
97704,24399,73305,24.972365512159175,75.02763448784083,Transportation
29655,28635,1020,96.56044511886697,3.43955488113303,Food
134020,42062,91958,31.384867930159675,68.61513206984033,Healthcare
11278,7296,3982,64.69232133356978,35.30767866643022,Housing
139777,3324,136453,2.3780736458787928,97.6219263541212,Healthcare
158827,23371,135456,14.714752529481764,85.28524747051823,Entertainment
29622,26061,3561,87.97852947133887,12.021470528661132,Food
8593,4839,3754,56.31327824973816,43.68672175026184,Housing
21705,8652,13053,39.861782999308915,60.138217000691085,Housing
130833,45891,84942,35.076012932517024,64.92398706748298,Healthcare
17496,3300,14196,18.86145404663923,81.13854595336076,Housing
21288,18889,2399,88.73074032318678,11.26925967681323,Housing
46134,39339,6795,85.2711666016387,14.728833398361296,Food
177051,34269,142782,19.35543995797821,80.6445600420218,Entertainment
92833,15003,77830,16.161278855579372,83.83872114442063,Transportation
154390,49703,104687,32.19314722456117,67.80685277543881,Entertainment
63451,9491,53960,14.95799908590881,85.04200091409119,Transportation
181237,1244,179993,0.6863940586083416,99.31360594139166,Entertainment
101660,37930,63730,37.310643320873496,62.6893566791265,Healthcare
44786,23831,20955,53.21082481132496,46.78917518867503,Food
186215,21545,164670,11.569959455468142,88.43004054453186,Entertainment
141401,19641,121760,13.890283661360245,86.10971633863976,Healthcare
29824,26852,2972,90.0348712446352,9.965128755364807,Food
20473,9461,11012,46.21208420846969,53.7879157915303,Housing
119326,271,119055,0.22710892848163852,99.77289107151836,Healthcare
47641,14308,33333,30.03295480783359,69.96704519216641,Food
13755,10825,2930,78.69865503453289,21.301344965467102,Housing
123178,46253,76925,37.54972478851743,62.45027521148258,Healthcare
133683,18228,115455,13.635241578959178,86.36475842104082,Healthcare
41656,8334,33322,20.006721720760513,79.99327827923949,Food
114326,35892,78434,31.394433462204574,68.60556653779543,Healthcare
97969,26519,71450,27.068766650675215,72.93123334932478,Transportation
148024,8884,139140,6.001729449278495,93.99827055072151,Healthcare
73672,16450,57222,22.32870018460202,77.67129981539797,Transportation
126540,3307,123233,2.6134028765607713,97.38659712343923,Healthcare
10023,4966,5057,49.54604409857328,50.45395590142672,Housing
116877,37532,79345,32.112391659607965,67.88760834039203,Healthcare
179413,31835,147578,17.743976189016404,82.25602381098359,Entertainment
66183,41580,24603,62.82580118761616,37.17419881238385,Transportation
45436,18581,26855,40.89488511312616,59.10511488687384,Food
131095,22187,108908,16.924367824859836,83.07563217514017,Healthcare
154753,24507,130246,15.836203498478222,84.16379650152179,Entertainment
74784,46716,28068,62.467907573812575,37.53209242618742,Transportation
46570,6411,40159,13.766373201631952,86.23362679836805,Food
161629,42032,119597,26.005234209207508,73.9947657907925,Entertainment
25808,24762,1046,95.94699318040918,4.053006819590824,Food
23924,16523,7401,69.06453770272529,30.9354622972747,Housing
11430,4435,6995,38.80139982502187,61.198600174978125,Housing
60586,48230,12356,79.60584953619649,20.394150463803516,Transportation
194845,21007,173838,10.78139033590803,89.21860966409197,Entertainment
69477,3044,66433,4.381306043726701,95.6186939562733,Transportation
11900,6677,5223,56.109243697478995,43.890756302521005,Housing
87068,17357,69711,19.934993338539993,80.06500666146,Transportation
198275,44277,153998,22.331105787416465,77.66889421258352,Entertainment
45122,26287,18835,58.25761269447276,41.74238730552724,Food
185695,7975,177720,4.294676754893778,95.70532324510623,Entertainment
186164,49592,136572,26.638877548827917,73.3611224511721,Entertainment
82127,43372,38755,52.810890450156464,47.189109549843536,Transportation
39133,13304,25829,33.99688242659648,66.00311757340353,Food
22257,14486,7771,65.08514175315631,34.914858246843686,Housing
104330,22551,81779,21.6150675740439,78.3849324259561,Healthcare
123799,13565,110234,10.957277522435561,89.04272247756444,Healthcare
63249,33187,30062,52.47039478885041,47.52960521114959,Transportation
145292,17093,128199,11.764584423092806,88.2354155769072,Healthcare
130307,1934,128373,1.4841873421995748,98.51581265780042,Healthcare
24363,19604,4759,80.46628083569347,19.533719164306532,Housing
25727,6697,19030,26.03101799665721,73.96898200334279,Food
174257,25052,149205,14.376466942504463,85.62353305749554,Entertainment
122788,14776,108012,12.03374922630876,87.96625077369123,Healthcare
33794,1620,32174,4.793750369888146,95.20624963011186,Food
27396,24604,2792,89.80873120163527,10.191268798364725,Food
157289,44034,113255,27.995600455213015,72.00439954478699,Entertainment
20180,234,19946,1.1595639246778988,98.8404360753221,Housing
94477,33927,60550,35.9103273812674,64.0896726187326,Transportation
167546,17413,150133,10.392966707650436,89.60703329234956,Entertainment
55329,3621,51708,6.544488423792225,93.45551157620777,Transportation
64606,17463,47143,27.029997213881064,72.97000278611894,Transportation
46401,6533,39868,14.079437943147777,85.92056205685222,Food
115862,26171,89691,22.58807892147555,77.41192107852444,Healthcare
57044,41473,15571,72.70352710188627,27.296472898113738,Transportation
26882,269,26613,1.0006695930362324,98.99933040696376,Food
110886,7434,103452,6.704182674097722,93.29581732590228,Healthcare
133933,33387,100546,24.92813570964587,75.07186429035413,Healthcare
14960,3004,11956,20.080213903743317,79.91978609625669,Housing
191774,16786,174988,8.753011357118275,91.24698864288172,Entertainment
57690,3567,54123,6.183047321892875,93.81695267810713,Transportation
159051,48976,110075,30.7926388391145,69.20736116088551,Entertainment
25557,13393,12164,52.40442931486481,47.595570685135186,Food
157552,49258,108294,31.26459835482888,68.73540164517112,Entertainment
104644,5056,99588,4.831619586407247,95.16838041359276,Healthcare
111664,38523,73141,34.49903281272388,65.50096718727612,Healthcare
140623,39531,101092,28.111333138960198,71.8886668610398,Healthcare
174799,863,173936,0.49370991824896027,99.50629008175103,Entertainment
101635,40878,60757,40.2203965169479,59.7796034830521,Healthcare
136745,14205,122540,10.387948371055614,89.61205162894439,Healthcare
133650,34828,98822,26.05910961466517,73.94089038533484,Healthcare
124893,43675,81218,34.969934263729755,65.03006573627025,Healthcare
157016,44885,112131,28.586258725225456,71.41374127477455,Entertainment
162135,10782,151353,6.650013877324453,93.34998612267555,Entertainment
72581,14855,57726,20.466788829032392,79.5332111709676,Transportation
89575,43284,46291,48.321518280770306,51.678481719229694,Transportation
90392,10327,80065,11.424683600318613,88.5753163996814,Transportation
11596,11475,121,98.9565367368058,1.043463263194205,Housing
24140,922,23218,3.819386909693455,96.18061309030654,Housing
26882,6799,20083,25.292016963023585,74.70798303697642,Food
149980,25465,124515,16.978930524069877,83.02106947593012,Healthcare
21237,18579,2658,87.48410792484815,12.515892075151857,Housing
46112,14670,31442,31.813844552394173,68.18615544760583,Food
105286,7370,97916,6.999981004122105,93.0000189958779,Healthcare
31094,23088,8006,74.25226731845372,25.74773268154628,Food
99730,45765,53965,45.88890003008122,54.11109996991878,Transportation
100212,18098,82114,18.059713407575938,81.94028659242406,Healthcare
39408,32006,7402,81.21701177425903,18.782988225740965,Food
73525,7065,66460,9.608976538592316,90.39102346140768,Transportation
63407,19781,43626,31.19687100793288,68.80312899206712,Transportation
142608,27621,114987,19.368478626725008,80.63152137327499,Healthcare
79893,7973,71920,9.97959771193972,90.02040228806028,Transportation
122758,37234,85524,30.331220775835384,69.66877922416461,Healthcare
196043,14297,181746,7.292787806756682,92.70721219324332,Entertainment
49252,20648,28604,41.923170632664664,58.076829367335336,Food
108499,8131,100368,7.494078286435819,92.50592171356418,Healthcare
152077,37555,114522,24.69472701328932,75.30527298671068,Entertainment
183713,24604,159109,13.39262871979664,86.60737128020337,Entertainment
170616,3576,167040,2.0959347306231537,97.90406526937684,Entertainment
78413,18171,60242,23.173453381454607,76.8265466185454,Transportation
8097,3215,4882,39.706063974311476,60.293936025688524,Housing
138175,11432,126743,8.273566129907724,91.72643387009228,Healthcare
136946,39979,96967,29.193258656696802,70.8067413433032,Healthcare
183539,27115,156424,14.773426901094592,85.2265730989054,Entertainment
9708,3630,6078,37.39184177997528,62.60815822002472,Housing
103405,37260,66145,36.03307383588801,63.966926164111996,Healthcare
165437,21815,143622,13.186288436081409,86.81371156391859,Entertainment
169142,29696,139446,17.556845727258754,82.44315427274125,Entertainment
178914,45217,133697,25.27303620733984,74.72696379266016,Entertainment
172543,42733,129810,24.7665799250042,75.23342007499579,Entertainment
109471,49617,59854,45.32433247161349,54.67566752838652,Healthcare
174147,6846,167301,3.9311616048510736,96.06883839514893,Entertainment
24173,13178,10995,54.515368386216025,45.48463161378397,Housing
37459,14536,22923,38.80509356896874,61.19490643103126,Food
47367,28557,18810,60.28880866425993,39.71119133574007,Food
134190,5765,128425,4.296147253893732,95.70385274610626,Healthcare
11731,7262,4469,61.90435597988236,38.09564402011764,Housing
85955,5789,80166,6.734919434587866,93.26508056541213,Transportation
84434,15932,68502,18.86917592439065,81.13082407560935,Transportation
8302,986,7316,11.876656227415081,88.12334377258492,Housing
190479,26401,164078,13.860320560271736,86.13967943972827,Entertainment
12873,4806,8067,37.33395478909345,62.66604521090655,Housing
12000,5052,6948,42.1,57.9,Housing
22534,10230,12304,45.3980651460016,54.6019348539984,Housing
31583,13455,18128,42.602032739131815,57.397967260868185,Food
39636,30297,9339,76.43808658795035,23.561913412049652,Food
134354,13500,120854,10.048081932804383,89.9519180671956,Healthcare
11273,7000,4273,62.09527188858333,37.90472811141666,Housing
16245,7214,9031,44.407510003077874,55.59248999692213,Housing
151506,5363,146143,3.5397938035457344,96.46020619645427,Entertainment
106941,48790,58151,45.62328760718527,54.37671239281473,Healthcare
17788,5660,12128,31.819203957724305,68.18079604227569,Housing
23338,2491,20847,10.673579569800326,89.32642043019968,Housing
67791,17625,50166,25.999026419436213,74.0009735805638,Transportation
14370,9528,4842,66.30480167014613,33.695198329853866,Housing
153091,39265,113826,25.648143914403853,74.35185608559614,Entertainment
149778,5906,143872,3.9431692237845346,96.05683077621546,Healthcare
64111,5958,58153,9.293257007377829,90.70674299262217,Transportation
14570,9196,5374,63.11599176389843,36.88400823610158,Housing
13347,7269,6078,54.461676781299175,45.53832321870083,Housing
179516,35921,143595,20.009915550703,79.990084449297,Entertainment
120828,21173,99655,17.523256198894295,82.4767438011057,Healthcare
57523,13663,43860,23.752238235140727,76.24776176485928,Transportation
90707,42722,47985,47.09890085660423,52.90109914339577,Transportation
52430,28208,24222,53.80125882128552,46.19874117871448,Transportation
169353,23653,145700,13.966684971627311,86.0333150283727,Entertainment
146304,37016,109288,25.30074365704287,74.69925634295713,Healthcare
187050,27821,159229,14.873563218390803,85.1264367816092,Entertainment
117528,49607,67921,42.20866516915118,57.79133483084882,Healthcare
160026,34082,125944,21.297789109269743,78.70221089073026,Entertainment
44568,32479,12089,72.87515706336384,27.12484293663615,Food
9948,9137,811,91.84760755930841,8.152392440691596,Housing
36782,5515,31267,14.993746941438745,85.00625305856126,Food
44844,38885,5959,86.71171171171171,13.288288288288289,Food
161441,26245,135196,16.256712978735266,83.74328702126473,Entertainment
188251,16076,172175,8.5396624719125,91.46033752808749,Entertainment
196291,32806,163485,16.712941500119722,83.28705849988029,Entertainment
169421,25236,144185,14.895437991748366,85.10456200825163,Entertainment
127606,26665,100941,20.89635283607354,79.10364716392647,Healthcare
146574,21832,124742,14.894865392225087,85.10513460777491,Healthcare
92619,3380,89239,3.6493592027553743,96.35064079724462,Transportation
26468,13439,13029,50.77452017530602,49.22547982469397,Food
165211,8689,156522,5.2593350321709815,94.74066496782902,Entertainment
189070,44653,144417,23.617178822658275,76.38282117734173,Entertainment
104264,43049,61215,41.28846006291721,58.71153993708279,Healthcare
183144,48285,134859,26.36450006552221,73.63549993447779,Entertainment
199692,24369,175323,12.203293071329847,87.79670692867015,Entertainment
103730,31351,72379,30.223657572544106,69.7763424274559,Healthcare
47648,16436,31212,34.49462726662189,65.50537273337811,Food
32324,3255,29069,10.069917089469126,89.93008291053087,Food
194290,1373,192917,0.7066755880384992,99.2933244119615,Entertainment
152484,27482,125002,18.022874531098346,81.97712546890166,Entertainment
79257,25651,53606,32.36433374970034,67.63566625029965,Transportation
96873,39384,57489,40.65529094794215,59.34470905205785,Transportation
129237,1620,127617,1.2535109914343416,98.74648900856566,Healthcare
24725,18458,6267,74.65318503538928,25.34681496461072,Housing
11906,3637,8269,30.547623047203093,69.45237695279691,Housing
46226,45730,496,98.92701077315796,1.072989226842037,Food
108077,18006,90071,16.660344013990024,83.33965598600997,Healthcare
40450,692,39758,1.7107540173053153,98.28924598269468,Food
16026,15773,253,98.42131536253588,1.5786846374641208,Housing
41270,14567,26703,35.2968257814393,64.7031742185607,Food
43681,39932,3749,91.41732103202766,8.582678967972344,Food
118801,23246,95555,19.567175360476764,80.43282463952323,Healthcare
138552,9751,128801,7.037790865523413,92.96220913447658,Healthcare
17447,10674,6773,61.1795724193271,38.82042758067289,Housing
198535,38767,159768,19.52653184577027,80.47346815422974,Entertainment
64714,20043,44671,30.971659919028337,69.02834008097166,Transportation
199758,27990,171768,14.011954464902532,85.98804553509747,Entertainment
68728,33120,35608,48.189966243743456,51.810033756256544,Transportation
34950,23963,10987,68.56366237482118,31.43633762517883,Food
185806,12417,173389,6.682776659526603,93.3172233404734,Entertainment
53839,1973,51866,3.6646297293783316,96.33537027062167,Transportation
17692,7311,10381,41.32376215238526,58.67623784761474,Housing
64677,30776,33901,47.584148924656375,52.41585107534363,Transportation
20373,17582,2791,86.30049575418445,13.699504245815541,Housing
36815,33804,3011,91.82126850468559,8.17873149531441,Food
94775,29545,65230,31.17383276180427,68.82616723819572,Transportation
125363,47842,77521,38.162775300527265,61.83722469947273,Healthcare
173897,28155,145742,16.190618584564426,83.80938141543557,Entertainment
37581,32323,5258,86.00888746973204,13.991112530267955,Food
156933,14248,142685,9.079033727769175,90.92096627223083,Entertainment
99907,2347,97560,2.3491847418098835,97.65081525819012,Transportation
155496,18681,136815,12.013813860163605,87.98618613983639,Entertainment
14283,12846,1437,89.93908842680109,10.060911573198908,Housing
39996,23559,16437,58.9033903390339,41.0966096609661,Food
64739,21019,43720,32.467291740681816,67.53270825931818,Transportation
95591,24785,70806,25.92817315437646,74.07182684562355,Transportation
181247,47372,133875,26.136708469657428,73.86329153034256,Entertainment
24288,7156,17132,29.463109354413703,70.5368906455863,Housing
189128,16560,172568,8.75597478956051,91.24402521043949,Entertainment
48282,29978,18304,62.0893914916532,37.91060850834679,Food
82451,18897,63554,22.919067082267045,77.08093291773295,Transportation
8086,2512,5574,31.0660400692555,68.93395993074449,Housing
171615,23828,147787,13.884567199836845,86.11543280016316,Entertainment
15099,3926,11173,26.001721968342274,73.99827803165773,Housing
99842,25745,74097,25.785741471525007,74.21425852847499,Transportation
23812,4615,19197,19.380984377624728,80.61901562237527,Housing
181175,44179,136996,24.384710914861323,75.61528908513868,Entertainment
10708,7112,3596,66.41763167725065,33.582368322749346,Housing
41956,17174,24782,40.933358756792835,59.06664124320717,Food
167908,40821,127087,24.311527741382186,75.68847225861781,Entertainment
20258,2468,17790,12.182841346628493,87.81715865337151,Housing
159884,42139,117745,26.35598308773861,73.64401691226139,Entertainment
22357,13368,8989,59.793353312161734,40.20664668783826,Housing
45424,2035,43389,4.480010567101092,95.51998943289891,Food
19168,612,18556,3.192821368948247,96.80717863105176,Housing
146665,9630,137035,6.565983704360277,93.43401629563972,Healthcare
104134,42144,61990,40.47093168417616,59.52906831582384,Healthcare
63312,30531,32781,48.22308567096285,51.77691432903715,Transportation
184738,41911,142827,22.686723900875837,77.31327609912417,Entertainment
9248,4033,5215,43.609429065743946,56.390570934256054,Housing
106501,35342,71159,33.184664932723635,66.81533506727637,Healthcare
14471,2863,11608,19.78439637896483,80.21560362103517,Housing
45878,27094,18784,59.05662844936571,40.94337155063429,Food
92846,10315,82531,11.109794713827197,88.8902052861728,Transportation
50695,15588,35107,30.74859453595029,69.25140546404971,Transportation
87622,18325,69297,20.913697473237313,79.08630252676268,Transportation
16996,16458,538,96.834549305719,3.1654506942810072,Housing
75136,28164,46972,37.48402896081772,62.51597103918228,Transportation
21493,17069,4424,79.41655422695762,20.583445773042385,Housing
195563,2963,192600,1.5151127769567863,98.48488722304322,Entertainment
54664,38677,15987,70.75406117371578,29.245938826284206,Transportation
135110,13919,121191,10.301976167567167,89.69802383243282,Healthcare
198966,25664,173302,12.898686207693776,87.10131379230623,Entertainment
42107,8720,33387,20.709145747737907,79.2908542522621,Food
35971,28997,6974,80.61215979539074,19.38784020460927,Food
44825,4631,40194,10.331288343558283,89.66871165644172,Food
80816,29565,51251,36.58310235596912,63.41689764403089,Transportation
29380,27959,1421,95.16337644656228,4.836623553437713,Food
100667,33044,67623,32.82505687067261,67.17494312932739,Healthcare
121819,43246,78573,35.50020932695228,64.49979067304771,Healthcare
149596,28750,120846,19.21842830022193,80.78157169977807,Healthcare
180512,33479,147033,18.546689416770075,81.45331058322992,Entertainment
42849,390,42459,0.9101729328572429,99.08982706714275,Food
43629,20470,23159,46.918334135552044,53.081665864447956,Food
38970,23495,15475,60.2899666410059,39.710033358994096,Food
27119,6391,20728,23.566503189645633,76.43349681035436,Food
142904,18672,124232,13.066114314504842,86.93388568549516,Healthcare
87657,4979,82678,5.680094002760761,94.31990599723925,Transportation
137250,33902,103348,24.700910746812387,75.29908925318762,Healthcare
151638,14670,136968,9.67435603212915,90.32564396787085,Entertainment
43225,38826,4399,89.82301908617698,10.17698091382302,Food
162652,25966,136686,15.964144308093353,84.03585569190665,Entertainment
121538,34370,87168,28.27922131349866,71.72077868650135,Healthcare
39313,27052,12261,68.81184341057666,31.188156589423343,Food
49850,18690,31160,37.49247743229689,62.50752256770311,Food
35188,17400,17788,49.44867568489258,50.55132431510743,Food
148240,9678,138562,6.528602266594712,93.4713977334053,Healthcare
142757,4722,138035,3.3077187108162818,96.69228128918371,Healthcare
83823,41340,42483,49.31820622024981,50.68179377975019,Transportation
15604,7544,8060,48.346577800563956,51.65342219943604,Housing
95010,38549,56461,40.57362382907063,59.42637617092937,Transportation
194186,9678,184508,4.983881433265013,95.01611856673499,Entertainment
142629,21352,121277,14.970307581207187,85.02969241879282,Healthcare
39681,35303,4378,88.9670119200625,11.032988079937502,Food
105025,7715,97310,7.345870030945013,92.65412996905499,Healthcare
43266,25097,18169,58.00628669162853,41.99371330837147,Food
61937,11036,50901,17.81810549429259,82.1818945057074,Transportation
39063,15160,23903,38.80910324347848,61.19089675652152,Food
155316,5381,149935,3.464549692240336,96.53545030775966,Entertainment
194639,29024,165615,14.911708342110266,85.08829165788974,Entertainment
171140,14767,156373,8.628608157064392,91.37139184293561,Entertainment
125742,6437,119305,5.119212355458001,94.880787644542,Healthcare
20043,3440,16603,17.163099336426683,82.83690066357332,Housing
18636,16,18620,0.08585533376261,99.91414466623739,Housing
120139,43262,76877,36.00995513530161,63.99004486469839,Healthcare
14539,370,14169,2.5448792901850195,97.45512070981498,Housing
22686,3983,18703,17.557083663933703,82.44291633606629,Housing
89219,12213,77006,13.688788262589807,86.3112117374102,Transportation
13498,10582,2916,78.39679952585568,21.60320047414432,Housing
47254,24423,22831,51.684513480340286,48.315486519659714,Food
21998,13261,8737,60.28275297754341,39.71724702245659,Housing
13017,12868,149,98.85534301298303,1.1446569870169778,Housing
121033,41618,79415,34.3856634141102,65.6143365858898,Healthcare
34981,19838,15143,56.71078585517853,43.28921414482147,Food
183237,38673,144564,21.105453592887898,78.8945464071121,Entertainment
94240,45268,48972,48.03480475382003,51.96519524617996,Transportation
11676,2426,9250,20.777663583418978,79.22233641658102,Housing
137757,6344,131413,4.60521062450547,95.39478937549453,Healthcare
40967,31097,9870,75.90743769375351,24.09256230624649,Food
129176,24288,104888,18.802254288722363,81.19774571127763,Healthcare
135589,15472,120117,11.41095516597954,88.58904483402046,Healthcare
108285,43526,64759,40.19577965553863,59.80422034446138,Healthcare
28991,21594,7397,74.48518505743161,25.514814942568382,Food
171860,33805,138055,19.670080297916908,80.32991970208309,Entertainment
14979,9805,5174,65.45830829828427,34.541691701715735,Housing
107695,4830,102865,4.484887877803055,95.51511212219694,Healthcare
35851,18412,17439,51.35700538339238,48.64299461660762,Food
164619,17245,147374,10.475704505555251,89.52429549444474,Entertainment
27647,5209,22438,18.84110391724238,81.15889608275762,Food
18357,17154,1203,93.44664160810589,6.5533583918941,Housing
31560,7620,23940,24.14448669201521,75.8555133079848,Food
34891,10283,24608,29.471783554498295,70.5282164455017,Food
100640,12502,88138,12.422496025437201,87.5775039745628,Healthcare
39905,26081,13824,65.3577245959153,34.6422754040847,Food
37616,1466,36150,3.8972777541471713,96.10272224585283,Food
75906,7972,67934,10.50246357336706,89.49753642663293,Transportation
54723,17772,36951,32.476289677101036,67.52371032289896,Transportation
25192,25074,118,99.5315973324865,0.46840266751349635,Food
147459,36075,111384,24.46442740015869,75.53557259984132,Healthcare
47470,46233,1237,97.39414366968612,2.605856330313882,Food
185160,24852,160308,13.421905379131562,86.57809462086844,Entertainment
91723,46359,45364,50.54239394699258,49.457606053007424,Transportation
198062,6490,191572,3.2767517242075717,96.72324827579243,Entertainment
106413,20504,85909,19.268322479396314,80.73167752060368,Healthcare
27973,18256,9717,65.26293211310907,34.737067886890934,Food
13867,6963,6904,50.21273527078676,49.787264729213234,Housing
151011,47692,103319,31.581805298951732,68.41819470104826,Entertainment
43029,35912,7117,83.45999209835227,16.540007901647726,Food
109179,1725,107454,1.579974170857033,98.42002582914297,Healthcare
87849,15471,72378,17.610900522487448,82.38909947751254,Transportation
11453,4507,6946,39.3521348118397,60.64786518816031,Housing
168289,21415,146874,12.725133550024065,87.27486644997593,Entertainment
57888,33182,24706,57.32103372028745,42.67896627971255,Transportation
156711,20236,136475,12.912941656935379,87.08705834306463,Entertainment
194939,44735,150204,22.948204310066224,77.05179568993378,Entertainment
22382,18755,3627,83.79501385041551,16.20498614958449,Housing
141463,3521,137942,2.488990053936365,97.51100994606364,Healthcare
10044,7368,2676,73.35722819593788,26.642771804062125,Housing
98000,11698,86302,11.936734693877552,88.06326530612245,Transportation
147102,39023,108079,26.52785142282226,73.47214857717775,Healthcare
27927,25928,1999,92.84205249400223,7.157947505997781,Food
117755,34404,83351,29.21659377521124,70.78340622478876,Healthcare
16172,3345,12827,20.68389809547366,79.31610190452633,Housing
107550,13397,94153,12.456531845653185,87.54346815434681,Healthcare
92219,13418,78801,14.55014693284464,85.44985306715536,Transportation
196351,11643,184708,5.929687141904039,94.07031285809596,Entertainment
102025,7666,94359,7.513844645920117,92.48615535407988,Healthcare
166362,15907,150455,9.561678748752719,90.43832125124727,Entertainment
112648,38016,74632,33.74760315318514,66.25239684681486,Healthcare
118661,46099,72562,38.849327074607494,61.1506729253925,Healthcare
59033,27718,31315,46.953398946352046,53.046601053647954,Transportation
79766,23769,55997,29.79841035027455,70.20158964972545,Transportation
30198,15553,14645,51.50341082190874,48.49658917809126,Food
19016,2612,16404,13.735801430374423,86.26419856962558,Housing
30209,687,29522,2.274156708265749,97.72584329173425,Food
23639,11546,12093,48.84301366386057,51.15698633613943,Housing
24133,1682,22451,6.969709526374674,93.03029047362531,Housing
189972,3545,186427,1.8660644726591287,98.13393552734088,Entertainment
46639,1073,45566,2.300649670876305,97.69935032912369,Food
10011,1442,8569,14.404155429028071,85.59584457097193,Housing
21521,20979,542,97.48152966869569,2.5184703313043073,Housing
46154,5247,40907,11.368462105126316,88.63153789487367,Food
25106,11479,13627,45.722138134310526,54.27786186568948,Food
39192,19190,20002,48.96407430087773,51.035925699122274,Food
15783,11197,4586,70.94342013558892,29.056579864411074,Housing
68768,10846,57922,15.771870637505817,84.22812936249419,Transportation
93884,9018,84866,9.605470580716629,90.39452941928337,Transportation
57992,15439,42553,26.62263760518692,73.37736239481308,Transportation
72913,36919,35994,50.634317611399894,49.36568238860011,Transportation
13565,7241,6324,53.38002211573903,46.61997788426097,Housing
48526,15043,33483,30.99987635494374,69.00012364505625,Food
15483,539,14944,3.4812374862752695,96.51876251372474,Housing
132536,2940,129596,2.2182652260517894,97.78173477394822,Healthcare
53347,30807,22540,57.7483269912085,42.2516730087915,Transportation
93398,37909,55489,40.58866356881304,59.41133643118697,Transportation
138623,16600,122023,11.97492479602952,88.02507520397049,Healthcare
95168,12243,82925,12.864618359112306,87.13538164088769,Transportation
44868,35712,9156,79.59347419096015,20.40652580903985,Food
38266,5424,32842,14.17446296973815,85.82553703026186,Food
113108,28646,84462,25.326236870955192,74.67376312904481,Healthcare
35065,28369,6696,80.90403536289747,19.095964637102526,Food
18135,12966,5169,71.49710504549213,28.502894954507855,Housing
169632,1910,167722,1.1259667987172233,98.87403320128277,Entertainment
166674,23395,143279,14.036382399174435,85.96361760082556,Entertainment
15564,10961,4603,70.42534052942688,29.574659470573117,Housing
69748,44484,25264,63.77817285083444,36.22182714916557,Transportation
131771,11226,120545,8.519325192948372,91.48067480705163,Healthcare
161202,16910,144292,10.489944293495117,89.51005570650489,Entertainment
127067,42120,84947,33.14786687338176,66.85213312661824,Healthcare
96194,48466,47728,50.38359980871988,49.61640019128012,Transportation
11972,5295,6677,44.22819913130638,55.771800868693624,Housing
137082,34986,102096,25.521950365474677,74.47804963452532,Healthcare
149013,6641,142372,4.456658143920329,95.54334185607966,Healthcare
172153,19202,152951,11.154031588180281,88.84596841181973,Entertainment
137658,4839,132819,3.515233404524256,96.48476659547575,Healthcare
148249,8486,139763,5.724153282652835,94.27584671734716,Healthcare
122124,3970,118154,3.250794274671645,96.74920572532835,Healthcare
35714,2581,33133,7.2268578148625195,92.77314218513749,Food
122832,41091,81741,33.45300898788589,66.5469910121141,Healthcare
140728,18782,121946,13.346313455744415,86.65368654425558,Healthcare
44847,4011,40836,8.943742056324838,91.05625794367516,Food
175368,45134,130234,25.736736462752614,74.2632635372474,Entertainment
51360,24532,26828,47.76479750778816,52.23520249221184,Transportation
38681,24489,14192,63.31015227114087,36.689847728859135,Food
177950,22821,155129,12.82438887327901,87.17561112672098,Entertainment
76412,45188,31224,59.137308276186985,40.862691723813015,Transportation
16680,2204,14476,13.213429256594726,86.78657074340528,Housing
164079,4373,159706,2.665179578130047,97.33482042186995,Entertainment
73665,36828,36837,49.99389126450824,50.00610873549175,Transportation
28794,7373,21421,25.606029033826495,74.39397096617351,Food
110867,3889,106978,3.5078066512127144,96.49219334878728,Healthcare
29918,5831,24087,19.489939167056622,80.51006083294338,Food
24378,22737,1641,93.26852079744032,6.731479202559686,Housing
144227,48647,95580,33.729468130100464,66.27053186989953,Healthcare
135060,1532,133528,1.1343106767362654,98.86568932326374,Healthcare
36197,20900,15297,57.73959167886842,42.260408321131585,Food
86846,21282,65564,24.505446422402873,75.49455357759712,Transportation
167537,34062,133475,20.33103135426801,79.66896864573198,Entertainment
32453,8718,23735,26.86346408652513,73.13653591347487,Food
86982,15235,71747,17.51511807040537,82.48488192959464,Transportation
28794,9947,18847,34.54539140098631,65.45460859901368,Food
41855,30337,11518,72.48118504360292,27.518814956397087,Food
130594,21330,109264,16.33306277470634,83.66693722529365,Healthcare
124244,33289,90955,26.79324554908084,73.20675445091915,Healthcare
99753,13411,86342,13.444207191763658,86.55579280823635,Transportation
63471,13176,50295,20.759086827054876,79.24091317294513,Transportation
98941,35645,63296,36.026520855863595,63.973479144136405,Transportation
57445,10510,46935,18.295761162851424,81.70423883714858,Transportation
99901,12178,87723,12.19006816748581,87.80993183251418,Transportation
27053,22393,4660,82.77455365393857,17.225446346061435,Food
104077,32925,71152,31.63523160736762,68.36476839263239,Healthcare
8661,3374,5287,38.95624061886618,61.043759381133825,Housing
36089,33576,2513,93.03665936989111,6.963340630108897,Food
69117,35477,33640,51.32890605784395,48.67109394215605,Transportation
12425,8966,3459,72.16096579476861,27.83903420523139,Housing
24032,2198,21834,9.146138482023968,90.85386151797603,Housing
90147,18073,72074,20.048365447546786,79.95163455245321,Transportation
199217,7770,191447,3.900269555309035,96.09973044469096,Entertainment
39573,17794,21779,44.96500138983651,55.0349986101635,Food
24724,3828,20896,15.48293156447177,84.51706843552823,Housing
36240,10619,25621,29.30187637969095,70.69812362030905,Food
147110,19675,127435,13.374345727686766,86.62565427231324,Healthcare
176579,46408,130171,26.281720929442347,73.71827907055766,Entertainment
9855,8125,1730,82.44545915778792,17.554540842212074,Housing
20201,17778,2423,88.00554427998614,11.99445572001386,Housing
179430,46647,132783,25.9973248620632,74.0026751379368,Entertainment
152805,10176,142629,6.659467949347207,93.3405320506528,Entertainment
84938,13563,71375,15.968117921307307,84.0318820786927,Transportation
84949,34728,50221,40.88099918774794,59.119000812252054,Transportation
13233,11303,1930,85.41524975440188,14.584750245598126,Housing
26771,12305,14466,45.963916177953756,54.036083822046244,Food
36274,31954,4320,88.09064343606991,11.909356563930087,Food
172696,24952,147744,14.448510677722703,85.55148932227729,Entertainment
12632,6288,6344,49.77834072197594,50.22165927802406,Housing
171142,22666,148476,13.243972841266316,86.75602715873369,Entertainment
197354,16,197338,0.008107259037060308,99.99189274096294,Entertainment
83002,27228,55774,32.80402881858269,67.19597118141732,Transportation
14738,2472,12266,16.772967838241282,83.22703216175871,Housing
152507,32584,119923,21.365576662054856,78.63442333794515,Entertainment
44310,25901,18409,58.454073572556986,41.545926427443014,Food
184721,18079,166642,9.787192576913291,90.2128074230867,Entertainment
16277,11307,4970,69.46611783498187,30.533882165018124,Housing
136024,17601,118423,12.939628300888078,87.06037169911193,Healthcare
129657,22455,107202,17.318771836460815,82.68122816353919,Healthcare
21622,14125,7497,65.32698177781889,34.67301822218111,Housing
43468,34808,8660,80.0772982423852,19.922701757614796,Food
15373,5907,9466,38.424510505431606,61.5754894945684,Housing
34197,21709,12488,63.48217679913443,36.51782320086557,Food
122706,34722,87984,28.296904796831452,71.70309520316856,Healthcare
155850,30300,125550,19.441770933589993,80.55822906641001,Entertainment
48325,20674,27651,42.78116916709778,57.21883083290222,Food
153115,13442,139673,8.779022303497372,91.22097769650263,Entertainment
13126,5122,8004,39.0217888160902,60.978211183909806,Housing
35977,33586,2391,93.35408733357423,6.645912666425772,Food
161796,14984,146812,9.261044772429479,90.73895522757051,Entertainment
24843,23952,891,96.41347663325686,3.5865233667431466,Housing
144555,27785,116770,19.221057728892117,80.77894227110788,Healthcare
158496,33853,124643,21.358898647284473,78.64110135271552,Entertainment
116255,34512,81743,29.686465098275345,70.31353490172467,Healthcare
52115,34445,17670,66.09421471745179,33.90578528254821,Transportation
36955,17548,19407,47.4847787850088,52.5152212149912,Food
17744,5690,12054,32.06717763751127,67.93282236248874,Housing
146540,33717,112823,23.008734816432373,76.99126518356762,Healthcare
51844,73,51771,0.14080703649409768,99.8591929635059,Transportation
42305,42037,268,99.36650514123626,0.6334948587637396,Food
39337,22200,17137,56.43541703739482,43.56458296260518,Food
28971,24356,4615,84.07027717372544,15.929722826274551,Food
156588,6577,150011,4.200194140036274,95.79980585996373,Entertainment
23140,12803,10337,55.328435609334484,44.671564390665516,Housing
73071,11284,61787,15.442514814358638,84.55748518564137,Transportation
167602,26807,140795,15.994439207169364,84.00556079283064,Entertainment
35395,3749,31646,10.591891510100297,89.4081084898997,Food
8481,153,8328,1.8040325433321542,98.19596745666784,Housing
113516,21675,91841,19.094224602699178,80.90577539730081,Healthcare
41227,13543,27684,32.84983142115604,67.15016857884396,Food
98927,38203,60724,38.61736431914442,61.38263568085558,Transportation
57631,16375,41256,28.413527441828183,71.58647255817182,Transportation
182277,33630,148647,18.449941572441944,81.55005842755806,Entertainment
77776,9425,68351,12.118134128780087,87.88186587121992,Transportation
24589,23736,853,96.53096913253893,3.46903086746106,Housing
149161,25173,123988,16.876395304402624,83.12360469559738,Healthcare
13750,12772,978,92.88727272727273,7.112727272727273,Housing
175041,37646,137395,21.506961226227,78.49303877377301,Entertainment
166144,49744,116400,29.94029275808937,70.05970724191063,Entertainment
62042,23227,38815,37.43754231004803,62.56245768995197,Transportation
168461,26105,142356,15.496168252592588,84.5038317474074,Entertainment
9409,784,8625,8.332447656499097,91.6675523435009,Housing
19580,5634,13946,28.77425944841675,71.22574055158324,Housing
39142,9344,29798,23.87205559245823,76.12794440754178,Food
177426,41509,135917,23.395105565137015,76.60489443486298,Entertainment
112047,33444,78603,29.84818870652494,70.15181129347506,Healthcare
17865,2219,15646,12.420934788692975,87.57906521130703,Housing
150080,31282,118798,20.84355010660981,79.15644989339019,Entertainment
109107,34206,74901,31.350875745827487,68.6491242541725,Healthcare
45739,23544,22195,51.47467150571722,48.525328494282775,Food
144037,443,143594,0.30755986309073363,99.69244013690927,Healthcare
51068,20607,30461,40.35207958016762,59.64792041983238,Transportation
37068,23916,13152,64.51926189705407,35.480738102945935,Food
47277,8412,38865,17.793007170505742,82.20699282949425,Food
56611,43292,13319,76.47277030965714,23.527229690342864,Transportation
18759,5439,13320,28.994082840236686,71.00591715976331,Housing
179048,22560,156488,12.599973191546402,87.4000268084536,Entertainment
149685,13463,136222,8.994221197848816,91.00577880215118,Healthcare
109493,35421,74072,32.35001324285571,67.64998675714429,Healthcare
158800,23053,135747,14.517002518891688,85.48299748110831,Entertainment
191197,23569,167628,12.327076261656824,87.67292373834317,Entertainment
120013,34333,85680,28.607734162132438,71.39226583786757,Healthcare
190169,2379,187790,1.2509925382160079,98.74900746178399,Entertainment
152544,28702,123842,18.815554856303756,81.18444514369625,Entertainment
9000,1388,7612,15.422222222222222,84.57777777777777,Housing
45334,27684,17650,61.06674901839679,38.933250981603216,Food
182312,38206,144106,20.95638246522445,79.04361753477555,Entertainment
21949,21633,316,98.560298874664,1.4397011253360061,Housing
119969,47605,72364,39.68108428010569,60.31891571989431,Healthcare
38559,1587,36972,4.115770637205322,95.88422936279468,Food
165264,16238,149026,9.825491335075998,90.174508664924,Entertainment
55142,38756,16386,70.28399405172101,29.71600594827899,Transportation
193840,39541,154299,20.39878250103178,79.60121749896823,Entertainment
156304,19053,137251,12.18970723717883,87.81029276282118,Entertainment
152247,39421,112826,25.89279263302397,74.10720736697604,Entertainment
14342,12636,1706,88.10486682471064,11.89513317528936,Housing
131501,13207,118294,10.043269632930548,89.95673036706945,Healthcare
10365,1525,8840,14.712976362759287,85.28702363724071,Housing
48889,26514,22375,54.23305856123054,45.76694143876946,Food
96183,8587,87596,8.927773099196322,91.07222690080367,Transportation
26031,9487,16544,36.44500787522569,63.554992124774316,Food
137535,36126,101409,26.266768458937722,73.73323154106227,Healthcare
127477,16212,111265,12.717588270825326,87.28241172917467,Healthcare
161158,19575,141583,12.146464959853063,87.85353504014694,Entertainment
164692,39761,124931,24.142642022684768,75.85735797731523,Entertainment
30232,7965,22267,26.34625562318074,73.65374437681926,Food
172234,17800,154434,10.334777105565685,89.66522289443432,Entertainment
125463,27044,98419,21.55535895044754,78.44464104955246,Healthcare
120449,45641,74808,37.89238598909082,62.10761401090919,Healthcare
24984,14060,10924,56.27601665065642,43.723983349343584,Housing
22309,13234,9075,59.321350127751124,40.67864987224887,Housing
32348,14249,18099,44.04909113391863,55.95090886608136,Food
19394,3556,15838,18.335567701350932,81.66443229864907,Housing
110653,21507,89146,19.43643642739013,80.56356357260988,Healthcare
78755,43310,35445,54.99333375658688,45.00666624341312,Transportation
31471,2062,29409,6.552063804772648,93.44793619522736,Food
33746,29092,4654,86.20873585017483,13.791264149825164,Food
121310,18688,102622,15.405160333031079,84.59483966696892,Healthcare
107742,4694,103048,4.35670397802157,95.64329602197843,Healthcare
32355,11294,21061,34.90650594962138,65.09349405037861,Food
34980,20316,14664,58.07890222984563,41.921097770154375,Food
126820,11741,115079,9.25800346948431,90.74199653051569,Healthcare
20935,8068,12867,38.538332935275854,61.461667064724146,Housing
49054,15193,33861,30.97199005177967,69.02800994822033,Food
157803,42230,115573,26.761214932542476,73.23878506745753,Entertainment
121752,39029,82723,32.056146921611145,67.94385307838886,Healthcare
59777,21947,37830,36.71478996938622,63.28521003061378,Transportation
186535,31668,154867,16.976974830460772,83.02302516953924,Entertainment
28458,9848,18610,34.60538337198679,65.39461662801321,Food
166058,1310,164748,0.7888809933878524,99.21111900661215,Entertainment
86048,26754,59294,31.09194867980662,68.90805132019338,Transportation
161274,31739,129535,19.680171633369298,80.3198283666307,Entertainment
70585,4791,65794,6.787561096550259,93.21243890344975,Transportation
150930,40726,110204,26.98336977406745,73.01663022593256,Entertainment
82886,16865,66021,20.34722389788384,79.65277610211616,Transportation
177526,38977,138549,21.955657199508806,78.0443428004912,Entertainment
66485,4646,61839,6.988042415582463,93.01195758441753,Transportation
33431,22831,10600,68.29290179773264,31.70709820226736,Food
124205,34928,89277,28.121251157360817,71.87874884263918,Healthcare
65083,47409,17674,72.84390701104742,27.15609298895257,Transportation
38096,33783,4313,88.67860142797144,11.32139857202856,Food
181067,33181,147886,18.32526081505741,81.6747391849426,Entertainment
77714,41621,36093,53.55663072290707,46.443369277092934,Transportation
159458,33922,125536,21.273313348969637,78.72668665103036,Entertainment
23343,13635,9708,58.41151522940496,41.58848477059504,Housing
23328,14599,8729,62.581447187928674,37.41855281207133,Housing
160608,16919,143689,10.53434449093445,89.46565550906556,Entertainment
166938,37672,129266,22.56646180018929,77.4335381998107,Entertainment
195244,32486,162758,16.638667513470324,83.36133248652968,Entertainment
165377,36039,129338,21.792026702624913,78.20797329737509,Entertainment
159637,3376,156261,2.1147979478441714,97.88520205215583,Entertainment
147941,17402,130539,11.762797331368587,88.23720266863141,Healthcare
105682,36446,69236,34.48647830283303,65.51352169716698,Healthcare
19174,4729,14445,24.663606967768853,75.33639303223114,Housing
47440,11413,36027,24.057757166947724,75.94224283305228,Food
104906,48307,56599,46.04789049244085,53.95210950755914,Healthcare
39087,9261,29826,23.69329956251439,76.3067004374856,Food
112187,34607,77580,30.8476026634102,69.1523973365898,Healthcare
13752,9852,3900,71.64048865619547,28.359511343804538,Housing
95205,45638,49567,47.93655795388897,52.06344204611102,Transportation
143714,1919,141795,1.33529092503166,98.66470907496834,Healthcare
107494,35604,71890,33.12184866132063,66.87815133867937,Healthcare
114038,18756,95282,16.447149195882073,83.55285080411792,Healthcare
180610,17401,163209,9.634571729140136,90.36542827085987,Entertainment
121609,17579,104030,14.455344587982797,85.5446554120172,Healthcare
59582,4515,55067,7.577791950589104,92.4222080494109,Transportation
40194,25883,14311,64.3951833607006,35.6048166392994,Food
138750,44989,93761,32.424504504504505,67.5754954954955,Healthcare
115054,27426,87628,23.837502390182003,76.162497609818,Healthcare
139837,22205,117632,15.879202214006307,84.1207977859937,Healthcare
69570,48506,21064,69.72258157251689,30.27741842748311,Transportation
62483,34318,28165,54.92373925707793,45.076260742922074,Transportation
97599,6722,90877,6.88736564923821,93.1126343507618,Transportation
35956,34800,1156,96.78495939481589,3.215040605184114,Food
161231,17765,143466,11.018352550067915,88.98164744993208,Entertainment
108304,15100,93204,13.942236667159108,86.05776333284089,Healthcare
10994,8751,2243,79.59796252501364,20.402037474986358,Housing
125937,27002,98935,21.440879169743603,78.5591208302564,Healthcare
10064,3253,6811,32.3231319554849,67.6768680445151,Housing
35314,20462,14852,57.94302542900832,42.05697457099167,Food
191096,38677,152419,20.23956545401264,79.76043454598735,Entertainment
106616,6762,99854,6.342387634126211,93.65761236587379,Healthcare
105005,22705,82300,21.622779867625354,78.37722013237465,Healthcare
108109,28715,79394,26.56115587046407,73.43884412953592,Healthcare
48096,42043,6053,87.41475382568197,12.58524617431803,Food
14236,6078,8158,42.694577128406856,57.30542287159315,Housing
97115,37812,59303,38.93528291201153,61.06471708798846,Transportation
101909,39722,62187,38.97791166629052,61.02208833370949,Healthcare
149238,15414,133824,10.328468620592611,89.67153137940738,Healthcare
13738,4232,9506,30.80506623962731,69.19493376037269,Housing
113225,3052,110173,2.695517774343122,97.30448222565687,Healthcare
117143,49916,67227,42.61116754735665,57.38883245264334,Healthcare
36992,21168,15824,57.22318339100346,42.77681660899654,Food
66714,2486,64228,3.7263542884551972,96.2736457115448,Transportation
86292,18147,68145,21.029759421499097,78.9702405785009,Transportation
164963,35290,129673,21.392675933391125,78.60732406660887,Entertainment
159263,4487,154776,2.8173524296289787,97.18264757037102,Entertainment
46674,40870,5804,87.56481124394739,12.43518875605262,Food
14980,13472,1508,89.93324432576769,10.06675567423231,Housing
9932,8556,1376,86.14579138139348,13.854208618606526,Housing
23845,17438,6407,73.13063535332354,26.869364646676452,Housing
46433,27527,18906,59.283268365171324,40.716731634828676,Food
140109,26252,113857,18.73684060267363,81.26315939732636,Healthcare
67733,5289,62444,7.808601420282581,92.19139857971741,Transportation
21234,17044,4190,80.26749552604315,19.732504473956862,Housing
98258,1018,97240,1.036047955382768,98.96395204461723,Transportation
101512,45486,56026,44.808495547324455,55.191504452675545,Healthcare
18616,4361,14255,23.42608508809626,76.57391491190374,Housing
110347,25156,85191,22.797176180593944,77.20282381940605,Healthcare
10048,6233,3815,62.03224522292994,37.96775477707006,Housing
102204,25370,76834,24.82290321318148,75.17709678681852,Healthcare
130541,35335,95206,27.068124190867238,72.93187580913276,Healthcare
15151,8564,6587,56.52432182694211,43.47567817305789,Housing
36438,4551,31887,12.489708546023383,87.51029145397662,Food
93149,29401,63748,31.563409161665717,68.43659083833428,Transportation
17369,9283,8086,53.44579423110139,46.55420576889861,Housing
91188,2881,88307,3.1594069395095845,96.84059306049042,Transportation
83383,4050,79333,4.857105165321468,95.14289483467853,Transportation
78073,35561,42512,45.54839701305189,54.45160298694811,Transportation
26314,7847,18467,29.82062780269058,70.17937219730942,Food
44742,870,43872,1.9444816950516295,98.05551830494838,Food
77917,44871,33046,57.58820283121784,42.411797168782165,Transportation
19397,12999,6398,67.01551786358715,32.98448213641284,Housing
99778,15858,83920,15.893283088456373,84.10671691154363,Transportation
51213,9001,42212,17.575615566360103,82.4243844336399,Transportation
8689,3759,4930,43.261595120267,56.738404879733,Housing
98927,33690,65237,34.055414598643445,65.94458540135656,Transportation
19296,7813,11483,40.49025704809287,59.50974295190713,Housing
180216,9106,171110,5.0528254982909395,94.94717450170907,Entertainment
111518,21683,89835,19.443497910651196,80.5565020893488,Healthcare
192428,7216,185212,3.7499740162554307,96.25002598374456,Entertainment
108521,26415,82106,24.340910975755843,75.65908902424415,Healthcare
107332,11553,95779,10.763798308053516,89.23620169194648,Healthcare
24103,12742,11361,52.864788615525036,47.135211384474964,Housing
136856,41721,95135,30.485327643654642,69.51467235634536,Healthcare
65946,255,65691,0.38668001091802384,99.61331998908197,Transportation
118910,9117,109793,7.6671432175595,92.3328567824405,Healthcare
174126,9369,164757,5.3805864718652,94.6194135281348,Entertainment
130615,17601,113014,13.475481376564712,86.52451862343528,Healthcare
34644,9943,24701,28.700496478466693,71.29950352153331,Food
158178,46115,112063,29.153864633514143,70.84613536648587,Entertainment
48549,37265,11284,76.75750272920142,23.242497270798573,Food
84078,864,83214,1.0276172125883107,98.97238278741169,Transportation
68808,11767,57041,17.101209161725382,82.89879083827462,Transportation
12637,2104,10533,16.649521247131442,83.35047875286857,Housing
157264,12777,144487,8.124554888594975,91.87544511140503,Entertainment
66185,30897,35288,46.682783107954975,53.317216892045025,Transportation
38667,20955,17712,54.19349833191093,45.80650166808907,Food
91882,13546,78336,14.742822315578676,85.25717768442132,Transportation
28566,10426,18140,36.49793460757544,63.502065392424555,Food
57972,31269,26703,53.938108052163116,46.061891947836884,Transportation
37393,7938,29455,21.22857219265638,78.77142780734361,Food
11291,4033,7258,35.71871402001594,64.28128597998406,Housing
13475,8232,5243,61.09090909090909,38.90909090909091,Housing
45735,37755,7980,82.55165628074779,17.448343719252215,Food
69564,47322,22242,68.02656546489564,31.973434535104367,Transportation
34079,11725,22354,34.40535226972622,65.59464773027378,Food
171220,27946,143274,16.321691391192616,83.67830860880738,Entertainment
130983,16746,114237,12.784865211515998,87.21513478848401,Healthcare
172517,10473,162044,6.0707060753433,93.9292939246567,Entertainment
139808,36903,102905,26.395485236896317,73.6045147631037,Healthcare
135259,25301,109958,18.705594452125183,81.29440554787482,Healthcare
196337,33959,162378,17.296281393726094,82.7037186062739,Entertainment
107249,19829,87420,18.488750477859934,81.51124952214006,Healthcare
166495,41543,124952,24.951500045046398,75.04849995495361,Entertainment
166926,6033,160893,3.614176341612451,96.38582365838755,Entertainment
109822,49720,60102,45.273260366775325,54.726739633224675,Healthcare
30078,3768,26310,12.527428685417913,87.47257131458208,Food
101068,15245,85823,15.083903906280922,84.91609609371909,Healthcare
36464,17241,19223,47.28225098727512,52.71774901272488,Food
124661,39377,85284,31.5872646617627,68.4127353382373,Healthcare
79070,21827,57243,27.60465410395852,72.39534589604149,Transportation
19889,12275,7614,61.7175323042888,38.2824676957112,Housing
135557,26451,109106,19.51282486334162,80.48717513665838,Healthcare
22908,17858,5050,77.95529945870439,22.04470054129562,Housing
45208,23154,22054,51.21659883206512,48.78340116793488,Food
166690,15923,150767,9.552462655228268,90.44753734477173,Entertainment
125728,22559,103169,17.942701705268515,82.05729829473148,Healthcare
143810,1081,142729,0.7516862526945275,99.24831374730547,Healthcare
13486,8335,5151,61.80483464333383,38.19516535666617,Housing
59188,7226,51962,12.208555788335474,87.79144421166453,Transportation
101608,44477,57131,43.77312810014959,56.22687189985041,Healthcare
22139,7531,14608,34.01689326527847,65.98310673472153,Housing
118896,47910,70986,40.295720629794104,59.704279370205896,Healthcare
56230,6877,49353,12.230126267117198,87.76987373288281,Transportation
188910,19504,169406,10.324493144883808,89.6755068551162,Entertainment
66989,2979,64010,4.446998760990611,95.55300123900939,Transportation
186815,34841,151974,18.650001338222307,81.34999866177769,Entertainment
148930,16160,132770,10.850735244745854,89.14926475525414,Healthcare
197548,12100,185448,6.125093648126025,93.87490635187397,Entertainment
16321,3814,12507,23.368666135653452,76.63133386434654,Housing
10217,3539,6678,34.63834785161985,65.36165214838016,Housing
70045,33836,36209,48.30608894282247,51.69391105717753,Transportation
191969,22322,169647,11.62791909110325,88.37208090889675,Entertainment
144707,11548,133159,7.98026356707001,92.01973643292999,Healthcare
143133,2160,140973,1.5090859550208546,98.49091404497915,Healthcare
71354,15250,56104,21.372312694453008,78.62768730554698,Transportation
102269,38400,63869,37.54803508394528,62.45196491605471,Healthcare
175175,26663,148512,15.220779220779221,84.77922077922078,Entertainment
26911,24466,2445,90.91449593103192,9.08550406896808,Food
167588,23733,143855,14.161515144282408,85.8384848557176,Entertainment
197973,9950,188023,5.025937880418037,94.97406211958196,Entertainment
132017,27640,104377,20.936697546528098,79.0633024534719,Healthcare
135576,15654,119922,11.546291379005133,88.45370862099486,Healthcare
87922,1894,86028,2.1541821159664245,97.84581788403356,Transportation
176521,44105,132416,24.98569575291325,75.01430424708676,Entertainment
171951,11089,160862,6.448930218492476,93.55106978150752,Entertainment
179509,42653,136856,23.760925636040533,76.23907436395947,Entertainment
162417,510,161907,0.3140065387243946,99.6859934612756,Entertainment
123766,35560,88206,28.731638737617764,71.26836126238224,Healthcare
34952,30992,3960,88.6701762417029,11.329823758297094,Food
29501,1172,28329,3.9727466865529983,96.027253313447,Food
195589,18953,176636,9.690217752532096,90.30978224746791,Entertainment
194543,42078,152465,21.62915139583537,78.37084860416464,Entertainment
63783,49244,14539,77.20552498314598,22.794475016854022,Transportation
94554,968,93586,1.0237536222687564,98.97624637773124,Transportation
32796,11332,21464,34.552994267593604,65.4470057324064,Food
31160,23702,7458,76.06546854942233,23.934531450577666,Food
14296,14060,236,98.34918858421936,1.650811415780638,Housing
88334,17493,70841,19.80324676794892,80.19675323205108,Transportation
10983,4278,6705,38.95110625512155,61.048893744878455,Housing
47838,14997,32841,31.34955474727204,68.65044525272795,Food
88033,15890,72143,18.0500494132882,81.94995058671181,Transportation
9762,7101,2661,72.74124154886293,27.258758451137062,Housing
109558,44496,65062,40.6141039449424,59.3858960550576,Healthcare
192662,18866,173796,9.792278705712596,90.2077212942874,Entertainment
172103,21536,150567,12.513436721033337,87.48656327896667,Entertainment
16924,4330,12594,25.58496809264949,74.41503190735051,Housing
121564,6472,115092,5.323944588858544,94.67605541114146,Healthcare
99012,7933,91079,8.012160142204985,91.98783985779502,Transportation
76383,11139,65244,14.583087859864104,85.41691214013589,Transportation
163156,11255,151901,6.898305915810635,93.10169408418936,Entertainment
163583,43888,119695,26.829193742626067,73.17080625737393,Entertainment
20977,9,20968,0.04290413309815512,99.95709586690185,Housing
23072,3935,19137,17.055305131761443,82.94469486823856,Housing
18150,6530,11620,35.97796143250689,64.02203856749311,Housing
68977,34258,34719,49.665830639198575,50.334169360801425,Transportation
145016,28255,116761,19.484056931648922,80.51594306835108,Healthcare
163415,7749,155666,4.74191475690726,95.25808524309274,Entertainment
20067,1104,18963,5.501569741366422,94.49843025863358,Housing
161684,5839,155845,3.6113653793820046,96.38863462061799,Entertainment
12559,7291,5268,58.053985189903656,41.946014810096344,Housing
195853,5027,190826,2.5667209590866618,97.43327904091333,Entertainment
51075,42676,8399,83.55555555555556,16.444444444444446,Transportation
67199,1415,65784,2.1056860965192934,97.89431390348071,Transportation
43622,4054,39568,9.293475769107332,90.70652423089267,Food
187781,30740,157041,16.370133293570703,83.6298667064293,Entertainment
135569,41791,93778,30.82636886013764,69.17363113986235,Healthcare
142061,9862,132199,6.94208825786106,93.05791174213894,Healthcare
171197,25976,145221,15.173163081128758,84.82683691887124,Entertainment
12188,671,11517,5.505415162454874,94.49458483754512,Housing
33682,12450,21232,36.96336322071136,63.03663677928865,Food
18685,5451,13234,29.173133529569174,70.82686647043083,Housing
151245,2416,148829,1.5974081787827696,98.40259182121723,Entertainment
152359,26583,125776,17.44760729592607,82.55239270407392,Entertainment
60221,8554,51667,14.204347320702079,85.79565267929792,Transportation
87877,34878,52999,39.68956609806889,60.310433901931106,Transportation
144846,15930,128916,10.997887411457686,89.00211258854232,Healthcare
33734,9479,24255,28.099247050453545,71.90075294954646,Food
46200,25868,20332,55.99134199134199,44.00865800865801,Food
42418,23283,19135,54.88943373096327,45.11056626903673,Food
13842,1316,12526,9.507296633434475,90.49270336656554,Housing
131623,7883,123740,5.989074857737629,94.01092514226237,Healthcare
37854,4042,33812,10.677867596555185,89.32213240344481,Food
31327,14605,16722,46.62112554665305,53.37887445334696,Food
15394,14056,1338,91.30830193581915,8.69169806418085,Housing
52591,7372,45219,14.017607575440666,85.98239242455934,Transportation
85795,39477,46318,46.01317093070692,53.98682906929309,Transportation
9813,8801,1012,89.68714969937838,10.312850300621625,Housing
89420,23178,66242,25.920375754864683,74.0796242451353,Transportation
124497,17765,106732,14.2694201466702,85.7305798533298,Healthcare
122107,17131,104976,14.029498718337196,85.9705012816628,Healthcare
72373,16117,56256,22.269354593563897,77.73064540643611,Transportation
154356,33701,120655,21.833294462152427,78.16670553784758,Entertainment
16096,7560,8536,46.96819085487077,53.03180914512923,Housing
14042,7102,6940,50.57684090585387,49.423159094146136,Housing
135573,17610,117963,12.989312031156647,87.01068796884336,Healthcare
191410,44200,147210,23.09179248733086,76.90820751266914,Entertainment
14882,1906,12976,12.807418357747617,87.19258164225239,Housing
80347,22748,57599,28.312195850498462,71.68780414950153,Transportation
162671,27839,134832,17.113683446957356,82.88631655304265,Entertainment
174936,41477,133459,23.709813874788495,76.2901861252115,Entertainment
183742,21661,162081,11.788812574152887,88.21118742584711,Entertainment
87056,27213,59843,31.259189487226614,68.7408105127734,Transportation
122389,15055,107334,12.300942078127937,87.69905792187205,Healthcare
109287,45,109242,0.041175986164868644,99.95882401383514,Healthcare
92250,28341,63909,30.721951219512196,69.2780487804878,Transportation
125744,40324,85420,32.06832930398269,67.9316706960173,Healthcare
10502,10011,491,95.32470005713198,4.675299942868025,Housing
124915,35592,89323,28.492975223151745,71.50702477684825,Healthcare
188346,12901,175445,6.849627812642689,93.1503721873573,Entertainment
35763,30133,5630,84.25747280709113,15.742527192908874,Food
104455,40537,63918,38.80809918146571,61.19190081853429,Healthcare
164678,31241,133437,18.970961512770376,81.02903848722963,Entertainment
196010,49002,147008,24.99974491097393,75.00025508902607,Entertainment
96627,22304,74323,23.082575263642667,76.91742473635733,Transportation
190857,13140,177717,6.8847356921674345,93.11526430783258,Entertainment
49437,20085,29352,40.62746525881425,59.37253474118576,Food
31104,30106,998,96.79140946502058,3.208590534979424,Food
33264,25805,7459,77.57635882635883,22.423641173641172,Food
8726,2736,5990,31.354572541829018,68.64542745817099,Housing
111232,29751,81481,26.746799482163407,73.25320051783659,Healthcare
26269,7454,18815,28.37565190909437,71.62434809090563,Food
33532,22403,11129,66.81080758678277,33.18919241321723,Food
150654,8129,142525,5.395807612144384,94.60419238785562,Entertainment
153858,26671,127187,17.33481521922812,82.66518478077188,Entertainment
183312,36668,146644,20.00305490093393,79.99694509906607,Entertainment
66677,9843,56834,14.76221185716214,85.23778814283786,Transportation
41161,17560,23601,42.661742911979786,57.338257088020214,Food
29589,7297,22292,24.66119165906249,75.33880834093752,Food
161688,22998,138690,14.22369006976399,85.77630993023601,Entertainment
177200,20334,156866,11.475169300225733,88.52483069977427,Entertainment
100945,31695,69250,31.398286195452968,68.60171380454703,Healthcare
156968,6661,150307,4.243540084603231,95.75645991539676,Entertainment
171833,1868,169965,1.0871020118370744,98.91289798816292,Entertainment
15846,8643,7203,54.54373343430519,45.45626656569481,Housing
111224,16220,95004,14.583183485578651,85.41681651442134,Healthcare
79012,8128,70884,10.2870450058219,89.71295499417809,Transportation
199607,30694,168913,15.377216229891738,84.62278377010827,Entertainment
34312,27564,6748,80.33341105152716,19.66658894847284,Food
181385,1461,179924,0.805469029963889,99.19453097003611,Entertainment
31270,30260,1010,96.77006715701951,3.2299328429804923,Food
167315,27332,139983,16.335654304754506,83.66434569524549,Entertainment
10817,8636,2181,79.83729314967182,20.16270685032819,Housing
16984,15883,1101,93.51742816768723,6.4825718323127655,Housing
176805,43586,133219,24.652017759678742,75.34798224032126,Entertainment
58626,39199,19427,66.86282536758435,33.13717463241565,Transportation
67819,30857,36962,45.499048939087864,54.50095106091213,Transportation
9998,7994,2004,79.95599119823964,20.044008801760352,Housing
111079,28030,83049,25.23429271059336,74.76570728940663,Healthcare
51729,7632,44097,14.753813141564692,85.24618685843531,Transportation
123925,44112,79813,35.595723219689326,64.40427678031068,Healthcare
15999,6052,9947,37.82736421026314,62.172635789736866,Housing
17794,441,17353,2.4783634933123526,97.52163650668764,Housing
167337,19684,147653,11.76308885661868,88.23691114338132,Entertainment
31198,27642,3556,88.60183345086223,11.398166549137766,Food
120546,28204,92342,23.39687754052395,76.60312245947605,Healthcare
146117,40484,105633,27.706563917956156,72.29343608204384,Healthcare
92734,11760,80974,12.681432915651216,87.31856708434879,Transportation
20497,4658,15839,22.72527686978582,77.27472313021417,Housing
157718,13331,144387,8.452427750795724,91.54757224920428,Entertainment
151235,34752,116483,22.97880781565114,77.02119218434886,Entertainment
181276,26597,154679,14.672102208786603,85.3278977912134,Entertainment
107544,23946,83598,22.266235215353717,77.73376478464628,Healthcare
24029,16977,7052,70.6521286778476,29.347871322152397,Housing
111425,9643,101782,8.654251738837782,91.34574826116221,Healthcare
121732,20673,101059,16.98238753984162,83.01761246015839,Healthcare
16800,14083,2717,83.82738095238095,16.172619047619047,Housing
42072,21045,21027,50.02139189960069,49.97860810039931,Food
23876,18180,5696,76.14340760596416,23.856592394035854,Housing
15418,6362,9056,41.263458295498765,58.736541704501235,Housing
30962,15734,15228,50.81713067631291,49.1828693236871,Food
14783,13226,1557,89.46763173915984,10.532368260840155,Housing
32383,22971,9412,70.93536732236049,29.0646326776395,Food
85455,23572,61883,27.584108595167045,72.41589140483296,Transportation
182816,35132,147684,19.21713635568003,80.78286364431997,Entertainment
125340,39823,85517,31.771980213818413,68.22801978618158,Healthcare
45787,5515,40272,12.044903575250617,87.95509642474939,Food
129666,42477,87189,32.7587802507982,67.2412197492018,Healthcare
35117,15733,19384,44.8016630122163,55.19833698778369,Food
109291,34818,74473,31.858066995452504,68.1419330045475,Healthcare
139421,38051,101370,27.292158283185458,72.70784171681454,Healthcare
164254,11565,152689,7.040924421931886,92.95907557806812,Entertainment
11112,5670,5442,51.02591792656588,48.974082073434126,Housing
39821,11221,28600,28.178599231561236,71.82140076843876,Food
10520,3081,7439,29.287072243346007,70.71292775665398,Housing
87090,29759,57331,34.17039843839706,65.82960156160294,Transportation
191754,31130,160624,16.23434191724814,83.76565808275186,Entertainment
53197,9552,43645,17.955899768783954,82.04410023121605,Transportation
198358,15839,182519,7.985057320602143,92.01494267939786,Entertainment
92627,45384,47243,48.99651289580792,51.00348710419208,Transportation
36497,19097,17400,52.324848617694606,47.675151382305394,Food
113223,37010,76213,32.68770479496215,67.31229520503784,Healthcare
10261,3736,6525,36.40970665627132,63.590293343728675,Housing
142083,16258,125825,11.442607489988246,88.55739251001175,Healthcare
126912,17866,109046,14.077471003530004,85.92252899646999,Healthcare
90722,37145,53577,40.94376226273671,59.05623773726328,Transportation
86660,15522,71138,17.91137779829218,82.08862220170784,Transportation
20013,690,19323,3.447758956678159,96.55224104332184,Housing
85097,41787,43310,49.105138841557284,50.894861158442716,Transportation
193023,3046,189977,1.578050284163027,98.42194971583697,Entertainment
56781,27050,29731,47.63917507616984,52.36082492383015,Transportation
116006,21292,94714,18.354223057428065,81.64577694257193,Healthcare
168582,36679,131903,21.757364368675187,78.24263563132482,Entertainment
40834,4922,35912,12.053680756232552,87.94631924376745,Food
176991,10321,166670,5.831369956664463,94.16863004333553,Entertainment
45656,33005,12651,72.29060802523217,27.709391974767826,Food
125522,36672,88850,29.215595672471757,70.78440432752824,Healthcare
19328,13319,6009,68.91038907284768,31.089610927152318,Housing
197151,12122,185029,6.148586616349904,93.8514133836501,Entertainment
63825,13444,50381,21.063846455150802,78.93615354484919,Transportation
41527,29896,11631,71.99171623281238,28.008283767187613,Food
105581,49366,56215,46.75651869181008,53.24348130818992,Healthcare
170743,17833,152910,10.444352037858067,89.55564796214193,Entertainment
159048,22993,136055,14.456642020019114,85.54335797998088,Entertainment
194899,3405,191494,1.7470587329847767,98.25294126701523,Entertainment
132789,29805,102984,22.44538327722929,77.5546167227707,Healthcare
165578,24298,141280,14.674654845450483,85.32534515454951,Entertainment
117270,7975,109295,6.8005457491259484,93.19945425087404,Healthcare
24127,5656,18471,23.44261615617358,76.55738384382641,Housing
144064,21140,122924,14.674033762772101,85.3259662372279,Healthcare
94459,26020,68439,27.546342857747806,72.4536571422522,Transportation
9816,5854,3962,59.63732681336593,40.36267318663407,Housing
156360,14364,141996,9.186492709132771,90.81350729086724,Entertainment
118262,27378,90884,23.15029341631293,76.84970658368707,Healthcare
141477,27740,113737,19.607427355683253,80.39257264431674,Healthcare
79375,12288,67087,15.480944881889764,84.51905511811023,Transportation
50819,47207,3612,92.89242212558295,7.107577874417048,Transportation
24644,22422,2222,90.98360655737704,9.01639344262295,Housing
199770,29312,170458,14.672873804875607,85.32712619512439,Entertainment
194498,1327,193171,0.6822692264187806,99.31773077358122,Entertainment
169982,44704,125278,26.29925521525809,73.70074478474191,Entertainment
192642,25909,166733,13.449299737336615,86.55070026266338,Entertainment
56844,1105,55739,1.9439166842586726,98.05608331574133,Transportation
85984,33158,52826,38.562988462969855,61.43701153703015,Transportation
16666,2747,13919,16.482659306372256,83.51734069362774,Housing
72118,4893,67225,6.784713941041072,93.21528605895892,Transportation
18800,5055,13745,26.888297872340427,73.11170212765957,Housing
43715,463,43252,1.0591330207022762,98.94086697929772,Food
132900,5443,127457,4.095560571858541,95.90443942814146,Healthcare
102922,4676,98246,4.543246341889975,95.45675365811003,Healthcare
36963,33302,3661,90.09550090631173,9.904499093688283,Food
109954,26567,83387,24.161922258398967,75.83807774160103,Healthcare
101032,23765,77267,23.522250376118457,76.47774962388154,Healthcare
172821,19504,153317,11.285665515186233,88.71433448481376,Entertainment
24499,7084,17415,28.9154659373852,71.08453406261481,Housing
151218,35242,115976,23.305426602653124,76.69457339734687,Entertainment
47191,38333,8858,81.22947172130279,18.77052827869721,Food
188346,4081,184265,2.1667569260828476,97.83324307391716,Entertainment
193407,5350,188057,2.7661873665379226,97.23381263346208,Entertainment
130669,17316,113353,13.251804176966228,86.74819582303377,Healthcare
34826,21304,13522,61.172687072876585,38.827312927123415,Food
29819,23576,6243,79.06368422817667,20.93631577182333,Food
20298,14153,6145,69.7260813873288,30.273918612671196,Housing
168261,10027,158234,5.9591943468777675,94.04080565312223,Entertainment
24378,1141,23237,4.680449585692018,95.31955041430798,Housing
27074,16696,10378,61.668020979537566,38.331979020462434,Food
194790,44069,150721,22.623851327070177,77.37614867292983,Entertainment
17370,7597,9773,43.736327000575706,56.263672999424294,Housing
12837,7758,5079,60.4346810002337,39.565318999766305,Housing
141577,37012,104565,26.142664415830254,73.85733558416975,Healthcare
27303,2283,25020,8.361718492473354,91.63828150752664,Food
78528,15629,62899,19.902455175224123,80.09754482477588,Transportation
21926,19540,2386,89.1179421691143,10.882057830885707,Housing
34522,8669,25853,25.111523086727306,74.8884769132727,Food
188347,6729,181618,3.5726610989291046,96.4273389010709,Entertainment
21472,4380,17092,20.39865871833085,79.60134128166915,Housing
38224,21691,16533,56.74706990372541,43.252930096274596,Food
27787,23553,4234,84.7626587972793,15.237341202720698,Food
164176,10051,154125,6.122088490400546,93.87791150959946,Entertainment
81997,29204,52793,35.61593716843299,64.38406283156701,Transportation
143635,42864,100771,29.842308629512303,70.1576913704877,Healthcare
59917,29677,30240,49.53018342039822,50.469816579601776,Transportation
165553,2728,162825,1.6478106709029736,98.35218932909703,Entertainment
180162,4383,175779,2.4328104705764813,97.56718952942352,Entertainment
13626,7424,6202,54.48407456333481,45.5159254366652,Housing
72395,33021,39374,45.61226604047241,54.387733959527594,Transportation
182257,11332,170925,6.21759383727374,93.78240616272626,Entertainment
29952,8098,21854,27.03659188034188,72.96340811965813,Food
169776,36981,132795,21.78223070398643,78.21776929601357,Entertainment
195538,14161,181377,7.242070594973867,92.75792940502613,Entertainment
188517,21621,166896,11.468992186381069,88.53100781361893,Entertainment
82531,38736,43795,46.93509105669385,53.06490894330616,Transportation
79218,39291,39927,49.59857608119367,50.40142391880633,Transportation
17074,6406,10668,37.51903478973879,62.48096521026122,Housing
153477,4366,149111,2.844725919844667,97.15527408015532,Entertainment
197728,1694,196034,0.856732480983978,99.14326751901602,Entertainment
123980,30802,93178,24.84432973060171,75.15567026939829,Healthcare
117257,33909,83348,28.918529384173226,71.08147061582677,Healthcare
127874,38057,89817,29.76132755681374,70.23867244318626,Healthcare
87181,3883,83298,4.45395212259552,95.54604787740448,Transportation
10285,5223,5062,50.782693242586284,49.21730675741371,Housing
158767,48517,110250,30.558617344914246,69.44138265508576,Entertainment
102564,48657,53907,47.44062244062244,52.559377559377566,Healthcare
137433,13117,124316,9.544287034409495,90.45571296559051,Healthcare
177372,33210,144162,18.723361071646032,81.27663892835398,Entertainment
146613,32782,113831,22.35954519721989,77.64045480278011,Healthcare
91003,46665,44338,51.27852927925453,48.72147072074547,Transportation
23600,8636,14964,36.59322033898305,63.406779661016955,Housing
16305,3504,12801,21.490340386384542,78.50965961361545,Housing
72064,6200,65864,8.603463587921848,91.39653641207815,Transportation
108267,11183,97084,10.329093814366335,89.67090618563367,Healthcare
148387,39938,108449,26.914756683536968,73.08524331646304,Healthcare
112319,48875,63444,43.5144543665809,56.4855456334191,Healthcare
48696,33757,14939,69.32191555774601,30.678084442253983,Food
149832,23813,126019,15.893133643013508,84.10686635698649,Healthcare
101668,28152,73516,27.69012865405044,72.30987134594956,Healthcare
139182,40758,98424,29.283959132646466,70.71604086735354,Healthcare
186943,37538,149405,20.079917407979973,79.92008259202002,Entertainment
117788,33872,83916,28.75674941420179,71.24325058579821,Healthcare
184489,30493,153996,16.528356704193744,83.47164329580625,Entertainment
150348,49152,101196,32.69215420225078,67.30784579774922,Entertainment
13779,12411,1368,90.07184846505551,9.928151534944481,Housing
39063,3907,35156,10.001791977062693,89.9982080229373,Food
46293,35755,10538,77.23629922450479,22.763700775495217,Food
71775,4083,67692,5.688610240334378,94.31138975966562,Transportation
15096,2326,12770,15.408055113937467,84.59194488606254,Housing
105350,39963,65387,37.93355481727575,62.06644518272425,Healthcare
81369,5283,76086,6.49264461895808,93.50735538104192,Transportation
95533,35754,59779,37.42581097631185,62.574189023688156,Transportation
18773,16140,2633,85.97453790017579,14.025462099824216,Housing
112813,30276,82537,26.837332576919326,73.16266742308068,Healthcare
11719,2745,8974,23.423500298660297,76.57649970133971,Housing
19138,2530,16608,13.219772181001149,86.78022781899884,Housing
42494,3771,38723,8.874194003859369,91.12580599614063,Food
15957,13897,2060,87.09030519521214,12.909694804787867,Housing
171873,28330,143543,16.48310089426495,83.51689910573505,Entertainment
13827,8259,5568,59.730961162942066,40.26903883705793,Housing
18233,1828,16405,10.025777436516208,89.97422256348379,Housing
151608,2953,148655,1.9477863964962272,98.05221360350377,Entertainment
13788,201,13587,1.4577893820713663,98.54221061792863,Housing
14591,9449,5142,64.7590980741553,35.240901925844696,Housing
31306,18782,12524,59.99488915862774,40.00511084137226,Food
33678,8391,25287,24.915375022269732,75.08462497773027,Food
105696,30204,75492,28.576294277929154,71.42370572207084,Healthcare
190858,44905,145953,23.52796319777007,76.47203680222992,Entertainment
144670,18170,126500,12.559618441971383,87.44038155802862,Healthcare
37374,18987,18387,50.80269706212876,49.19730293787124,Food
39880,24600,15280,61.68505516549649,38.314944834503514,Food
147254,35690,111564,24.237032610319584,75.76296738968041,Healthcare
111056,22058,88998,19.86205157758248,80.13794842241751,Healthcare
8338,5895,2443,70.70040777164787,29.29959222835212,Housing
148366,2057,146309,1.3864362455009909,98.61356375449901,Healthcare
106705,40756,65949,38.195023663370975,61.804976336629025,Healthcare
169436,33194,136242,19.590877971623506,80.4091220283765,Entertainment
117102,642,116460,0.5482399959010094,99.45176000409899,Healthcare
151224,39878,111346,26.370152885785323,73.62984711421467,Entertainment
88666,15957,72709,17.996751855277108,82.00324814472289,Transportation
51042,39695,11347,77.7692880373026,22.230711962697384,Transportation
12910,4175,8735,32.33927188226181,67.66072811773819,Housing
18745,14199,4546,75.74819951987196,24.251800480128033,Housing
44811,20167,24644,45.004574769587826,54.995425230412174,Food
33258,13107,20151,39.410066750856934,60.589933249143066,Food
149855,2128,147727,1.4200393713923458,98.57996062860765,Healthcare
174000,3436,170564,1.9747126436781608,98.02528735632184,Entertainment
108620,11164,97456,10.27803351132388,89.72196648867612,Healthcare
158350,19693,138657,12.436375118408588,87.56362488159141,Entertainment
99273,6908,92365,6.958588941605472,93.04141105839453,Transportation
89350,29377,59973,32.878567431449355,67.12143256855065,Transportation
33113,18931,14182,57.17089964666445,42.82910035333555,Food
178932,32076,146856,17.92636308765341,82.07363691234659,Entertainment
26928,20536,6392,76.26262626262627,23.737373737373737,Food
47220,5057,42163,10.709445150360017,89.29055484963997,Food
185713,3936,181777,2.1193992881489176,97.88060071185109,Entertainment
160961,27992,132969,17.390548020949172,82.60945197905083,Entertainment
40087,17387,22700,43.37316336967096,56.62683663032904,Food
55296,20460,34836,37.00086805555556,62.99913194444444,Transportation
11005,4658,6347,42.326215356656064,57.673784643343936,Housing
169323,19010,150313,11.227063068809318,88.77293693119069,Entertainment
23206,18971,4235,81.75040937688529,18.249590623114713,Housing
41525,28202,13323,67.9157134256472,32.0842865743528,Food
57447,4725,52722,8.224972583424723,91.77502741657528,Transportation
22369,12910,9459,57.71380034869685,42.28619965130314,Housing
161331,26504,134827,16.42833677346573,83.57166322653427,Entertainment
117943,49167,68776,41.68708613482784,58.312913865172156,Healthcare
16705,10112,6593,60.53277461837773,39.46722538162227,Housing
113918,46489,67429,40.80917853192647,59.19082146807353,Healthcare
45270,10776,34494,23.803843605036448,76.19615639496355,Food
124507,17562,106945,14.105231031187001,85.894768968813,Healthcare
36462,19583,16879,53.70796994130876,46.29203005869124,Food
21221,1279,19942,6.0270486781961266,93.97295132180388,Housing
46702,17194,29508,36.81641043210141,63.18358956789859,Food
55193,2015,53178,3.6508252858152304,96.34917471418477,Transportation
14313,8315,5998,58.09404038286872,41.90595961713128,Housing
66492,27207,39285,40.917704385489984,59.082295614510016,Transportation
119590,2882,116708,2.409900493352287,97.5900995066477,Healthcare
72746,1245,71501,1.7114343056662908,98.28856569433371,Transportation
18578,17860,718,96.13521369361611,3.864786306383895,Housing
174973,13527,161446,7.730907054231224,92.26909294576878,Entertainment
12107,560,11547,4.625423308829603,95.3745766911704,Housing
117132,30143,86989,25.734214390602055,74.26578560939795,Healthcare
35776,3557,32219,9.942419499105545,90.05758050089445,Food
31095,23358,7737,75.1181862035697,24.881813796430293,Food
150088,9432,140656,6.284313202920953,93.71568679707904,Entertainment
21121,10966,10155,51.919890156716065,48.080109843283935,Housing
115955,16943,99012,14.611702815747488,85.38829718425251,Healthcare
22178,17660,4518,79.62846063666696,20.37153936333303,Housing
135052,20942,114110,15.506619672422476,84.49338032757753,Healthcare
106932,1091,105841,1.0202745670145512,98.97972543298545,Healthcare
27660,7509,20151,27.14750542299349,72.85249457700651,Food
54785,9472,45313,17.289404033950902,82.71059596604911,Transportation
24106,16940,7166,70.27296108852568,29.727038911474324,Housing
122755,12165,110590,9.909983300069243,90.09001669993076,Healthcare
35272,3145,32127,8.916420957133136,91.08357904286686,Food
107465,17110,90355,15.921462801842459,84.07853719815755,Healthcare
21456,15444,6012,71.97986577181209,28.02013422818792,Housing
65344,38598,26746,59.06892752203722,40.93107247796278,Transportation
27346,16459,10887,60.187961676296354,39.812038323703646,Food
16841,10539,6302,62.57941927438988,37.42058072561012,Housing
163395,33158,130237,20.293154625294534,79.70684537470547,Entertainment
31524,21387,10137,67.84354777312524,32.15645222687476,Food
30492,30051,441,98.55371900826447,1.4462809917355373,Food
21074,19374,1700,91.93318781436841,8.066812185631584,Housing
12025,2566,9459,21.33887733887734,78.66112266112266,Housing
108160,24310,83850,22.47596153846154,77.52403846153845,Healthcare
99615,17952,81663,18.021382321939466,81.97861767806053,Transportation
123092,39794,83298,32.32866473856952,67.67133526143047,Healthcare
86861,12975,73886,14.937659018431749,85.06234098156825,Transportation
107189,23696,83493,22.106746028043922,77.89325397195609,Healthcare
15218,7776,7442,51.097384676041536,48.90261532395847,Housing
9798,9600,198,97.97917942437232,2.020820575627679,Housing
16433,10233,6200,62.271039980526986,37.728960019473014,Housing
24393,10617,13776,43.52478169966793,56.47521830033207,Housing
13536,13479,57,99.57890070921985,0.42109929078014185,Housing
18541,2443,16098,13.176204088236881,86.82379591176313,Housing
31554,20426,11128,64.73347277682703,35.26652722317297,Food
189398,45487,143911,24.016621083643965,75.98337891635603,Entertainment
43245,21560,21685,49.85547462134351,50.14452537865649,Food
29865,9316,20549,31.1937050058597,68.80629499414029,Food
76772,1384,75388,1.802740582504038,98.19725941749596,Transportation
11629,4225,7404,36.33158483102588,63.668415168974114,Housing
36018,20107,15911,55.82486534510522,44.17513465489478,Food
130544,7244,123300,5.5490868979041545,94.45091310209584,Healthcare
48742,10692,38050,21.93590743096303,78.06409256903697,Food
18625,1629,16996,8.746308724832215,91.25369127516778,Housing
18106,7657,10449,42.28984866894952,57.71015133105048,Housing
109395,26974,82421,24.657434069198775,75.34256593080121,Healthcare
191037,24944,166093,13.057156467071824,86.94284353292817,Entertainment
198188,3323,194865,1.6766908188184955,98.3233091811815,Entertainment
17874,15151,2723,84.76558129126104,15.23441870873895,Housing
41150,992,40158,2.410692588092345,97.58930741190765,Food
21046,14211,6835,67.52351990877126,32.47648009122874,Housing
22243,6546,15697,29.429483432990157,70.57051656700985,Housing
114259,34318,79941,30.035270744536536,69.96472925546347,Healthcare
36284,30935,5349,85.25796494322566,14.742035056774336,Food
19543,18733,810,95.8552934554572,4.144706544542803,Housing
100512,47314,53198,47.07298631009233,52.927013689907675,Healthcare
132964,28440,104524,21.38924821756265,78.61075178243735,Healthcare
17732,3191,14541,17.9957139634559,82.0042860365441,Housing
113966,13733,100233,12.05008511310391,87.9499148868961,Healthcare
13390,5191,8199,38.767737117251684,61.23226288274832,Housing
167810,8469,159341,5.046779095405518,94.95322090459449,Entertainment
147335,33651,113684,22.83978688023891,77.1602131197611,Healthcare
30731,13921,16810,45.29953467182975,54.70046532817025,Food
191888,20893,170995,10.88812223797215,89.11187776202785,Entertainment
40628,7489,33139,18.433100324899083,81.56689967510091,Food
184818,37443,147375,20.25939031912476,79.74060968087524,Entertainment
45391,9867,35524,21.737789429622612,78.26221057037739,Food
17817,11261,6556,63.20368187685917,36.79631812314082,Housing
20003,10817,9186,54.07688846672999,45.92311153327001,Housing
27834,5285,22549,18.98756916002012,81.01243083997987,Food
195023,17388,177635,8.91587146131482,91.08412853868518,Entertainment
38405,33629,4776,87.5641192553053,12.435880744694702,Food
99946,26177,73769,26.191143217337366,73.80885678266263,Transportation
149324,45320,104004,30.350111167662263,69.64988883233774,Healthcare
156655,31280,125375,19.967444384156266,80.03255561584373,Entertainment
157161,19929,137232,12.680626873079198,87.3193731269208,Entertainment
166140,32977,133163,19.84892259540147,80.15107740459854,Entertainment
92318,4134,88184,4.477999956671505,95.52200004332849,Transportation
49909,11560,38349,23.162155122322627,76.83784487767737,Food
24774,12045,12729,48.61952046500363,51.38047953499637,Housing
191505,30132,161373,15.73431503093914,84.26568496906086,Entertainment
178611,38798,139813,21.722066390087956,78.27793360991204,Entertainment
11987,9719,2268,81.07950279469425,18.920497205305747,Housing
141507,47117,94390,33.29658603461313,66.70341396538687,Healthcare
186966,28794,158172,15.400661082763712,84.5993389172363,Entertainment
156339,49114,107225,31.415065978418692,68.58493402158132,Entertainment
193579,42797,150782,22.10828653934569,77.89171346065432,Entertainment
23674,4757,18917,20.093773760243305,79.90622623975669,Housing
11893,6811,5082,57.26898175397292,42.73101824602708,Housing
48122,10828,37294,22.50114292839034,77.49885707160966,Food
12841,1409,11432,10.97266568024297,89.02733431975702,Housing
144750,5007,139743,3.4590673575129536,96.54093264248704,Healthcare
28780,10050,18730,34.920083391243914,65.07991660875608,Food
66734,32449,34285,48.62438936673959,51.37561063326041,Transportation
60483,18961,41522,31.34930476332192,68.65069523667808,Transportation
110680,47373,63307,42.8017708709794,57.198229129020596,Healthcare
15693,8264,7429,52.66042184413433,47.339578155865674,Housing
130789,49477,81312,37.82963399062612,62.17036600937388,Healthcare
45919,1752,44167,3.815414098739084,96.18458590126092,Food
20258,15990,4268,78.93178003751603,21.06821996248396,Housing
46970,21876,25094,46.57440919736002,53.42559080263999,Food
39034,31673,7361,81.14208126248911,18.857918737510886,Food
65448,27370,38078,41.81945972375015,58.18054027624985,Transportation
186652,2600,184052,1.3929665902320896,98.60703340976791,Entertainment
100237,27350,72887,27.285333758991193,72.71466624100881,Healthcare
75855,10715,65140,14.125634434117726,85.87436556588227,Transportation
10895,6593,4302,60.51399724644332,39.486002753556676,Housing
26508,16335,10173,61.622906292440014,38.377093707559986,Food
151904,44261,107643,29.137481567305667,70.86251843269433,Entertainment
137959,13715,124244,9.941359389383802,90.05864061061621,Healthcare
185161,28688,156473,15.493543456775456,84.50645654322454,Entertainment
22296,3155,19141,14.150520272694653,85.84947972730535,Housing
26365,2708,23657,10.271192869334344,89.72880713066566,Food
13741,13281,460,96.6523542682483,3.3476457317516926,Housing
27252,12949,14303,47.51577865844709,52.48422134155292,Food
16533,5249,11284,31.74862396419283,68.25137603580717,Housing
148787,47469,101318,31.90399698898425,68.09600301101575,Healthcare
98813,15066,83747,15.246981672452007,84.75301832754799,Transportation
17168,3551,13617,20.683830382106244,79.31616961789375,Housing
99113,10940,88173,11.037906228244529,88.96209377175546,Transportation
142965,8507,134458,5.950407442381002,94.049592557619,Healthcare
76709,10860,65849,14.157400044323351,85.84259995567665,Transportation
9638,5671,3967,58.84000830047727,41.15999169952273,Housing
40709,23649,17060,58.092805030828565,41.907194969171435,Food
30523,2370,28153,7.7646365036202205,92.23536349637978,Food
55975,10928,45047,19.523001339883876,80.47699866011612,Transportation
28229,4582,23647,16.231534946331784,83.76846505366822,Food
32289,3203,29086,9.91978692433956,90.08021307566044,Food
11606,8468,3138,72.96226089953473,27.037739100465274,Housing
177127,29466,147661,16.635521405545173,83.36447859445482,Entertainment
11959,11005,954,92.02274437662011,7.977255623379881,Housing
31359,18565,12794,59.201505150036674,40.798494849963326,Food
35387,14157,21230,40.00621697233447,59.99378302766553,Food
24448,16216,8232,66.32853403141361,33.67146596858639,Housing
139387,38033,101354,27.28590184163516,72.71409815836483,Healthcare
197281,36103,161178,18.300292476214132,81.69970752378588,Entertainment
43197,14254,28943,32.99766187466722,67.00233812533278,Food
106257,28432,77825,26.757766547145128,73.24223345285486,Healthcare
164802,9628,155174,5.842162109683135,94.15783789031687,Entertainment
179779,36843,142936,20.493494790826514,79.50650520917348,Entertainment
46890,30313,16577,64.6470462785242,35.35295372147579,Food
77658,20047,57611,25.81446856730794,74.18553143269206,Transportation
57131,29405,27726,51.46942990670564,48.53057009329436,Transportation
75458,6131,69327,8.12504969651992,91.87495030348009,Transportation
199334,48336,150998,24.24874833194538,75.75125166805462,Entertainment
10353,7437,2916,71.83425094175601,28.16574905824399,Housing
92862,30677,62185,33.03504124399647,66.96495875600354,Transportation
127386,42176,85210,33.10881886549542,66.89118113450458,Healthcare
39598,13675,25923,34.5345724531542,65.4654275468458,Food
118048,19748,98300,16.728788289509353,83.27121171049065,Healthcare
86143,45679,40464,53.02694357057452,46.97305642942549,Transportation
180982,48650,132332,26.881126299853026,73.11887370014698,Entertainment
31773,1627,30146,5.12069996537941,94.8793000346206,Food
182376,13494,168882,7.398999868403737,92.60100013159627,Entertainment
22089,2196,19893,9.941599891348634,90.05840010865136,Housing
128731,9236,119495,7.174651016460682,92.82534898353931,Healthcare
21947,13686,8261,62.359320180434686,37.640679819565314,Housing
161701,31792,129909,19.66097921472347,80.33902078527653,Entertainment
115443,4860,110583,4.209869805878226,95.79013019412177,Healthcare
21323,1353,19970,6.345260985789992,93.65473901421001,Housing
61293,40794,20499,66.5557241446821,33.4442758553179,Transportation
47693,23862,23831,50.032499528232655,49.967500471767345,Food
24314,4090,20224,16.821584272435633,83.17841572756437,Housing
11536,6068,5468,52.600554785020805,47.399445214979195,Housing
50297,2409,47888,4.78955007256894,95.21044992743106,Transportation
73275,37699,35576,51.44865233708632,48.55134766291368,Transportation
12795,10634,2161,83.11059007424775,16.889409925752247,Housing
59269,27757,31512,46.8322394506403,53.1677605493597,Transportation
158955,23139,135816,14.556950080211381,85.44304991978862,Entertainment
32658,4920,27738,15.06522138526548,84.93477861473451,Food
21975,12835,9140,58.407281001137655,41.592718998862345,Housing
79182,37533,41649,47.400924452527086,52.59907554747291,Transportation
21550,14512,7038,67.34106728538282,32.658932714617166,Housing
25278,18243,7035,72.16947543318301,27.830524566816994,Food
44463,2983,41480,6.708949013786744,93.29105098621325,Food
45320,37387,7933,82.49558693733451,17.50441306266549,Food
160368,19629,140739,12.239973061957498,87.7600269380425,Entertainment
48589,14745,33844,30.34637469386075,69.65362530613925,Food
183823,27977,155846,15.219531832251675,84.78046816774832,Entertainment
72466,21868,50598,30.17691055115502,69.82308944884498,Transportation
49060,24648,24412,50.24052181002854,49.75947818997146,Food
19046,17717,1329,93.02215688333509,6.977843116664917,Housing
157869,42026,115843,26.620805858021523,73.37919414197847,Entertainment
54303,22391,31912,41.233449349023076,58.766550650976924,Transportation
35554,20811,14743,58.533498340552406,41.4665016594476,Food
32969,24530,8439,74.40322727410597,25.596772725894024,Food
91549,6554,84995,7.159007744486559,92.84099225551344,Transportation
30038,28633,1405,95.32259138424662,4.677408615753379,Food
15673,6949,8724,44.33739552095961,55.66260447904039,Housing
124465,42840,81625,34.41931466677379,65.58068533322621,Healthcare
14033,8560,5473,60.999073612199815,39.000926387800185,Housing
31623,12852,18771,40.6413053789963,59.35869462100371,Food
36619,8446,28173,23.064529342690953,76.93547065730904,Food
49861,13971,35890,28.019895308958905,71.98010469104109,Food
136026,12069,123957,8.87256847955538,91.12743152044462,Healthcare
65439,23385,42054,35.735570531334524,64.26442946866547,Transportation
20605,5482,15123,26.60519291434118,73.39480708565883,Housing
30022,26676,3346,88.85483978415827,11.145160215841717,Food
149857,33593,116264,22.416703924407937,77.58329607559207,Healthcare
14353,10541,3812,73.44109245453913,26.55890754546088,Housing
182994,47288,135706,25.841284413696624,74.15871558630339,Entertainment
38683,26762,11921,69.18284517746814,30.81715482253186,Food
39227,13861,25366,35.33535574986617,64.66464425013385,Food
23254,11470,11784,49.32484733809237,50.67515266190763,Housing
59895,48710,11185,81.32565322647967,18.674346773520327,Transportation
88911,38735,50176,43.56603794806042,56.43396205193958,Transportation
62471,49863,12608,79.8178354756607,20.182164524339292,Transportation
47815,43601,4214,91.1868660462198,8.813133953780195,Food
194519,12703,181816,6.530467460762187,93.4695325392378,Entertainment
80847,8107,72740,10.027582965354311,89.97241703464569,Transportation
36246,32069,4177,88.47596976218065,11.524030237819344,Food
86788,33583,53205,38.695441766142785,61.30455823385722,Transportation
51532,5481,46051,10.636109601800822,89.36389039819917,Transportation
15967,12415,3552,77.75411786810297,22.245882131897037,Housing
105775,31633,74142,29.905932403687068,70.09406759631293,Healthcare
13435,8435,5000,62.78377372534425,37.21622627465575,Housing
180772,26638,154134,14.735689155400172,85.26431084459982,Entertainment
61237,22024,39213,35.965184447311266,64.03481555268873,Transportation
152107,13669,138438,8.986437179091036,91.01356282090897,Entertainment
122190,45139,77051,36.94164825272117,63.05835174727883,Healthcare
9132,699,8433,7.654402102496714,92.34559789750328,Housing
18088,12946,5142,71.57231313578063,28.42768686421937,Housing
16767,13703,3064,81.7260094232719,18.273990576728096,Housing
22397,10744,11653,47.97071036299504,52.02928963700496,Housing
97515,35771,61744,36.68256165718095,63.31743834281905,Transportation
14441,5047,9394,34.94910324769753,65.05089675230246,Housing
124155,29684,94471,23.90882364785953,76.09117635214047,Healthcare
70345,4242,66103,6.030279337550644,93.96972066244935,Transportation
145416,41291,104125,28.3950871981075,71.60491280189251,Healthcare
185426,18316,167110,9.877794915491894,90.1222050845081,Entertainment
155984,19178,136806,12.294850753923479,87.70514924607652,Entertainment
36086,30564,5522,84.69766668514104,15.302333314858949,Food
101111,49730,51381,49.183570531396185,50.81642946860381,Healthcare
11163,9480,1683,84.92340768610589,15.076592313894114,Housing
28730,5974,22756,20.793595544726767,79.20640445527324,Food
16357,9759,6598,59.66252980375375,40.33747019624626,Housing
104900,28582,76318,27.246901811248808,72.75309818875118,Healthcare
158686,13778,144908,8.682555486936467,91.31744451306353,Entertainment
8869,1014,7855,11.433081519900778,88.56691848009922,Housing
27018,7957,19061,29.450736546006368,70.54926345399363,Food
128768,16347,112421,12.694924204771372,87.30507579522863,Healthcare
8207,2665,5542,32.47227976117948,67.52772023882052,Housing
26016,9275,16741,35.65113776137762,64.34886223862239,Food
20504,15398,5106,75.09754194303551,24.902458056964495,Housing
112465,40364,72101,35.8902769750589,64.10972302494109,Healthcare
22325,4458,17867,19.96864501679731,80.03135498320269,Housing
49571,20837,28734,42.034657360150085,57.965342639849915,Food
71449,42447,29002,59.40880908060294,40.59119091939705,Transportation
139619,33518,106101,24.006761257421985,75.99323874257801,Healthcare
64341,33356,30985,51.84252653828818,48.15747346171182,Transportation
127522,32615,94907,25.575979046752717,74.42402095324728,Healthcare
23641,6160,17481,26.056427393088278,73.94357260691173,Housing
163282,48732,114550,29.84529831824696,70.15470168175304,Entertainment
122941,7810,115131,6.352640697570379,93.64735930242962,Healthcare
14099,9499,4600,67.37357259380097,32.62642740619902,Housing
90201,24714,65487,27.398809325838958,72.60119067416105,Transportation
197797,48743,149054,24.642942006198272,75.35705799380172,Entertainment
109861,10745,99116,9.780540865275212,90.21945913472479,Healthcare
185320,26543,158777,14.322793006691128,85.67720699330887,Entertainment
87009,18706,68303,21.498925398521994,78.50107460147801,Transportation
25422,5540,19882,21.792148532766895,78.2078514672331,Food
186588,3364,183224,1.8029026518318434,98.19709734816816,Entertainment
184390,17945,166445,9.732089592711102,90.2679104072889,Entertainment
122153,24091,98062,19.721987998657422,80.27801200134257,Healthcare
77655,18895,58760,24.33198119889254,75.66801880110746,Transportation
11009,7806,3203,70.90562267235899,29.09437732764102,Housing
137595,3664,133931,2.6628874595733856,97.33711254042662,Healthcare
44002,25338,18664,57.58374619335485,42.41625380664515,Food
193828,13335,180493,6.87981096642384,93.12018903357617,Entertainment
21992,11861,10131,53.93324845398326,46.06675154601673,Housing
36487,12453,24034,34.1299640968016,65.8700359031984,Food
39486,15605,23881,39.520336321734284,60.479663678265716,Food
84471,18385,66086,21.764866048703105,78.2351339512969,Transportation
38420,14457,23963,37.62883914627798,62.37116085372202,Food
163987,45168,118819,27.543646752486477,72.45635324751353,Entertainment
156901,48905,107996,31.16933607816394,68.83066392183606,Entertainment
117280,44865,72415,38.254604365620736,61.745395634379264,Healthcare
90101,4944,85157,5.487175503046581,94.51282449695341,Transportation
19336,15596,3740,80.65784029788995,19.342159702110052,Housing
32960,31932,1028,96.88106796116504,3.1189320388349517,Food
19704,15761,3943,79.98883475436459,20.011165245635404,Housing
150459,48469,101990,32.21409154653428,67.78590845346572,Entertainment
42479,35179,7300,82.81503801878576,17.184961981214247,Food
156896,27979,128917,17.8328319396288,82.1671680603712,Entertainment
26041,2686,23355,10.314504051303713,89.68549594869629,Food
54567,2196,52371,4.024410357908626,95.97558964209138,Transportation
23988,8041,15947,33.52092713023178,66.47907286976822,Housing
41100,27200,13900,66.18004866180048,33.81995133819951,Food
166286,26886,139400,16.1685289200534,83.8314710799466,Entertainment
178705,25875,152830,14.479169581153299,85.5208304188467,Entertainment
148600,6114,142486,4.114401076716017,95.885598923284,Healthcare
20323,13031,7292,64.11947055060769,35.88052944939231,Housing
190155,35899,154256,18.878809392337832,81.12119060766217,Entertainment
124538,11217,113321,9.006889463456936,90.99311053654307,Healthcare
118250,9597,108653,8.115856236786469,91.88414376321353,Healthcare
187677,43395,144282,23.122172669000463,76.87782733099954,Entertainment
133524,31889,101635,23.882597885024413,76.11740211497559,Healthcare
50520,31106,19414,61.57165479018211,38.42834520981789,Transportation
31465,16562,14903,52.63626251390434,47.363737486095665,Food
19312,7679,11633,39.76284175642088,60.237158243579124,Housing
146317,7121,139196,4.866830238454862,95.13316976154513,Healthcare
41941,29831,12110,71.12610571993991,28.873894280060085,Food
132762,38051,94711,28.661062653470122,71.33893734652989,Healthcare
42516,4763,37753,11.202841283281588,88.79715871671841,Food
109712,20473,89239,18.660675222400467,81.33932477759953,Healthcare
50494,16465,34029,32.60783459420921,67.39216540579078,Transportation
8145,6077,2068,74.61019030079804,25.389809699201965,Housing
156373,22369,134004,14.304899183362856,85.69510081663715,Entertainment
17101,187,16914,1.0935033039003565,98.90649669609964,Housing
96911,23004,73907,23.737243450175935,76.26275654982406,Transportation
31859,2121,29738,6.657459430616153,93.34254056938384,Food
42311,3178,39133,7.511049136158446,92.48895086384155,Food
63924,27703,36221,43.33740066328765,56.66259933671235,Transportation
47822,25494,22328,53.31019196185856,46.689808038141436,Food
101081,32675,68406,32.32556068895243,67.67443931104758,Healthcare
23998,13386,10612,55.77964830402533,44.220351695974664,Housing
13832,12820,1012,92.68363215731637,7.316367842683633,Housing
173898,23010,150888,13.231894558879343,86.76810544112065,Entertainment
93204,26442,66762,28.370027037466205,71.6299729625338,Transportation
120585,25382,95203,21.04905253555583,78.95094746444417,Healthcare
95772,27599,68173,28.817399657519942,71.18260034248006,Transportation
16837,117,16720,0.6948981409989903,99.30510185900101,Housing
191478,34206,157272,17.864193275467677,82.13580672453233,Entertainment
122874,8384,114490,6.823249833162428,93.17675016683758,Healthcare
63137,14167,48970,22.43850673931292,77.56149326068707,Transportation
159561,47452,112109,29.739096646423626,70.26090335357638,Entertainment
68891,4725,64166,6.858660782976006,93.141339217024,Transportation
170385,47177,123208,27.68847022918684,72.31152977081315,Entertainment
167459,21831,145628,13.036623890026814,86.96337610997318,Entertainment
190130,31909,158221,16.782727607426498,83.2172723925735,Entertainment
183938,29233,154705,15.892855201209102,84.1071447987909,Entertainment
39436,33760,5676,85.60705953950705,14.39294046049295,Food
166025,31899,134126,19.213371480198767,80.78662851980124,Entertainment
133730,23211,110519,17.35661407313243,82.64338592686758,Healthcare
93037,33212,59825,35.6976256758064,64.30237432419361,Transportation
136661,45104,91557,33.00429530004902,66.99570469995098,Healthcare
25887,24916,971,96.24908255108741,3.7509174489125816,Food
74919,35497,39422,47.38050427795352,52.61949572204647,Transportation
12117,8345,3772,68.87018238837996,31.129817611620037,Housing
199409,19984,179425,10.021613868982843,89.97838613101715,Entertainment
177313,37124,140189,20.936987135743006,79.06301286425699,Entertainment
17911,8472,9439,47.300541566635026,52.699458433364974,Housing
153087,25535,127552,16.680057744942417,83.31994225505758,Entertainment
24585,18881,5704,76.7988610941631,23.201138905836892,Housing
188617,39585,149032,20.986973602591494,79.01302639740851,Entertainment
140769,9461,131308,6.720939979683028,93.27906002031698,Healthcare
35532,10931,24601,30.76381852977598,69.23618147022403,Food
12164,10785,1379,88.66326866162446,11.336731338375534,Housing
173551,36524,137027,21.045110659114613,78.95488934088539,Entertainment
30399,23062,7337,75.86433764268563,24.135662357314384,Food
120887,11576,109311,9.57588491731948,90.42411508268053,Healthcare
86487,21,86466,0.02428110583093413,99.97571889416906,Transportation
35694,27938,7756,78.27085784725725,21.72914215274276,Food
136366,10524,125842,7.7174662305853365,92.28253376941467,Healthcare
116463,13696,102767,11.75995809828014,88.24004190171986,Healthcare
92771,20802,71969,22.422955449440018,77.57704455055998,Transportation
40174,33737,6437,83.97719918355155,16.02280081644845,Food
166653,12925,153728,7.755635962148896,92.2443640378511,Entertainment
52740,13231,39509,25.087220326128172,74.91277967387182,Transportation
199978,3824,196154,1.9122103431377453,98.08778965686226,Entertainment
164499,18991,145508,11.544751031921166,88.45524896807883,Entertainment
149529,33740,115789,22.56418487383718,77.43581512616282,Healthcare
18521,10642,7879,57.45910048053561,42.54089951946439,Housing
24198,9914,14284,40.97032812629143,59.029671873708565,Housing
11830,9046,2784,76.46661031276416,23.533389687235843,Housing
53599,10564,43035,19.709322935129386,80.29067706487061,Transportation
91633,41476,50157,45.26316938220947,54.73683061779053,Transportation
30579,13834,16745,45.240197521174665,54.759802478825335,Food
45589,40214,5375,88.20987518919038,11.790124810809626,Food
21200,17508,3692,82.58490566037736,17.41509433962264,Housing
113524,24667,88857,21.728445086501534,78.27155491349846,Healthcare
18647,8716,9931,46.74210328739207,53.25789671260792,Housing
16666,3600,13066,21.600864034561383,78.39913596543862,Housing
116293,1614,114679,1.3878737327268194,98.61212626727318,Healthcare
117465,39008,78457,33.20818967351977,66.79181032648023,Healthcare
117444,34192,83252,29.11344981437962,70.88655018562038,Healthcare
22296,15438,6858,69.2411194833154,30.758880516684606,Housing
130184,27617,102567,21.213820438763594,78.78617956123641,Healthcare
161797,24450,137347,15.111528643917996,84.88847135608201,Entertainment
149957,8990,140967,5.995051914882266,94.00494808511773,Healthcare
103842,37116,66726,35.742763043855085,64.25723695614491,Healthcare
57774,28466,29308,49.27129850797937,50.72870149202063,Transportation
35473,21042,14431,59.318354805063,40.68164519493699,Food
145753,19441,126312,13.33831893683149,86.66168106316852,Healthcare
78075,20595,57480,26.37848222862632,73.62151777137368,Transportation
13443,989,12454,7.3569887673882315,92.64301123261177,Housing
176256,20130,156126,11.420887799564271,88.57911220043573,Entertainment
183382,14082,169300,7.679052469708041,92.32094753029196,Entertainment
194594,6678,187916,3.4317604859348183,96.56823951406518,Entertainment
178559,44846,133713,25.11550803935954,74.88449196064046,Entertainment
26439,3543,22896,13.400658118688302,86.5993418813117,Food
182747,16137,166610,8.83024071530586,91.16975928469414,Entertainment
75709,42662,33047,56.34997160179107,43.65002839820893,Transportation
185185,38379,146806,20.724680724680724,79.27531927531928,Entertainment
63529,13313,50216,20.955783972673895,79.04421602732612,Transportation
38435,4938,33497,12.847664888773252,87.15233511122675,Food
8442,6218,2224,73.65553186448709,26.344468135512912,Housing
96500,44645,51855,46.26424870466322,53.73575129533678,Transportation
46908,8055,38853,17.17191097467383,82.82808902532616,Food
180163,39496,140667,21.922370298007916,78.07762970199208,Entertainment
42741,19643,23098,45.95821342504855,54.04178657495146,Food
185675,570,185105,0.3069880166958395,99.69301198330416,Entertainment
152861,49875,102986,32.627681357573216,67.37231864242678,Entertainment
48761,11360,37401,23.297307274256067,76.70269272574394,Food
31569,2601,28968,8.239095315024231,91.76090468497577,Food
167935,20910,147025,12.451246017804507,87.54875398219549,Entertainment
129783,16979,112804,13.082607121117556,86.91739287888244,Healthcare
196524,48750,147774,24.80613054894059,75.19386945105941,Entertainment
55623,18261,37362,32.82994444744081,67.17005555255919,Transportation
22663,21754,909,95.98905705334685,4.010942946653135,Housing
188072,22258,165814,11.834829214343442,88.16517078565656,Entertainment
27441,20519,6922,74.774971757589,25.22502824241099,Food
18161,11314,6847,62.29833158967018,37.70166841032982,Housing
179946,17384,162562,9.660675980571948,90.33932401942805,Entertainment
9196,2787,6409,30.306655067420618,69.69334493257938,Housing
131822,38233,93589,29.003504726070002,70.99649527393,Healthcare
80917,27268,53649,33.69872832655684,66.30127167344317,Transportation
128841,17175,111666,13.33038396162712,86.66961603837288,Healthcare
153937,31174,122763,20.251141700825663,79.74885829917434,Entertainment
68739,29317,39422,42.6497330481968,57.3502669518032,Transportation
197502,39042,158460,19.76790108454598,80.23209891545402,Entertainment
21808,6585,15223,30.19534115920763,69.80465884079237,Housing
172788,21705,151083,12.56163622473783,87.43836377526218,Entertainment
159276,45606,113670,28.633315753785883,71.36668424621412,Entertainment
43815,18263,25552,41.682072349651946,58.317927650348054,Food
44731,42431,2300,94.85815206456373,5.1418479354362745,Food
14716,4875,9841,33.12720848056537,66.87279151943463,Housing
96623,46665,49958,48.29595437939207,51.70404562060793,Transportation
138597,18675,119922,13.474317625922637,86.52568237407736,Healthcare
20728,10332,10396,49.845619451949055,50.154380548050945,Housing
182151,44138,138013,24.231544158418018,75.76845584158198,Entertainment
197306,32264,165042,16.352265009680394,83.6477349903196,Entertainment
26437,11618,14819,43.94598479403866,56.054015205961335,Food
27548,3164,24384,11.485407289095397,88.51459271090461,Food
35279,34775,504,98.57138807789336,1.4286119221066356,Food
29249,18860,10389,64.48083695169066,35.519163048309345,Food
83440,33257,50183,39.857382550335565,60.14261744966443,Transportation
94967,37207,57760,39.17887266102962,60.821127338970385,Transportation
171741,49438,122303,28.78637017369178,71.21362982630822,Entertainment
34019,12100,21919,35.56835885828507,64.43164114171492,Food
44825,36824,8001,82.15058561070832,17.84941438929169,Food
12652,7939,4713,62.74897249446728,37.251027505532726,Housing
184434,45579,138855,24.712905429584566,75.28709457041543,Entertainment
176023,43130,132893,24.502479789572952,75.49752021042706,Entertainment
118395,28457,89938,24.03564339710292,75.96435660289707,Healthcare
17885,778,17107,4.350013978194017,95.64998602180597,Housing
21994,10552,11442,47.97672092388833,52.02327907611166,Housing
19867,2745,17122,13.816882267076055,86.18311773292395,Housing
155365,449,154916,0.28899687831879767,99.7110031216812,Entertainment
87409,19344,68065,22.13044423343134,77.86955576656867,Transportation
167604,36563,131041,21.815111811173956,78.18488818882604,Entertainment
63867,38968,24899,61.01429533248782,38.985704667512174,Transportation
42332,37528,4804,88.65161107436454,11.348388925635453,Food
102655,33758,68897,32.88490575227704,67.11509424772295,Healthcare
119996,49051,70945,40.87719590653022,59.12280409346978,Healthcare
168884,44400,124484,26.290234717320764,73.70976528267924,Entertainment
78206,23351,54855,29.858322890826788,70.1416771091732,Transportation
18288,17709,579,96.83398950131233,3.1660104986876636,Housing
38005,28948,9057,76.16892514142876,23.83107485857124,Food
40079,5419,34660,13.520796427056563,86.47920357294345,Food
66957,40473,26484,60.44625655271294,39.55374344728707,Transportation
34221,21698,12523,63.40551123579089,36.59448876420911,Food
94381,20493,73888,21.71305665335184,78.28694334664816,Transportation
142817,30431,112386,21.307687460176307,78.69231253982369,Healthcare
16555,148,16407,0.8939897311990335,99.10601026880097,Housing
9239,5370,3869,58.123173503625935,41.876826496374065,Housing
61086,25825,35261,42.276462691942506,57.723537308057494,Transportation
120515,17776,102739,14.750031116458532,85.24996888354147,Healthcare
167374,45452,121922,27.155950147573698,72.84404985242631,Entertainment
73950,16116,57834,21.793103448275865,78.20689655172414,Transportation
50094,35755,14339,71.37581347067513,28.62418652932487,Transportation
43187,10905,32282,25.25065413203047,74.74934586796952,Food
87974,34188,53786,38.861481801441336,61.138518198558664,Transportation
187082,22030,165052,11.775585037577105,88.2244149624229,Entertainment
171143,40950,130193,23.92735899218782,76.07264100781218,Entertainment
43800,25693,18107,58.65981735159818,41.34018264840182,Food
38162,34917,3245,91.4967768984854,8.503223101514596,Food
118367,37712,80655,31.860231314471093,68.1397686855289,Healthcare
108546,40247,68299,37.07828938883054,62.92171061116946,Healthcare
106793,26924,79869,25.211390259661215,74.78860974033879,Healthcare
34183,2607,31576,7.626598016557938,92.37340198344206,Food
30756,23344,7412,75.90063727402783,24.099362725972167,Food
110713,15991,94722,14.443651603696042,85.55634839630396,Healthcare
151003,39034,111969,25.84981755329364,74.15018244670635,Entertainment
81750,31887,49863,39.00550458715596,60.99449541284404,Transportation
18225,9556,8669,52.43347050754458,47.566529492455416,Housing
37955,13731,24224,36.17705177183507,63.82294822816493,Food
119231,26008,93223,21.81311907138244,78.18688092861755,Healthcare
23934,17247,6687,72.06066683379294,27.93933316620707,Housing
41006,26569,14437,64.79295712822514,35.20704287177486,Food
147446,39470,107976,26.76912225492723,73.23087774507277,Healthcare
8436,2828,5608,33.52299668089142,66.47700331910859,Housing
76149,31533,44616,41.4096048536422,58.5903951463578,Transportation
154534,23583,130951,15.26071932390283,84.73928067609717,Entertainment
49661,40660,9001,81.87511326795675,18.12488673204325,Food
111921,7432,104489,6.64039813797232,93.35960186202769,Healthcare
76225,14635,61590,19.19973761889144,80.80026238110855,Transportation
93979,47358,46621,50.39210887538705,49.60789112461295,Transportation
163509,45113,118396,27.590530184882788,72.4094698151172,Entertainment
70969,37809,33160,53.275373754737984,46.724626245262016,Transportation
101219,36145,65074,35.70969877196969,64.29030122803032,Healthcare
58246,31414,26832,53.93331730934313,46.06668269065687,Transportation
21518,352,21166,1.635839762059671,98.36416023794033,Housing
35346,27413,7933,77.5561591127709,22.443840887229108,Food
159516,26802,132714,16.80207628074927,83.19792371925074,Entertainment
131662,17184,114478,13.051601828925582,86.94839817107442,Healthcare
191863,19728,172135,10.28233687579158,89.71766312420843,Entertainment
75026,42314,32712,56.39911497347586,43.60088502652414,Transportation
42697,2962,39735,6.937255544886058,93.06274445511394,Food
44494,17618,26876,39.59635006967231,60.40364993032769,Food
197412,3934,193478,1.9927866593722772,98.00721334062771,Entertainment
13299,9917,3382,74.56951650500038,25.430483494999624,Housing
157700,2629,155071,1.6670894102726697,98.33291058972733,Entertainment
37998,7148,30850,18.811516395599767,81.18848360440023,Food
21032,4195,16837,19.945796880943327,80.05420311905668,Housing
69132,4677,64455,6.765318521090088,93.2346814789099,Transportation
111531,3591,107940,3.2197326303897573,96.78026736961024,Healthcare
60585,14780,45805,24.39547742840637,75.60452257159362,Transportation
182540,14030,168510,7.685986633066726,92.31401336693328,Entertainment
41364,28718,12646,69.42752151629436,30.57247848370564,Food
63895,45048,18847,70.50316926207059,29.496830737929415,Transportation
19939,2428,17511,12.177140277847434,87.82285972215257,Housing
35567,33085,2482,93.02162116568729,6.978378834312705,Food
80961,5901,75060,7.288694556638381,92.71130544336161,Transportation
12917,8429,4488,65.25509019122087,34.74490980877913,Housing
154540,18857,135683,12.202018894784523,87.79798110521548,Entertainment
31870,28310,3560,88.8296203326012,11.170379667398809,Food
74847,42503,32344,56.78651114941147,43.21348885058853,Transportation
188912,47277,141635,25.02593800287965,74.97406199712036,Entertainment
125299,35338,89961,28.20293857093831,71.79706142906169,Healthcare
76998,21101,55897,27.404607911893812,72.59539208810618,Transportation
27312,7225,20087,26.45357352079672,73.54642647920328,Food
73132,48591,24541,66.44287042607887,33.55712957392113,Transportation
8570,2904,5666,33.88564760793466,66.11435239206534,Housing
12135,6629,5506,54.62711166048619,45.3728883395138,Housing
98778,38985,59793,39.46729028731094,60.53270971268906,Transportation
135112,106,135006,0.07845343122742614,99.92154656877258,Healthcare
34584,23104,11480,66.80545917187139,33.194540828128616,Food
103537,1773,101764,1.7124313047509585,98.28756869524904,Healthcare
190606,15583,175023,8.17550339443669,91.82449660556331,Entertainment
187222,18632,168590,9.951821901272288,90.04817809872772,Entertainment
195264,12420,182844,6.360619469026549,93.63938053097345,Entertainment
175907,21107,154800,11.998953992734798,88.0010460072652,Entertainment
147901,41590,106311,28.12016145935457,71.87983854064544,Healthcare
16792,9171,7621,54.615292996665076,45.384707003334924,Housing
11186,2573,8613,23.001966744144468,76.99803325585553,Housing
169988,46115,123873,27.128385533096456,72.87161446690355,Entertainment
132853,34592,98261,26.037801178746435,73.96219882125357,Healthcare
95592,25112,70480,26.26998075152732,73.73001924847267,Transportation
149968,39023,110945,26.020884455350473,73.97911554464952,Healthcare
43317,27304,16013,63.03298935752707,36.96701064247293,Food
190383,28184,162199,14.803842780080153,85.19615721991984,Entertainment
112122,14219,97903,12.681721696009705,87.3182783039903,Healthcare
34191,29709,4482,86.89128718083707,13.108712819162937,Food
69286,18047,51239,26.04710908408625,73.95289091591376,Transportation
123581,5423,118158,4.388215016871526,95.61178498312847,Healthcare
98575,372,98203,0.37737763124524476,99.62262236875475,Transportation
70804,48114,22690,67.95378792158635,32.046212078413646,Transportation
22453,12174,10279,54.21992606778604,45.78007393221396,Housing
166637,32383,134254,19.43325912012338,80.56674087987662,Entertainment
36696,17796,18900,48.49574885546109,51.50425114453891,Food
30802,14130,16672,45.87364456853451,54.12635543146549,Food
19030,9065,9965,47.635312664214396,52.3646873357856,Housing
31379,19149,12230,61.0248892571465,38.9751107428535,Food
25640,172,25468,0.670826833073323,99.32917316692668,Food
153748,9297,144451,6.04690792725759,93.95309207274241,Entertainment
13283,7610,5673,57.29127456146955,42.70872543853045,Housing
42139,25345,16794,60.14618287097463,39.85381712902537,Food
30491,24948,5543,81.82086517332984,18.179134826670165,Food
103604,46540,57064,44.921045519478014,55.07895448052199,Healthcare
154939,31202,123737,20.138247955647063,79.86175204435294,Entertainment
61526,28760,32766,46.74446575431525,53.25553424568476,Transportation
136726,30203,106523,22.09016573292571,77.9098342670743,Healthcare
192181,8833,183348,4.5961879686337355,95.40381203136626,Entertainment
185437,47680,137757,25.712236500806203,74.28776349919379,Entertainment
15022,9151,5871,60.917321262148846,39.082678737851154,Housing
60356,33305,27051,55.18092650275035,44.81907349724965,Transportation
40639,27626,13013,67.97903491719777,32.020965082802235,Food
52957,8077,44880,15.251996903147838,84.74800309685216,Transportation
105070,19623,85447,18.676120681450463,81.32387931854954,Healthcare
36233,17509,18724,48.32335164076946,51.67664835923054,Food
15595,13605,1990,87.23949983969221,12.760500160307792,Housing
124551,6389,118162,5.129625615209834,94.87037438479017,Healthcare
13078,10322,2756,78.92644135188867,21.07355864811133,Housing
109450,15657,93793,14.30516217450891,85.69483782549109,Healthcare
26385,25973,412,98.43850672730719,1.561493272692818,Food
195439,24660,170779,12.617747737145605,87.3822522628544,Entertainment
14376,523,13853,3.638007790762382,96.36199220923763,Housing
24001,968,23033,4.033165284779801,95.9668347152202,Housing
121557,49855,71702,41.01368082463372,58.98631917536628,Healthcare
73447,38108,35339,51.885032744700254,48.11496725529974,Transportation
25911,18380,7531,70.93512407857666,29.064875921423333,Food
21125,3216,17909,15.223668639053253,84.77633136094674,Housing
134679,22266,112413,16.53264428752812,83.46735571247189,Healthcare
26814,11671,15143,43.52577012008652,56.47422987991347,Food
10385,4736,5649,45.60423688011555,54.39576311988444,Housing
55410,42438,12972,76.58906334596644,23.410936654033566,Transportation
30545,17479,13066,57.22376821083647,42.776231789163525,Food
33544,9916,23628,29.56117338421178,70.43882661578822,Food
27844,26460,1384,95.02944979169659,4.970550208303404,Food
185780,36894,148886,19.85897297879212,80.14102702120788,Entertainment
37570,13515,24055,35.97285067873303,64.02714932126696,Food
117085,23911,93174,20.421915702267583,79.57808429773242,Healthcare
105951,1360,104591,1.2836122358448716,98.71638776415513,Healthcare
154839,48943,105896,31.608961566530397,68.3910384334696,Entertainment
130918,38995,91923,29.78582013168548,70.21417986831452,Healthcare
109244,9596,99648,8.784006444289846,91.21599355571016,Healthcare
8204,5552,2652,67.67430521696734,32.32569478303267,Housing
93357,37134,56223,39.776342427455894,60.22365757254411,Transportation
33416,12466,20950,37.305482403638976,62.694517596361024,Food
48421,41691,6730,86.10107184899114,13.89892815100886,Food
95698,29176,66522,30.487575497920545,69.51242450207945,Transportation
48800,35183,13617,72.09631147540983,27.903688524590166,Food
23096,18880,4216,81.74575684101143,18.25424315898857,Housing
10097,5068,5029,50.1931266712885,49.8068733287115,Housing
37722,12427,25295,32.94364031599597,67.05635968400404,Food
13415,3391,10024,25.277674245247855,74.72232575475213,Housing
15843,14210,1633,89.69260872309536,10.307391276904626,Housing
155853,5462,150391,3.5045844481659,96.4954155518341,Entertainment
92419,38725,53694,41.901557039136975,58.098442960863025,Transportation
56719,42691,14028,75.26754703009574,24.732452969904266,Transportation
62962,43075,19887,68.41428163018963,31.585718369810362,Transportation
132096,5631,126465,4.2628088662790695,95.73719113372093,Healthcare
87450,18891,68559,21.60205831903945,78.39794168096054,Transportation
164736,29713,135023,18.03673756798757,81.96326243201243,Entertainment
12943,6530,6413,50.45198176620567,49.54801823379433,Housing
75545,14298,61247,18.926467668277187,81.07353233172282,Transportation
173660,44271,129389,25.49291719451802,74.50708280548197,Entertainment
23715,22431,1284,94.58570524984187,5.4142947501581284,Housing
96670,15762,80908,16.304955001551672,83.69504499844834,Transportation
48841,21058,27783,43.1154153272865,56.8845846727135,Food
20192,8566,11626,42.42274167987322,57.57725832012678,Housing
53294,44398,8896,83.30768942094795,16.692310579052048,Transportation
18449,17522,927,94.97533741666216,5.02466258333785,Housing
30699,1273,29426,4.146714876706081,95.85328512329392,Food
48467,43894,4573,90.56471413539109,9.43528586460891,Food
48182,10988,37194,22.8051969615209,77.1948030384791,Food
51404,17810,33594,34.64710917438332,65.35289082561668,Transportation
94755,45278,49477,47.78428578966809,52.21571421033191,Transportation
90748,20243,70505,22.306827698682063,77.69317230131793,Transportation
109746,36665,73081,33.40896251344013,66.59103748655988,Healthcare
134765,32004,102761,23.74800578785293,76.25199421214707,Healthcare
117359,29790,87569,25.383651871607633,74.61634812839237,Healthcare
38779,6771,32008,17.460481188272002,82.539518811728,Food
24406,18844,5562,77.21052200278619,22.7894779972138,Housing
19713,8502,11211,43.12889971085071,56.87110028914929,Housing
79824,7869,71955,9.857937462417318,90.14206253758267,Transportation
118511,6953,111558,5.8669659356515425,94.13303406434845,Healthcare
13855,7392,6463,53.352580295922046,46.647419704077954,Housing
145135,25874,119261,17.827539876666552,82.17246012333345,Healthcare
26991,5596,21395,20.732836871549775,79.26716312845022,Food
83025,47342,35683,57.021379102679916,42.978620897320084,Transportation
155414,39305,116109,25.290514368074945,74.70948563192505,Entertainment
147607,16038,131569,10.8653383647117,89.13466163528831,Healthcare
191746,34571,157175,18.029580799599472,81.97041920040053,Entertainment
189245,5942,183303,3.139845174245026,96.86015482575498,Entertainment
54542,40644,13898,74.51871951890287,25.481280481097134,Transportation
56631,33333,23298,58.859988345605764,41.140011654394236,Transportation
29894,16727,13167,55.95437211480565,44.04562788519436,Food
53515,9990,43525,18.66766327197982,81.33233672802018,Transportation
34291,14342,19949,41.824385407249714,58.17561459275028,Food
152428,35609,116819,23.361193481512583,76.63880651848741,Entertainment
40883,4675,36208,11.435070811828878,88.56492918817112,Food
79992,7634,72358,9.543454345434544,90.45654565456546,Transportation
38754,38090,664,98.28662847706043,1.7133715229395676,Food
193935,33700,160235,17.37695619666383,82.62304380333617,Entertainment
9892,3439,6453,34.76546704407602,65.23453295592397,Housing
12171,4360,7811,35.82285761235725,64.17714238764276,Housing
8619,882,7737,10.233205708318831,89.76679429168118,Housing
133087,15329,117758,11.518029559611383,88.48197044038861,Healthcare
46230,19073,27157,41.25675967986156,58.74324032013843,Food
24999,9941,15058,39.765590623624945,60.234409376375055,Housing
39038,26426,12612,67.69301706030022,32.30698293969978,Food
171656,10006,161650,5.829100060586289,94.17089993941372,Entertainment
9842,9101,741,92.47104247104248,7.5289575289575295,Housing
187694,23634,164060,12.591771713533731,87.40822828646627,Entertainment
13722,11029,2693,80.37458096487391,19.625419035126075,Housing
71677,43554,28123,60.764261897121806,39.23573810287819,Transportation
47444,19567,27877,41.24230671950089,58.75769328049911,Food
150758,26710,124048,17.717136072380903,82.2828639276191,Entertainment
41261,35440,5821,85.89224691597393,14.10775308402608,Food
110337,47037,63300,42.63030533728486,57.36969466271513,Healthcare
21116,9576,11540,45.34949801098693,54.650501989013065,Housing
153035,169,152866,0.11043225405952886,99.88956774594047,Entertainment
158465,1150,157315,0.7257123024011611,99.27428769759884,Entertainment
32857,28804,4053,87.6647289770825,12.33527102291749,Food
47804,14715,33089,30.781942933645716,69.21805706635428,Food
137000,5302,131698,3.87007299270073,96.12992700729926,Healthcare
60256,42406,17850,70.37639405204462,29.62360594795539,Transportation
18966,17374,1592,91.60603184646209,8.39396815353791,Housing
10591,8758,1833,82.69285242186763,17.307147578132376,Housing
125410,23526,101884,18.759269595726018,81.24073040427399,Healthcare
156828,30844,125984,19.667406330502207,80.3325936694978,Entertainment
114733,49506,65227,43.14887608621756,56.85112391378243,Healthcare
67262,19254,48008,28.625375397698548,71.37462460230145,Transportation
10143,9879,264,97.3972197574682,2.602780242531795,Housing
161410,31410,130000,19.45976085744378,80.54023914255623,Entertainment
100498,7641,92857,7.603136380823498,92.3968636191765,Healthcare
160729,40316,120413,25.083214603462974,74.91678539653704,Entertainment
13105,703,12402,5.364364746280046,94.63563525371995,Housing
54847,26205,28642,47.77836527066202,52.22163472933797,Transportation
77802,49063,28739,63.061360890465544,36.93863910953446,Transportation
36581,32651,3930,89.25671796834422,10.743282031655777,Food
21446,1218,20228,5.679380770306817,94.32061922969318,Housing
181479,26439,155040,14.568627775114477,85.43137222488552,Entertainment
66570,34319,32251,51.55325221571279,48.44674778428721,Transportation
158700,13955,144745,8.793320730938877,91.20667926906111,Entertainment
184890,17412,167478,9.417491481421386,90.58250851857862,Entertainment
127434,41465,85969,32.53841204074266,67.46158795925734,Healthcare
22423,11363,11060,50.675645542523306,49.3243544574767,Housing
70535,36828,33707,52.21237683419579,47.78762316580421,Transportation
155944,14569,141375,9.342456266352023,90.65754373364797,Entertainment
61689,4409,57280,7.147141305581221,92.85285869441879,Transportation
9724,1376,8348,14.150555327025916,85.84944467297409,Housing
42028,8693,33335,20.68382982773389,79.31617017226611,Food
179443,44557,134886,24.83072619160402,75.16927380839597,Entertainment
35112,6825,28287,19.437799043062203,80.5622009569378,Food
27501,20950,6551,76.17904803461693,23.820951965383077,Food
129528,39351,90177,30.38030387252177,69.61969612747822,Healthcare
105191,15304,89887,14.548773184017644,85.45122681598235,Healthcare
58776,29655,29121,50.45426704777461,49.54573295222539,Transportation
11642,11617,25,99.78526026455935,0.21473973544064595,Housing
24402,21205,3197,86.89861486763381,13.1013851323662,Housing
194871,48110,146761,24.688127017360202,75.3118729826398,Entertainment
26780,13186,13594,49.23823749066468,50.76176250933533,Food
198471,10939,187532,5.511636460742375,94.48836353925762,Entertainment
10642,9369,1273,88.03796278894944,11.962037211050554,Housing
72209,13767,58442,19.06549045132878,80.93450954867122,Transportation
46399,34650,11749,74.67833358477553,25.321666415224463,Food
32190,14541,17649,45.17241379310345,54.82758620689655,Food
122008,48269,73739,39.562159858369945,60.43784014163006,Healthcare
144334,21770,122564,15.083071209832749,84.91692879016726,Healthcare
131972,4861,127111,3.6833570757433396,96.31664292425666,Healthcare
60636,9964,50672,16.432482353717266,83.56751764628274,Transportation
142843,28287,114556,19.802860483187835,80.19713951681217,Healthcare
8698,7186,1512,82.61669349275695,17.38330650724304,Housing
187617,27280,160337,14.540260210961693,85.45973978903831,Entertainment
139411,15377,124034,11.02997611379303,88.97002388620697,Healthcare
106160,48487,57673,45.67351168048229,54.32648831951771,Healthcare
49890,33332,16558,66.81098416516336,33.18901583483664,Food
110957,21303,89654,19.199329469974856,80.80067053002514,Healthcare
57690,1379,56311,2.390362281157913,97.6096377188421,Transportation
24609,15636,8973,63.53773009874436,36.46226990125564,Housing
135935,9511,126424,6.99672637657704,93.00327362342296,Healthcare
120426,35185,85241,29.217112583661336,70.78288741633867,Healthcare
19093,13803,5290,72.29351071073168,27.706489289268315,Housing
18922,3521,15401,18.60796955924321,81.39203044075678,Housing
193026,16447,176579,8.520613803321831,91.47938619667816,Entertainment
184248,4626,179622,2.5107463853067604,97.48925361469324,Entertainment
78021,38459,39562,49.29313902667231,50.70686097332769,Transportation
191299,18669,172630,9.75906826486286,90.24093173513714,Entertainment
48440,29079,19361,60.0309661436829,39.9690338563171,Food
177849,23693,154156,13.321975383611939,86.67802461638806,Entertainment
147652,44913,102739,30.418145368840243,69.58185463115976,Healthcare
160488,18309,142179,11.408329594736056,88.59167040526394,Entertainment
104289,6734,97555,6.457056832455963,93.54294316754404,Healthcare
28627,20400,8227,71.26139658364481,28.73860341635519,Food
160427,7504,152923,4.677516876834947,95.32248312316506,Entertainment
188063,42805,145258,22.760989668355815,77.23901033164418,Entertainment
79455,7254,72201,9.129696054370399,90.8703039456296,Transportation
116998,14274,102724,12.200208550573514,87.7997914494265,Healthcare
28677,2572,26105,8.96886006207065,91.03113993792935,Food
13699,1241,12458,9.059055405504052,90.94094459449596,Housing
16275,1422,14853,8.737327188940093,91.26267281105991,Housing
69587,29250,40337,42.03371319355627,57.96628680644373,Transportation
87291,45541,41750,52.17147243129303,47.82852756870697,Transportation
56153,12,56141,0.021370185030185385,99.9786298149698,Transportation
118677,45177,73500,38.0671907783311,61.9328092216689,Healthcare
11086,8152,2934,73.53418726321486,26.465812736785132,Housing
40589,26096,14493,64.29328143092957,35.70671856907044,Food
182882,13690,169192,7.4857011624982235,92.51429883750177,Entertainment
199692,6499,193193,3.2545119484005367,96.74548805159947,Entertainment
16755,12383,4372,73.90629662787228,26.093703372127724,Housing
9933,1380,8553,13.893083660525521,86.10691633947448,Housing
17860,5989,11871,33.533034714445684,66.46696528555431,Housing
77426,48744,28682,62.95559631131661,37.04440368868339,Transportation
15804,7789,8015,49.28499114148317,50.71500885851683,Housing
97846,37289,60557,38.10988696523108,61.89011303476892,Transportation
38924,35199,3725,90.43006885212208,9.569931147877917,Food
69788,20982,48806,30.065340746260098,69.9346592537399,Transportation
26392,11516,14876,43.6344346771749,56.3655653228251,Food
125839,21804,104035,17.326901834884257,82.67309816511575,Healthcare
90985,11695,79290,12.853767104467769,87.14623289553222,Transportation
192739,45760,146979,23.74195155106128,76.25804844893872,Entertainment
121220,11937,109283,9.8473849199802,90.1526150800198,Healthcare
127598,8753,118845,6.859825389112682,93.14017461088731,Healthcare
29387,28412,975,96.6822064178038,3.3177935821962095,Food
27582,691,26891,2.5052570517003843,97.49474294829962,Food
11452,9106,2346,79.51449528466642,20.485504715333565,Housing
135714,31813,103901,23.44120724464683,76.55879275535317,Healthcare
110048,7750,102298,7.042381506251817,92.95761849374819,Healthcare
136742,26898,109844,19.670620584750846,80.32937941524916,Healthcare
35238,29195,6043,82.85089959702594,17.149100402974064,Food
176914,22184,154730,12.539425935765399,87.46057406423459,Entertainment
80506,7692,72814,9.554567361438899,90.4454326385611,Transportation
160130,30358,129772,18.958346343595828,81.04165365640416,Entertainment
109746,41128,68618,37.475625535327026,62.524374464672974,Healthcare
140546,41205,99341,29.317803423790075,70.68219657620992,Healthcare
113289,6387,106902,5.637793607499404,94.3622063925006,Healthcare
15009,12987,2022,86.52808315010994,13.471916849890068,Housing
87307,18608,68699,21.313296757419224,78.68670324258078,Transportation
19700,3741,15959,18.98984771573604,81.01015228426395,Housing
33614,16928,16686,50.3599690605105,49.6400309394895,Food
11719,2581,9138,22.024063486645616,77.97593651335438,Housing
187132,2163,184969,1.155868584742321,98.84413141525768,Entertainment
175039,22555,152484,12.88569975833957,87.11430024166043,Entertainment
101065,41848,59217,41.40701528719141,58.592984712808594,Healthcare
112975,1137,111838,1.0064173489710113,98.99358265102899,Healthcare
100598,29119,71479,28.945903497087418,71.05409650291257,Healthcare
128491,260,128231,0.2023488026398736,99.79765119736012,Healthcare
107502,1845,105657,1.7162471395881007,98.2837528604119,Healthcare
101618,35298,66320,34.73597197346926,65.26402802653072,Healthcare
24690,24363,327,98.67557715674363,1.3244228432563792,Housing
138797,12207,126590,8.794858678501697,91.2051413214983,Healthcare
23768,21639,2129,91.0425782564793,8.957421743520701,Housing
45747,5188,40559,11.340634358537171,88.65936564146283,Food
144699,36491,108208,25.218557142758414,74.78144285724159,Healthcare
51354,26986,24368,52.548973789772944,47.451026210227056,Transportation
57495,36723,20772,63.87164101226194,36.12835898773806,Transportation
114394,35380,79014,30.92819553473084,69.07180446526915,Healthcare
90374,7213,83161,7.981277801137495,92.0187221988625,Transportation
94655,17920,76735,18.93191062278802,81.06808937721198,Transportation
29508,6575,22933,22.282092991731055,77.71790700826895,Food
48473,5586,42887,11.523941163121739,88.47605883687825,Food
95914,46324,49590,48.29743311716746,51.702566882832535,Transportation
35025,7435,27590,21.22769450392577,78.77230549607424,Food
100568,2179,98389,2.1666931827221383,97.83330681727787,Healthcare
8699,5088,3611,58.489481549603404,41.5105184503966,Housing
116446,17878,98568,15.353039176957559,84.64696082304243,Healthcare
65832,20125,45707,30.57023939725362,69.42976060274638,Transportation
39331,4891,34440,12.435483460883272,87.56451653911674,Food
110909,49730,61179,44.838561343083065,55.16143865691693,Healthcare
26270,7868,18402,29.950513894175867,70.04948610582413,Food
60779,12501,48278,20.567959328057388,79.43204067194262,Transportation
63887,20307,43580,31.785809319579883,68.21419068042012,Transportation
87486,3271,84215,3.7388839357154287,96.26111606428456,Transportation
146841,15976,130865,10.879795152580002,89.12020484742,Healthcare
87685,23184,64501,26.440098078348633,73.55990192165136,Transportation
9875,6993,2882,70.81518987341772,29.184810126582278,Housing
136601,48738,87863,35.679094589351465,64.32090541064854,Healthcare
138122,36175,101947,26.19061409478577,73.80938590521423,Healthcare
195860,37083,158777,18.93342183192076,81.06657816807925,Entertainment
148582,27025,121557,18.188609656620585,81.81139034337941,Healthcare
170996,19180,151816,11.216636646471262,88.78336335352873,Entertainment
112583,863,111720,0.7665455708233038,99.23345442917669,Healthcare
90618,45241,45377,49.92495972102673,50.07504027897327,Transportation
89099,47829,41270,53.68073715754386,46.31926284245614,Transportation
134575,43060,91515,31.997027679732494,68.0029723202675,Healthcare
10597,141,10456,1.3305652543172597,98.66943474568274,Housing
33895,30761,3134,90.7537984953533,9.246201504646704,Food
42119,22616,19503,53.69548184904674,46.30451815095325,Food
67158,45565,21593,67.8474641889276,32.1525358110724,Transportation
111882,36996,74886,33.066981283852634,66.93301871614737,Healthcare
73342,11678,61664,15.922663685200838,84.07733631479915,Transportation
129362,16007,113355,12.37380374453085,87.62619625546915,Healthcare
168227,2802,165425,1.6656065910941764,98.33439340890583,Entertainment
160121,20223,139898,12.629823695830028,87.37017630416997,Entertainment
22933,10473,12460,45.667814939170626,54.332185060829374,Housing
79991,42907,37084,53.63978447575353,46.36021552424648,Transportation
24542,956,23586,3.8953630510960804,96.10463694890392,Housing
184061,42154,141907,22.902190034825413,77.09780996517459,Entertainment
21964,17575,4389,80.01730103806229,19.982698961937718,Housing
141491,21793,119698,15.40239308507255,84.59760691492745,Healthcare
29912,403,29509,1.3472853704198984,98.6527146295801,Food
80317,25567,54750,31.832613269917946,68.16738673008204,Transportation
91908,6791,85117,7.3889106497802155,92.61108935021979,Transportation
54748,47006,7742,85.85884415869073,14.141155841309272,Transportation
106417,10633,95784,9.991824614488287,90.00817538551172,Healthcare
13655,12091,1564,88.5463200292933,11.453679970706702,Housing
172971,10895,162076,6.2987437200455565,93.70125627995445,Entertainment
41352,4131,37221,9.98984329657574,90.01015670342426,Food
62315,44197,18118,70.92513840969269,29.07486159030731,Transportation
130483,16447,114036,12.604707126598868,87.39529287340113,Healthcare
148635,30041,118594,20.211255760756213,79.78874423924378,Healthcare
66007,44149,21858,66.88533034375142,33.11466965624858,Transportation
96038,13092,82946,13.632103958849623,86.36789604115039,Transportation
154859,19472,135387,12.574018946267248,87.42598105373276,Entertainment
129282,40279,89003,31.155922711591717,68.84407728840829,Healthcare
112219,23792,88427,21.201400832301125,78.79859916769888,Healthcare
15295,8392,6903,54.867603792088914,45.13239620791108,Housing
51904,14551,37353,28.034448212083845,71.96555178791616,Transportation
26320,1141,25179,4.335106382978723,95.66489361702128,Food
182095,14685,167410,8.064471841621131,91.93552815837887,Entertainment
22594,20128,2466,89.08559794635744,10.914402053642561,Housing
21918,20119,1799,91.79213431882471,8.20786568117529,Housing
198905,47111,151794,23.68517634046404,76.31482365953596,Entertainment
170831,21078,149753,12.338509989404734,87.66149001059527,Entertainment
20602,20170,432,97.90311620231046,2.0968837976895447,Housing
186863,21866,164997,11.701620973654496,88.29837902634551,Entertainment
81263,30363,50900,37.36386793497656,62.63613206502344,Transportation
162085,307,161778,0.1894067927322084,99.8105932072678,Entertainment
120558,21825,98733,18.103319564027274,81.89668043597273,Healthcare
49180,41297,7883,83.9711264741765,16.028873525823506,Food
91804,9716,82088,10.583416844581937,89.41658315541807,Transportation
111634,23384,88250,20.94702330831109,79.05297669168891,Healthcare
169284,934,168350,0.5517355450012996,99.44826445499871,Entertainment
48038,31349,16689,65.25875348682293,34.741246513177074,Food
14272,571,13701,4.000840807174888,95.99915919282512,Housing
75118,33126,41992,44.09861817407279,55.90138182592721,Transportation
146492,23405,123087,15.97698167818038,84.02301832181962,Healthcare
139537,14039,125498,10.061130739517116,89.93886926048287,Healthcare
193909,36067,157842,18.599961837769264,81.40003816223074,Entertainment
43641,28386,15255,65.0443390389771,34.955660961022886,Food
13051,6420,6631,49.191632825070876,50.808367174929124,Housing
24322,14749,9573,60.640572321355144,39.35942767864485,Housing
68965,28812,40153,41.77771333285,58.22228666715,Transportation
9810,6588,3222,67.1559633027523,32.84403669724771,Housing
146997,8559,138438,5.8225678075062755,94.17743219249373,Healthcare
92040,36366,55674,39.511082138200784,60.488917861799216,Transportation
31572,29812,1760,94.42544026352464,5.574559736475358,Food
103108,20852,82256,20.22345501803934,79.77654498196067,Healthcare
17915,9784,8131,54.61345241417806,45.38654758582194,Housing
18106,5189,12917,28.65900806362532,71.34099193637469,Housing
41253,41004,249,99.39640753399753,0.6035924660024725,Food
115170,25968,89202,22.547538421463923,77.45246157853607,Healthcare
104961,18781,86180,17.893312754261107,82.1066872457389,Healthcare
91926,11982,79944,13.034397232556621,86.96560276744337,Transportation
147964,25822,122142,17.45154226703793,82.54845773296208,Healthcare
104124,16603,87521,15.945411240444084,84.05458875955591,Healthcare
125817,15619,110198,12.414061692776016,87.58593830722398,Healthcare
43563,10871,32692,24.954663361109198,75.0453366388908,Food
87298,34743,52555,39.79816261540929,60.20183738459072,Transportation
54151,11109,43042,20.514856604679508,79.48514339532049,Transportation
9304,7368,1936,79.19174548581256,20.808254514187446,Housing
138420,16204,122216,11.706400809131628,88.29359919086838,Healthcare
27694,9562,18132,34.527334440673066,65.47266555932693,Food
33789,2147,31642,6.354138920950605,93.6458610790494,Food
124946,40239,84707,32.205112608646935,67.79488739135306,Healthcare
169075,7874,161201,4.657104835132338,95.34289516486766,Entertainment
80985,41941,39044,51.78860282768414,48.21139717231586,Transportation
17766,3998,13768,22.503658673871442,77.49634132612856,Housing
101811,21574,80237,21.19024466904362,78.80975533095638,Healthcare
193625,33241,160384,17.167721110393803,82.83227888960619,Entertainment
57193,10745,46448,18.787264175685834,81.21273582431417,Transportation
12669,12336,333,97.37153682216434,2.6284631778356617,Housing
124277,34351,89926,27.64067365642878,72.35932634357121,Healthcare
156669,15344,141325,9.793896686645093,90.20610331335492,Entertainment
158968,19422,139546,12.217553218257763,87.78244678174224,Entertainment
27039,4270,22769,15.79200414216502,84.20799585783499,Food
26382,8154,18228,30.90743688878781,69.09256311121219,Food
178834,10033,168801,5.610230716754085,94.38976928324591,Entertainment
29699,20695,9004,69.68248089161251,30.317519108387486,Food
170968,21904,149064,12.811754246408686,87.18824575359132,Entertainment
50348,24741,25607,49.139985699531266,50.860014300468734,Transportation
27377,25616,1761,93.56759323519744,6.432406764802572,Food
14142,12109,2033,85.62438127563287,14.375618724367135,Housing
143666,38164,105502,26.5643924101736,73.4356075898264,Healthcare
78931,48890,30041,61.94017559640699,38.05982440359301,Transportation
50890,19445,31445,38.209864413440755,61.790135586559245,Transportation
90410,18565,71845,20.534232938834197,79.4657670611658,Transportation
19803,2294,17509,11.584103418673939,88.41589658132605,Housing
124147,11802,112345,9.5064721660612,90.4935278339388,Healthcare
159525,22538,136987,14.12819307318602,85.87180692681397,Entertainment
42083,7243,34840,17.21122543544899,82.788774564551,Food
11444,10757,687,93.99685424676687,6.003145753233135,Housing
50633,13280,37353,26.227954101080325,73.77204589891969,Transportation
10475,3610,6865,34.463007159904535,65.53699284009546,Housing
24170,125,24045,0.517170045510964,99.48282995448903,Housing
128563,40663,87900,31.628851224691395,68.3711487753086,Healthcare
21324,2257,19067,10.584318139185894,89.41568186081412,Housing
16438,16154,284,98.2722958997445,1.7277041002555056,Housing
20342,8038,12304,39.514305378035594,60.485694621964406,Housing
108969,26598,82371,24.408776808083033,75.59122319191697,Healthcare
39260,14873,24387,37.88334182373917,62.11665817626083,Food
153371,1908,151463,1.2440422244100906,98.7559577755899,Entertainment
197483,7141,190342,3.6160074538061506,96.38399254619385,Entertainment
124282,48302,75980,38.86483963888576,61.13516036111424,Healthcare
162931,4333,158598,2.659407970245073,97.34059202975493,Entertainment
43175,33653,9522,77.94557035321367,22.054429646786335,Food
86952,11351,75601,13.054328825098905,86.9456711749011,Transportation
85951,11009,74942,12.808460634547592,87.19153936545241,Transportation
63797,36854,26943,57.76760662727087,42.23239337272913,Transportation
165095,7935,157160,4.80632363184833,95.19367636815167,Entertainment
196276,20359,175917,10.37263852941776,89.62736147058224,Entertainment
53986,43052,10934,79.74660097062201,20.253399029377984,Transportation
85878,18570,67308,21.623698735415356,78.37630126458464,Transportation
35491,9824,25667,27.6802569665549,72.31974303344509,Food
129889,8097,121792,6.233784231151214,93.76621576884878,Healthcare
18751,13450,5301,71.72950775958616,28.270492240413848,Housing
47450,14799,32651,31.188619599578505,68.8113804004215,Food
112804,49625,63179,43.99223431793199,56.00776568206801,Healthcare
44325,8738,35587,19.71347997743937,80.28652002256064,Food
157049,22568,134481,14.370037376869641,85.62996262313037,Entertainment
11311,6048,5263,53.47007337989568,46.52992662010432,Housing
95000,18482,76518,19.454736842105262,80.54526315789474,Transportation
134121,34364,99757,25.62164016075037,74.37835983924963,Healthcare
184011,15636,168375,8.49731809511388,91.50268190488612,Entertainment
191652,33793,157859,17.632479702794647,82.36752029720536,Entertainment
154193,16128,138065,10.45961878943921,89.5403812105608,Entertainment
63492,25294,38198,39.83808983808984,60.16191016191016,Transportation
140751,3066,137685,2.1783148965193853,97.82168510348062,Healthcare
8234,1548,6686,18.80009715812485,81.19990284187514,Housing
150982,21554,129428,14.275873945238505,85.7241260547615,Entertainment
26690,26093,597,97.7632071937055,2.2367928062944924,Food
176837,14388,162449,8.136306315985909,91.8636936840141,Entertainment
132669,6574,126095,4.95518923034017,95.04481076965983,Healthcare
14852,12594,2258,84.79666038244007,15.203339617559925,Housing
92323,2102,90221,2.2767890991410593,97.72321090085893,Transportation
12213,10293,1920,84.27904691721936,15.720953082780644,Housing
143183,22650,120533,15.818917050208475,84.18108294979153,Healthcare
38354,15882,22472,41.40897950670073,58.59102049329926,Food
18382,4437,13945,24.137743444674136,75.86225655532586,Housing
138398,6318,132080,4.565094871313169,95.43490512868684,Healthcare
137490,41176,96314,29.9483598807186,70.0516401192814,Healthcare
58984,636,58348,1.078258510782585,98.92174148921742,Transportation
120891,18715,102176,15.480887741850097,84.5191122581499,Healthcare
192237,4942,187295,2.5707850205735627,97.42921497942643,Entertainment
79483,11586,67897,14.5767019362631,85.4232980637369,Transportation
171972,1989,169983,1.1565836298932384,98.84341637010677,Entertainment
54191,1883,52308,3.4747467291616685,96.52525327083833,Transportation
113201,21548,91653,19.035167533855706,80.96483246614429,Healthcare
182048,9483,172565,5.2090657409034975,94.7909342590965,Entertainment
61174,38097,23077,62.27645731846862,37.72354268153137,Transportation
107966,9597,98369,8.888909471500288,91.11109052849972,Healthcare
83306,14166,69140,17.00477756704199,82.99522243295802,Transportation
98584,1160,97424,1.1766615272255132,98.8233384727745,Transportation
147346,11885,135461,8.066048620254367,91.93395137974564,Healthcare
28925,24999,3926,86.42696629213484,13.573033707865168,Food
18517,3754,14763,20.273262407517418,79.72673759248259,Housing
20485,10849,9636,52.960702953380526,47.039297046619474,Housing
45787,44565,1222,97.33112018695263,2.6688798130473717,Food
123635,4090,119545,3.3081247219638454,96.69187527803615,Healthcare
67940,11825,56115,17.405063291139243,82.59493670886076,Transportation
129023,3793,125230,2.939785929640452,97.06021407035955,Healthcare
82070,16205,65865,19.745339344462046,80.25466065553796,Transportation
117977,38376,79601,32.52837417462725,67.47162582537274,Healthcare
64909,44358,20551,68.33875117472154,31.661248825278467,Transportation
171303,21264,150039,12.41309259032241,87.58690740967758,Entertainment
159623,48423,111200,30.335853855647372,69.66414614435263,Entertainment
54483,42454,12029,77.9215535121047,22.078446487895306,Transportation
48401,6191,42210,12.791058035990993,87.20894196400901,Food
23251,526,22725,2.262268289535934,97.73773171046408,Housing
46317,37371,8946,80.68527754388238,19.314722456117625,Food
75763,34332,41431,45.314995446326044,54.685004553673956,Transportation
64497,12062,52435,18.701645037753696,81.29835496224631,Transportation
178893,10041,168852,5.612852375442304,94.3871476245577,Entertainment
172770,1577,171193,0.9127742084852694,99.08722579151473,Entertainment
14469,13721,748,94.8303269057986,5.169673094201396,Housing
119448,22751,96697,19.046781863237563,80.95321813676244,Healthcare
161713,4905,156808,3.033151323641266,96.96684867635874,Entertainment
77332,13934,63398,18.018414110588115,81.98158588941189,Transportation
24743,15434,9309,62.37723800670897,37.62276199329103,Housing
157102,4743,152359,3.0190576822701174,96.98094231772988,Entertainment
154790,20159,134631,13.023451127333807,86.9765488726662,Entertainment
98652,33586,65066,34.044925597048206,65.95507440295178,Transportation
86944,48158,38786,55.38967611336032,44.61032388663968,Transportation
48621,28307,20314,58.219699306883854,41.780300693116146,Food
52261,43907,8354,84.01484854863091,15.98515145136909,Transportation
34138,16984,17154,49.75101060401898,50.24898939598101,Food
27604,12046,15558,43.63860310099986,56.36139689900015,Food
117216,5538,111678,4.724610974610974,95.27538902538902,Healthcare
122044,2124,119920,1.740355937202976,98.25964406279702,Healthcare
27787,14154,13633,50.93748875373376,49.06251124626624,Food
59341,38952,20389,65.64095650562007,34.35904349437994,Transportation
94400,2597,91803,2.7510593220338984,97.2489406779661,Transportation
8630,6683,1947,77.43916570104288,22.56083429895713,Housing
86391,10292,76099,11.913278003495735,88.08672199650427,Transportation
14397,14316,81,99.43738278808085,0.5626172119191498,Housing
49850,21435,28415,42.99899699097292,57.00100300902709,Food
44990,12746,32244,28.330740164480993,71.669259835519,Food
34463,25216,9247,73.16832545048312,26.83167454951687,Food
76326,22597,53729,29.605901003589864,70.39409899641014,Transportation
178831,44540,134291,24.906196352981304,75.0938036470187,Entertainment
107039,6414,100625,5.992208447388335,94.00779155261166,Healthcare
16920,213,16707,1.2588652482269505,98.74113475177305,Housing
130162,7282,122880,5.5945667706396645,94.40543322936034,Healthcare
149856,22218,127638,14.826233183856502,85.1737668161435,Healthcare
22231,3490,18741,15.69879897440511,84.30120102559488,Housing
99411,36843,62568,37.06129100401364,62.93870899598636,Transportation
124330,43020,81310,34.60146384621572,65.39853615378428,Healthcare
14638,6570,8068,44.883180762399235,55.116819237600765,Housing
36832,19556,17276,53.09513466550826,46.904865334491745,Food
32451,27473,4978,84.65994884595236,15.34005115404764,Food
199523,7837,191686,3.9278679650967554,96.07213203490325,Entertainment
180290,32780,147510,18.181818181818183,81.81818181818183,Entertainment
13256,2635,10621,19.877791188895593,80.1222088111044,Housing
118415,24220,94195,20.453489845036525,79.54651015496349,Healthcare
169948,45416,124532,26.72346835502624,73.27653164497376,Entertainment
48570,11151,37419,22.958616429894995,77.041383570105,Food
188630,45819,142811,24.290409796957004,75.70959020304299,Entertainment
33071,27765,5306,83.95573160775301,16.044268392246984,Food
74365,40639,33726,54.64801990183554,45.35198009816446,Transportation
76556,20378,56178,26.618423115105283,73.38157688489471,Transportation
88453,13266,75187,14.99779543938589,85.00220456061412,Transportation
124584,28349,96235,22.754928401720928,77.24507159827907,Healthcare
13926,6251,7675,44.88726123797214,55.11273876202786,Housing
35703,15385,20318,43.0916169509565,56.9083830490435,Food
99089,7641,91448,7.7112494827882,92.28875051721181,Transportation
157335,47387,109948,30.118536879905932,69.88146312009407,Entertainment
73366,6026,67340,8.2136139356105,91.7863860643895,Transportation
82845,48648,34197,58.72170921600579,41.2782907839942,Transportation
43325,31334,11991,72.32313906520484,27.676860934795155,Food
99609,5914,93695,5.937214508729131,94.06278549127087,Transportation
96951,2523,94428,2.6023455147445618,97.39765448525543,Transportation
46685,23238,23447,49.77615936596337,50.223840634036634,Food
133358,9552,123806,7.162674905142549,92.83732509485745,Healthcare
10800,5310,5490,49.166666666666664,50.83333333333333,Housing
8488,7114,1374,83.8124410933082,16.1875589066918,Housing
127884,14063,113821,10.996684495323887,89.00331550467612,Healthcare
187076,21134,165942,11.29701297868246,88.70298702131754,Entertainment
82275,11419,70856,13.879064114250989,86.12093588574902,Transportation
183088,10416,172672,5.689067552215328,94.31093244778467,Entertainment
26578,9488,17090,35.69869817141998,64.30130182858002,Food
97161,29047,68114,29.895740060312264,70.10425993968774,Transportation
180869,10862,170007,6.005451459343503,93.9945485406565,Entertainment
162874,16512,146362,10.137898007048394,89.86210199295161,Entertainment
35349,16755,18594,47.39879487397097,52.60120512602903,Food
144653,26367,118286,18.227758843577387,81.77224115642261,Healthcare
139434,18448,120986,13.230632413901919,86.76936758609808,Healthcare
34500,13386,21114,38.800000000000004,61.199999999999996,Food
114663,38680,75983,33.73363683141031,66.26636316858969,Healthcare
93028,24908,68120,26.774734488541085,73.22526551145891,Transportation
86491,44827,41664,51.82851394942827,48.17148605057174,Transportation
134561,15376,119185,11.426787850863178,88.57321214913682,Healthcare
111827,17472,94355,15.624133706528834,84.37586629347116,Healthcare
40035,5060,34975,12.638940926689147,87.36105907331086,Food
111786,40910,70876,36.59671157390013,63.40328842609987,Healthcare
27697,1717,25980,6.199227353142939,93.80077264685706,Food
69143,25104,44039,36.30736300131611,63.69263699868388,Transportation
187969,42642,145327,22.685655613425617,77.31434438657439,Entertainment
38744,18771,19973,48.448792071030354,51.551207928969646,Food
111144,39593,71551,35.6231555459584,64.3768444540416,Healthcare
39850,26973,12877,67.68632371392724,32.31367628607277,Food
20278,10014,10264,49.38356839925042,50.61643160074958,Housing
70081,36664,33417,52.316605071274665,47.683394928725335,Transportation
28241,6665,21576,23.600439077936333,76.39956092206367,Food
181140,47198,133942,26.056089212763606,73.94391078723639,Entertainment
146546,26251,120295,17.91314672526033,82.08685327473967,Healthcare
19918,13849,6069,69.53007330053218,30.46992669946782,Housing
61385,30348,31037,49.43878797751894,50.56121202248106,Transportation
30112,6752,23360,22.422954303931988,77.57704569606801,Food
101083,11148,89935,11.02856068775165,88.97143931224835,Healthcare
38042,36784,1258,96.69312864728458,3.3068713527154197,Food
23507,15826,7681,67.32462670693836,32.67537329306165,Housing
62835,2314,60521,3.6826609373756667,96.31733906262433,Transportation
124065,49581,74484,39.963728690605734,60.03627130939427,Healthcare
24380,8519,15861,34.94257588187038,65.05742411812962,Housing
23379,19018,4361,81.34650754951025,18.653492450489757,Housing
11832,8891,2941,75.14367816091954,24.856321839080458,Housing
197660,42065,155595,21.281493473641607,78.7185065263584,Entertainment
20945,7485,13460,35.736452613989016,64.26354738601098,Housing
177395,48821,128574,27.52106880126272,72.47893119873729,Entertainment
15927,15562,365,97.70829409179382,2.2917059082061906,Housing
40860,23122,17738,56.58835046500245,43.41164953499755,Food
79349,8080,71269,10.182863048053536,89.81713695194647,Transportation
170427,48197,122230,28.280143404507502,71.7198565954925,Entertainment
176310,41719,134591,23.662299359083434,76.33770064091657,Entertainment
154319,46827,107492,30.344286834414426,69.65571316558558,Entertainment
65609,36427,29182,55.52134615677728,44.47865384322272,Transportation
9969,891,9078,8.937706891363225,91.06229310863677,Housing
175470,15903,159567,9.063087707300394,90.93691229269962,Entertainment
90082,18101,71981,20.09391443351613,79.90608556648388,Transportation
178776,26766,152010,14.971808296415626,85.02819170358438,Entertainment
22551,7906,14645,35.05831226996586,64.94168773003415,Housing
53204,39267,13937,73.80460115780768,26.19539884219232,Transportation
112684,49485,63199,43.91484150367399,56.085158496326,Healthcare
148470,44018,104452,29.647740284232505,70.3522597157675,Healthcare
143847,9260,134587,6.4373952880491085,93.5626047119509,Healthcare
149710,9808,139902,6.551332576314207,93.44866742368579,Healthcare
94959,19899,75060,20.955359681546774,79.04464031845323,Transportation
100065,3299,96766,3.2968570429221007,96.7031429570779,Healthcare
179076,42185,136891,23.557037235587124,76.44296276441287,Entertainment
8406,4431,3975,52.71234832262669,47.287651677373304,Housing
98459,42856,55603,43.52674717395058,56.473252826049425,Transportation
64692,39620,25072,61.24404872318061,38.75595127681939,Transportation
50798,8209,42589,16.160085042718215,83.83991495728178,Transportation
12426,5578,6848,44.889747304039915,55.110252695960085,Housing
34534,3720,30814,10.771992818671453,89.22800718132855,Food
86000,6351,79649,7.384883720930232,92.61511627906977,Transportation
25524,20659,4865,80.93950791412004,19.060492085879957,Food
27254,4942,22312,18.133118074411094,81.86688192558891,Food
32028,331,31697,1.0334707131260148,98.96652928687398,Food
66106,7939,58167,12.00949989410946,87.99050010589053,Transportation
138310,49986,88324,36.140553828356595,63.859446171643405,Healthcare
139942,23457,116485,16.761944234039817,83.23805576596018,Healthcare
141369,22889,118480,16.190961243271158,83.80903875672885,Healthcare
12000,11333,667,94.44166666666666,5.558333333333334,Housing
9341,8407,934,90.00107054919172,9.998929450808266,Housing
41635,26120,15515,62.73567911612826,37.26432088387174,Food
96688,46936,49752,48.54376965083568,51.45623034916432,Transportation
9667,4114,5553,42.55715320161374,57.44284679838626,Housing
82500,44695,37805,54.17575757575758,45.82424242424242,Transportation
190161,11447,178714,6.019635992658852,93.98036400734114,Entertainment
138965,16292,122673,11.723815349188644,88.27618465081135,Healthcare
149525,40551,108974,27.11987961879284,72.88012038120716,Healthcare
195558,44608,150950,22.810623958109613,77.18937604189038,Entertainment
93517,38066,55451,40.704898574590715,59.29510142540928,Transportation
183369,40572,142797,22.125877329319568,77.87412267068044,Entertainment
132814,27632,105182,20.80503561371542,79.19496438628458,Healthcare
43212,25095,18117,58.07414607053596,41.92585392946403,Food
60448,30624,29824,50.66172578083642,49.33827421916358,Transportation
135417,6903,128514,5.097587452092426,94.90241254790757,Healthcare
39918,37333,2585,93.52422466055414,6.475775339445863,Food
93226,17199,76027,18.448716023426943,81.55128397657306,Transportation
108999,36080,72919,33.10122111212029,66.8987788878797,Healthcare
163441,44864,118577,27.449660733842794,72.55033926615721,Entertainment
10700,6815,3885,63.691588785046726,36.308411214953274,Housing
62295,20719,41576,33.25949113090939,66.74050886909062,Transportation
20808,2599,18209,12.49038831218762,87.50961168781238,Housing
48850,12940,35910,26.489252814738997,73.51074718526101,Food
88894,40642,48252,45.7196211217855,54.280378878214506,Transportation
76471,8328,68143,10.890402897830551,89.10959710216945,Transportation
147837,4595,143242,3.1081528981242856,96.89184710187571,Healthcare
112858,27463,85395,24.334118981374825,75.66588101862517,Healthcare
109860,29164,80696,26.546513744766067,73.45348625523394,Healthcare
195987,37019,158968,18.888497706480532,81.11150229351946,Entertainment
19561,9131,10430,46.67961760646184,53.32038239353817,Housing
8358,4931,3427,58.99736779133764,41.00263220866236,Housing
20323,4780,15543,23.520149584214927,76.47985041578507,Housing
128703,20165,108538,15.667855450144907,84.33214454985509,Healthcare
41932,10860,31072,25.899074692359058,74.10092530764094,Food
19156,11108,8048,57.987053664648144,42.01294633535185,Housing
52106,2568,49538,4.928415153725099,95.0715848462749,Transportation
108032,1799,106233,1.6652473341232228,98.33475266587678,Healthcare
39843,23519,16324,59.02918956905856,40.97081043094145,Food
41235,37782,3453,91.62604583484904,8.373954165150964,Food
19996,14162,5834,70.8241648329666,29.17583516703341,Housing
70203,13273,56930,18.90659943307266,81.09340056692734,Transportation
9252,4203,5049,45.42801556420233,54.57198443579766,Housing
123547,35447,88100,28.69110540927744,71.30889459072256,Healthcare
55240,49444,5796,89.50760318609703,10.492396813902968,Transportation
9637,5103,4534,52.95216353637024,47.047836463629764,Housing
155913,29974,125939,19.224824100620218,80.77517589937978,Entertainment
39607,34812,4795,87.89355416971748,12.106445830282526,Food
38066,19423,18643,51.02453633163453,48.97546366836547,Food
163409,19369,144040,11.85308030769419,88.14691969230581,Entertainment
147926,40861,107065,27.622595081324448,72.37740491867555,Healthcare
38273,1230,37043,3.2137538212316774,96.78624617876832,Food
15154,13828,1326,91.24983502705555,8.750164972944436,Housing
18457,2479,15978,13.43121850788319,86.56878149211681,Housing
174358,27071,147287,15.526101469390563,84.47389853060943,Entertainment
85863,25574,60289,29.78465695351898,70.21534304648102,Transportation
19645,15083,4562,76.777806057521,23.222193942479002,Housing
155377,42,155335,0.027031027758291123,99.9729689722417,Entertainment
16436,12984,3452,78.99732294962278,21.002677050377223,Housing
23158,12763,10395,55.11270403316348,44.88729596683652,Housing
38181,27301,10880,71.50415127943218,28.495848720567825,Food
157856,46146,111710,29.232971822420435,70.76702817757956,Entertainment
23921,11870,12051,49.62167133481042,50.378328665189585,Housing
47467,23042,24425,48.543198432595275,51.45680156740472,Food
24898,16832,8066,67.60382360028918,32.39617639971082,Housing
38783,20566,18217,53.02838872701957,46.97161127298043,Food
185546,31740,153806,17.106270143252885,82.89372985674711,Entertainment
112166,23564,88602,21.008148636841824,78.99185136315818,Healthcare
153252,22289,130963,14.544019001383344,85.45598099861665,Entertainment
133101,46477,86624,34.91859565292522,65.08140434707478,Healthcare
65871,9304,56567,14.124576824399204,85.8754231756008,Transportation
148827,31913,116914,21.443017731997553,78.55698226800246,Healthcare
195490,27381,168109,14.006343035449383,85.99365696455061,Entertainment
119543,32294,87249,27.01454706674586,72.98545293325415,Healthcare
67046,40741,26305,60.76574292276944,39.23425707723055,Transportation
198975,44655,154320,22.44251790425933,77.55748209574067,Entertainment
107971,47922,60049,44.38414018579063,55.615859814209365,Healthcare
95709,17682,78027,18.47475159075949,81.52524840924052,Transportation
15357,12324,3033,80.2500488376636,19.749951162336394,Housing
25694,8347,17347,32.48618354479645,67.51381645520354,Food
68887,36587,32300,53.11161757661097,46.88838242338903,Transportation
153801,35246,118555,22.916626029739728,77.08337397026027,Entertainment
25119,709,24410,2.822564592539512,97.1774354074605,Food
8508,1661,6847,19.52280206864128,80.47719793135872,Housing
144152,244,143908,0.16926577501526166,99.83073422498474,Healthcare
21070,12232,8838,58.05410536307546,41.945894636924535,Housing
36827,13890,22937,37.71689249735248,62.28310750264752,Food
153066,10467,142599,6.838226647328603,93.16177335267139,Entertainment
152156,7019,145137,4.613028733668077,95.38697126633193,Entertainment
161370,10340,151030,6.407634628493525,93.59236537150647,Entertainment
55830,34381,21449,61.58158696041555,38.41841303958445,Transportation
81473,34629,46844,42.5036515164533,57.4963484835467,Transportation
17587,11749,5838,66.80502643998409,33.194973560015924,Housing
109229,21686,87543,19.853701855734283,80.14629814426571,Healthcare
188687,1316,187371,0.6974513347501418,99.30254866524986,Entertainment
39941,10618,29323,26.584211712275607,73.4157882877244,Food
59835,36656,23179,61.2618032923874,38.7381967076126,Transportation
164386,43751,120635,26.614796880512937,73.38520311948706,Entertainment
60096,25958,34138,43.19422257720979,56.80577742279021,Transportation
120622,48821,71801,40.47437449221535,59.52562550778465,Healthcare
53823,28878,24945,53.65364249484421,46.34635750515579,Transportation
160047,49419,110628,30.877804644885565,69.12219535511443,Entertainment
20329,1826,18503,8.982242117172511,91.01775788282748,Housing
27213,22504,4709,82.6957704038511,17.304229596148897,Food
83893,5660,78233,6.7466892350970875,93.2533107649029,Transportation
84179,3770,80409,4.4785516577768805,95.52144834222312,Transportation
40425,240,40185,0.5936920222634509,99.40630797773655,Food
40473,17570,22903,43.41165715415215,56.58834284584785,Food
24646,14075,10571,57.10865860585896,42.89134139414104,Housing
183485,6229,177256,3.3948279150884266,96.60517208491157,Entertainment
33793,20597,13196,60.95049270558992,39.049507294410084,Food
185010,13601,171409,7.351494513810064,92.64850548618993,Entertainment
56643,19775,36868,34.911639567113326,65.08836043288667,Transportation
163196,43805,119391,26.841956910708596,73.1580430892914,Entertainment
88139,28757,59382,32.626873461237366,67.37312653876263,Transportation
14696,9583,5113,65.20821992378879,34.79178007621122,Housing
116966,47003,69963,40.185182018706286,59.814817981293714,Healthcare
104180,6299,97881,6.046266077942023,93.95373392205798,Healthcare
94136,38015,56121,40.383062802753464,59.616937197246536,Transportation
19929,2539,17390,12.740227808720958,87.25977219127904,Housing
29118,8869,20249,30.458822721340752,69.54117727865925,Food
47030,13749,33281,29.23453115032958,70.76546884967043,Food
102823,24667,78156,23.989768826040866,76.01023117395913,Healthcare
103466,440,103026,0.425260472039124,99.57473952796087,Healthcare
27942,10849,17093,38.826855629518285,61.173144370481715,Food
95616,9967,85649,10.423987617135207,89.57601238286479,Transportation
53938,36731,17207,68.09855760317402,31.901442396825985,Transportation
43533,11349,32184,26.06987802356833,73.93012197643168,Food
178928,23461,155467,13.111978002324959,86.88802199767505,Entertainment
196414,22354,174060,11.381062449723544,88.61893755027646,Entertainment
177446,45310,132136,25.534528814399877,74.46547118560012,Entertainment
18188,14683,3505,80.72905212227842,19.270947877721575,Housing
57247,31467,25780,54.967072510349894,45.03292748965011,Transportation
50570,1973,48597,3.901522641882539,96.09847735811746,Transportation
143084,30383,112701,21.234379804869867,78.76562019513014,Healthcare
164179,43397,120782,26.432735002649547,73.56726499735046,Entertainment
185421,10832,174589,5.841840999671019,94.15815900032898,Entertainment
19035,18257,778,95.91279222484897,4.087207775151038,Housing
95916,15545,80371,16.206889361524667,83.79311063847533,Transportation
29927,25763,4164,86.08614294783973,13.913857052160255,Food
121114,20011,101103,16.52244992321284,83.47755007678715,Healthcare
63411,45971,17440,72.49688539843245,27.503114601567553,Transportation
17306,6623,10683,38.26996417427482,61.73003582572518,Housing
42518,23991,18527,56.425513899995295,43.574486100004705,Food
178833,17978,160855,10.052954432347496,89.94704556765251,Entertainment
13520,11510,2010,85.13313609467455,14.866863905325445,Housing
20253,18990,1263,93.7638868315805,6.236113168419494,Housing
26506,9053,17453,34.154531049573684,65.84546895042632,Food
151500,23814,127686,15.718811881188119,84.28118811881188,Entertainment
22232,14026,8206,63.089240734077,36.91075926592299,Housing
154167,19309,134858,12.52472967626016,87.47527032373984,Entertainment
100591,26119,74472,25.96554363710471,74.03445636289528,Healthcare
130029,1022,129007,0.7859785124856763,99.21402148751433,Healthcare
34831,13798,21033,39.614136832132296,60.385863167867704,Food
21481,20670,811,96.22457055071924,3.775429449280759,Housing
43625,20350,23275,46.64756446991404,53.35243553008596,Food
96716,19657,77059,20.324455105670207,79.67554489432979,Transportation
186791,18032,168759,9.653570032817427,90.34642996718257,Entertainment
182921,42381,140540,23.169018319383778,76.83098168061622,Entertainment
114691,39107,75584,34.09770601006182,65.90229398993817,Healthcare
8857,4886,3971,55.16540589364345,44.834594106356555,Housing
113728,3534,110194,3.107414181204277,96.89258581879572,Healthcare
17540,16364,1176,93.29532497149373,6.704675028506271,Housing
124277,15410,108867,12.39971998036644,87.60028001963356,Healthcare
26129,19894,6235,76.13762486126527,23.86237513873474,Food
167033,25755,141278,15.419108798860107,84.58089120113989,Entertainment
47019,13704,33315,29.145664518598863,70.85433548140114,Food
83552,21376,62176,25.584067407123705,74.41593259287629,Transportation
160984,43738,117246,27.169159668041544,72.83084033195846,Entertainment
65372,37310,28062,57.07336474331518,42.92663525668482,Transportation
14833,11938,2895,80.48270747657251,19.517292523427493,Housing
39517,19091,20426,48.31085355669712,51.68914644330288,Food
59476,12878,46598,21.65243123276616,78.34756876723384,Transportation
85591,33038,52553,38.59985278826045,61.40014721173955,Transportation
60185,12468,47717,20.716125280385477,79.28387471961452,Transportation
12173,11065,1108,90.8978887702292,9.102111229770804,Housing
74755,31153,43602,41.67346665774865,58.32653334225135,Transportation
98751,17100,81651,17.316280341464896,82.68371965853511,Transportation
121067,49480,71587,40.86993152551893,59.13006847448107,Healthcare
153532,9343,144189,6.085376338483182,93.91462366151681,Entertainment
76416,37888,38528,49.58123953098828,50.41876046901172,Transportation
156564,14387,142177,9.189213356838097,90.8107866431619,Entertainment
11553,7761,3792,67.17735653077122,32.82264346922877,Housing
68264,38140,30124,55.871323098558534,44.12867690144146,Transportation
11093,5658,5435,51.00513837555215,48.99486162444785,Housing
27723,10550,17173,38.055044547848354,61.94495545215164,Food
18593,1772,16821,9.530468455870489,90.46953154412951,Housing
119356,17177,102179,14.391400516103086,85.60859948389692,Healthcare
144600,2105,142495,1.4557399723374826,98.54426002766252,Healthcare
45853,10464,35389,22.820753276775786,77.17924672322421,Food
24789,14567,10222,58.76396788898302,41.23603211101698,Housing
125969,39255,86714,31.16242885154284,68.83757114845716,Healthcare
11630,146,11484,1.2553740326741187,98.74462596732589,Housing
73058,4833,68225,6.615291959812751,93.38470804018725,Transportation
28982,9493,19489,32.75481333241322,67.24518666758678,Food
30581,7054,23527,23.066609986592983,76.93339001340702,Food
13590,6919,6671,50.91243561442237,49.08756438557763,Housing
135250,34588,100662,25.573382624768946,74.42661737523105,Healthcare
15226,5162,10064,33.902535137265204,66.0974648627348,Housing
24370,21534,2836,88.36274107509232,11.637258924907673,Housing
34970,12404,22566,35.47040320274521,64.52959679725478,Food
63929,9721,54208,15.205931580346949,84.79406841965306,Transportation
52330,42095,10235,80.44142939040704,19.55857060959297,Transportation
67592,26718,40874,39.52834654988756,60.47165345011244,Transportation
154319,11479,142840,7.438487807722964,92.56151219227704,Entertainment
144437,18946,125491,13.11713757555197,86.88286242444802,Healthcare
198314,45582,152732,22.984761539780347,77.01523846021965,Entertainment
72160,3849,68311,5.333980044345898,94.66601995565411,Transportation
135745,19455,116290,14.332019595565216,85.66798040443479,Healthcare
16333,5410,10923,33.123124961733915,66.87687503826609,Housing
100717,13850,86867,13.751402444473126,86.24859755552687,Healthcare
89052,32761,56291,36.78861788617886,63.21138211382114,Transportation
154075,21188,132887,13.75174428038293,86.24825571961708,Entertainment
12776,824,11952,6.4495929868503445,93.55040701314965,Housing
69250,35343,33907,51.03682310469314,48.96317689530686,Transportation
197566,7806,189760,3.9510847008088437,96.04891529919115,Entertainment
35738,25251,10487,70.65588449269686,29.344115507303155,Food
40328,12755,27573,31.628149176750647,68.37185082324936,Food
184457,467,183990,0.25317553684598576,99.74682446315401,Entertainment
54972,26909,28063,48.95037473622935,51.04962526377065,Transportation
42026,3083,38943,7.335934897444439,92.66406510255555,Food
133098,26673,106425,20.040120813235358,79.95987918676464,Healthcare
21057,12500,8557,59.362682243434485,40.63731775656551,Housing
88380,12516,75864,14.161575016972167,85.83842498302783,Transportation
47539,40555,6984,85.30890426807464,14.691095731925365,Food
23088,11834,11254,51.25606375606375,48.74393624393624,Housing
139711,47498,92213,33.997323045429496,66.0026769545705,Healthcare
108032,21947,86085,20.3152769549763,79.6847230450237,Healthcare
147616,41809,105807,28.32281053544331,71.67718946455669,Healthcare
9742,1306,8436,13.405871484294806,86.5941285157052,Housing
130227,7614,122613,5.846713815107466,94.15328618489254,Healthcare
95483,209,95274,0.21888713174072874,99.78111286825927,Transportation
192736,42926,149810,22.271915988709946,77.72808401129005,Entertainment
148738,41735,107003,28.059406473127247,71.94059352687276,Healthcare
38449,6297,32152,16.377539077739343,83.62246092226066,Food
20592,8927,11665,43.3517871017871,56.648212898212904,Housing
126999,25890,101109,20.385987291238514,79.61401270876148,Healthcare
18576,16566,2010,89.1795865633075,10.820413436692506,Housing
110996,2631,108365,2.3703556884932793,97.62964431150672,Healthcare
114643,20439,94204,17.828388998892216,82.17161100110779,Healthcare
57188,29685,27503,51.90774288312233,48.09225711687767,Transportation
53236,4576,48660,8.595687129010445,91.40431287098956,Transportation
13387,8002,5385,59.774408007768734,40.225591992231266,Housing
69657,21618,48039,31.03492829148542,68.96507170851459,Transportation
100795,47366,53429,46.99241033781438,53.00758966218563,Healthcare
159089,46982,112107,29.53189723990974,70.46810276009026,Entertainment
104177,34923,69254,33.52275454274936,66.47724545725065,Healthcare
13232,10353,2879,78.24214026602176,21.757859733978236,Housing
112980,7867,105113,6.96317932377412,93.03682067622589,Healthcare
20686,5330,15356,25.766218698636763,74.23378130136325,Housing
29869,16396,13473,54.893032910375304,45.106967089624696,Food
174606,49477,125129,28.33636873876041,71.66363126123959,Entertainment
63825,4299,59526,6.735605170387779,93.26439482961221,Transportation
188654,28859,159795,15.297316780985296,84.7026832190147,Entertainment
170944,38785,132159,22.688716772744293,77.31128322725571,Entertainment
35305,30341,4964,85.939668602181,14.060331397819006,Food
191541,9012,182529,4.704997885570191,95.2950021144298,Entertainment
47192,21267,25925,45.064841498559076,54.93515850144092,Food
148829,1935,146894,1.3001498363894133,98.69985016361059,Healthcare
30681,25739,4942,83.89231120237281,16.107688797627194,Food
152929,40385,112544,26.407679380627613,73.59232061937239,Entertainment
144654,24945,119709,17.244597453233233,82.75540254676676,Healthcare
37487,17107,20380,45.634486622028966,54.365513377971034,Food
141965,11652,130313,8.207656816821048,91.79234318317894,Healthcare
41533,16821,24712,40.5003250427371,59.499674957262904,Food
67564,5193,62371,7.686045823219466,92.31395417678053,Transportation
21917,18935,2982,86.39412328329608,13.60587671670393,Housing
117906,22058,95848,18.708123420351804,81.29187657964819,Healthcare
82808,10222,72586,12.344217949956526,87.65578205004347,Transportation
79378,33001,46377,41.57449167275568,58.42550832724432,Transportation
185099,24030,161069,12.982241935396734,87.01775806460327,Entertainment
46474,2031,44443,4.3701854800533635,95.62981451994663,Food
30751,15627,15124,50.81785958180222,49.18214041819778,Food
77259,27353,49906,35.404289467893705,64.59571053210628,Transportation
38779,7008,31771,18.071636710590784,81.9283632894092,Food
158309,29654,128655,18.73172087499763,81.26827912500238,Entertainment
21931,3627,18304,16.53823355068168,83.46176644931832,Housing
44601,19520,25081,43.76583484675231,56.23416515324769,Food
69334,4261,65073,6.145613984480919,93.85438601551908,Transportation
127141,22595,104546,17.771607899890675,82.22839210010933,Healthcare
158549,47272,111277,29.815388302669838,70.18461169733017,Entertainment
198877,26204,172673,13.175983145361203,86.8240168546388,Entertainment
108016,3420,104596,3.1661976003555026,96.8338023996445,Healthcare
64368,29672,34696,46.0974397216008,53.9025602783992,Transportation
62752,47482,15270,75.66611422743497,24.33388577256502,Transportation
196527,47717,148810,24.280124359502768,75.71987564049724,Entertainment
16906,4146,12760,24.52383769076068,75.47616230923933,Housing
155280,25157,130123,16.2010561566203,83.7989438433797,Entertainment
130400,14002,116398,10.737730061349692,89.2622699386503,Healthcare
120642,32500,88142,26.939208567497225,73.06079143250278,Healthcare
106386,8222,98164,7.728460511721467,92.27153948827853,Healthcare
121250,15,121235,0.012371134020618558,99.98762886597939,Healthcare
130933,44097,86836,33.67905722774243,66.32094277225757,Healthcare
11631,6172,5459,53.06508468747313,46.93491531252687,Housing
162029,19823,142206,12.234229674934733,87.76577032506526,Entertainment
137404,37193,100211,27.068353177491193,72.93164682250881,Healthcare
22818,1549,21269,6.788500306775353,93.21149969322464,Housing
51876,37066,14810,71.45115274886267,28.548847251137328,Transportation
17907,4777,13130,26.676718601664152,73.32328139833585,Housing
73093,25105,47988,34.34665426237807,65.65334573762193,Transportation
141646,25702,115944,18.14523530491507,81.85476469508492,Healthcare
197020,35297,161723,17.91544005684702,82.08455994315298,Entertainment
125406,41815,83591,33.34369966349298,66.65630033650703,Healthcare
43803,42274,1529,96.50937150423486,3.4906284957651303,Food
17223,4940,12283,28.682575625616906,71.31742437438308,Housing
38017,153,37864,0.402451534839677,99.59754846516033,Food
142514,21711,120803,15.23429277123651,84.76570722876349,Healthcare
39018,8314,30704,21.308114203700857,78.69188579629915,Food
13939,2295,11644,16.464595738575223,83.53540426142479,Housing
31924,25446,6478,79.70805663450695,20.291943365493044,Food
195589,40533,155056,20.72355807330678,79.27644192669322,Entertainment
23921,18096,5825,75.64901132895781,24.35098867104218,Housing
195565,45502,150063,23.266944494157954,76.73305550584205,Entertainment
124332,2037,122295,1.6383553711031753,98.36164462889683,Healthcare
95840,11322,84518,11.813439065108513,88.18656093489149,Transportation
126786,21033,105753,16.58937106620605,83.41062893379394,Healthcare
166451,15535,150916,9.333077001640122,90.66692299835988,Entertainment
121807,14407,107400,11.827727470506622,88.17227252949338,Healthcare
33449,10073,23376,30.114502675715265,69.88549732428473,Food
105029,32725,72304,31.158061106932372,68.84193889306763,Healthcare
188091,28805,159286,15.314395691447224,84.68560430855277,Entertainment
198504,27549,170955,13.878309756982226,86.12169024301777,Entertainment
89768,29550,60218,32.91818910970502,67.08181089029497,Transportation
184748,29810,154938,16.13549267109793,83.86450732890208,Entertainment
33805,27169,6636,80.3697677858305,19.630232214169503,Food
48184,9472,38712,19.657977751950856,80.34202224804915,Food
15935,6093,9842,38.23658613115783,61.76341386884218,Housing
12493,9335,3158,74.72184423277035,25.27815576722965,Housing
108164,39051,69113,36.10350948559595,63.89649051440406,Healthcare
10890,10858,32,99.70615243342516,0.2938475665748393,Housing
82162,43081,39081,52.43421533068815,47.565784669311846,Transportation
30530,22988,7542,75.29642974123813,24.70357025876187,Food
26376,1181,25195,4.477555353351532,95.52244464664847,Food
21245,11151,10094,52.48764415156507,47.51235584843493,Housing
187587,35030,152557,18.674001929771254,81.32599807022875,Entertainment
41185,40734,451,98.90494111933957,1.0950588806604347,Food
48972,17420,31552,35.57134689210161,64.4286531078984,Food
128947,37355,91592,28.969266442802084,71.03073355719792,Healthcare
28638,10355,18283,36.15825127453034,63.84174872546966,Food
155400,17839,137561,11.479407979407979,88.52059202059202,Entertainment
169524,48447,121077,28.578254406455724,71.42174559354427,Entertainment
112313,32596,79717,29.022464006838035,70.97753599316196,Healthcare
45377,7837,37540,17.27086409414461,82.72913590585539,Food
58960,28261,30699,47.93249660786974,52.067503392130256,Transportation
14823,2105,12718,14.200904000539701,85.79909599946029,Housing
126366,25188,101178,19.932576800721712,80.06742319927828,Healthcare
88166,11528,76638,13.075335163214843,86.92466483678515,Transportation
52084,46146,5938,88.59918593042009,11.400814069579909,Transportation
41396,2537,38859,6.128611460044449,93.87138853995555,Food
138184,15398,122786,11.143113529786373,88.85688647021362,Healthcare
15005,14036,969,93.54215261579473,6.457847384205265,Housing
21422,152,21270,0.7095509289515451,99.29044907104846,Housing
183167,25727,157440,14.045652328203223,85.95434767179677,Entertainment
73458,5036,68422,6.855618176372894,93.14438182362711,Transportation
68596,21923,46673,31.95958948043618,68.04041051956382,Transportation
16795,11641,5154,69.31229532598988,30.687704674010124,Housing
122575,49923,72652,40.728533550887214,59.271466449112786,Healthcare
67060,23052,44008,34.3751864002386,65.62481359976141,Transportation
94473,26380,68093,27.923322007346012,72.07667799265398,Transportation
98889,48348,50541,48.89118102114492,51.108818978855076,Transportation
12806,2190,10616,17.10135873809152,82.89864126190848,Housing
144777,17974,126803,12.414955414188718,87.58504458581127,Healthcare
